episode	global_ep_reward	episode_reward	loss	num_steps	global_steps	worker_idx
0	1.6493150684931583	1.6493150684931583	-0.035976192530463726	51	51	1
1	1.6512444530194945	1.8422535211267697	-0.034241381813498104	51	102	7
2	1.6514605308260695	1.6728522336769833	-0.03318206469217936	51	153	4
3	1.6419429756653015	0.699705014749266	-0.0297472500333599	51	204	6
4	1.6487115158334604	2.318796992481214	-0.031783767774993296	51	255	8
5	1.6464495662380398	1.4225165562913977	-0.029151255009221097	51	306	12
6	1.6462444562411884	1.6259385665529091	-0.027401316399667777	51	357	13
7	1.6465105340155464	1.6728522336769833	-0.0326301981421078	51	408	5
8	1.64630481434092	1.6259385665529091	-0.028061754563275504	51	459	14
9	1.794750857106601	16.490909090909028	-0.003529132604598999	125	584	8
10	2.3806141593463455	60.38108108108104	0.048605835553511834	206	790	11
11	2.7901058900933062	43.32978723404243	0.04051430085126091	204	994	9
12	3.4202443568840755	65.80395256917022	0.0814879456458733	171	1165	4
13	3.926906320094894	54.08644067796594	0.07793252047370462	170	1335	7
14	4.3823039235606105	49.46666666666656	0.05722216555946752	171	1506	13
15	4.839557807401926	50.10769230769217	0.05959448340343453	171	1677	12
16	5.268310377476054	47.71481481481467	0.07082651923684513	170	1847	6
17	5.692781119855138	47.71538461538451	0.07858233792441231	168	2015	14
18	6.096483939287216	46.06306306306292	0.057719275796201806	169	2184	5
19	6.46130197451208	42.578287461773556	0.038288577785336876	246	2430	10
20	7.684188954766966	128.75000000000068	0.12867547473768248	274	2704	2
21	8.598300336247338	99.09532710280423	0.13461918681191756	223	2927	1
22	10.031083616409774	151.87662835249094	0.14174768848351313	281	3208	3
23	10.492486561164402	56.17137809187262	0.06263473298814562	144	3352	8
24	10.940902832676503	55.33411371237443	0.0822931044810527	148	3500	11
25	11.40463173538422	57.31379310344814	0.06928137461344401	150	3650	9
26	11.889585418030375	59.899999999999906	0.06477346420288085	150	3800	4
27	12.274155361895673	50.346579804560115	0.060252903270072676	147	3947	13
28	12.718591890468495	56.71780821917794	0.06393090936521821	151	4098	6
29	13.14410395814099	55.26979865771795	0.06390012021096336	151	4249	12
30	13.5469374283635	53.42745098039204	0.0643333788739135	151	4400	14
31	13.940286235898043	52.88181818181801	0.06654992856477436	152	4552	5
32	14.294970190259317	49.40868167202561	0.06547907880834632	148	4700	10
33	14.743027868430524	59.10073800737994	0.054059877787550836	146	4846	1
34	15.754740446889079	115.91428571428615	0.13081130400526947	197	5043	7
35	16.13123213036807	53.40390879478812	0.06115190134752517	149	5192	3
36	16.44678548070618	47.68656716417899	0.06595806147428167	149	5341	2
37	16.788491538942594	50.61739130434769	0.06301391206938645	145	5486	8
38	17.122754771701317	50.214814814814666	0.5176219019396552	145	5631	11
39	17.492316697668514	54.07894736842093	0.09814229107543126	149	5780	6
40	17.790642721630338	47.32491909385096	0.11132085943497674	173	5953	9
41	18.170490680378947	55.775438596491085	0.16072242576759177	143	6096	5
42	18.65766763011524	66.88818565400872	0.14417220806253367	174	6270	12
43	19.05422888484857	58.31379310344816	0.0643280097416469	140	6410	1
44	19.088126312312145	22.443971631206267	0.184118526498067	194	6604	13
45	19.461943035766204	56.469798657717966	0.09735589061709617	139	6743	7
46	19.87500445647237	60.768085106382976	0.2073692433974322	136	6879	2
47	20.163714979730994	48.74605678233429	0.11952018737792969	174	7053	14
48	20.42737960508161	46.53017751479277	0.11056756050355973	155	7208	10
49	20.526354919351085	30.32491103202895	0.09951895659190442	227	7435	4
50	20.99330032538146	67.2208955223884	0.02922255026327597	185	7620	3
51	21.37501092074356	59.1643598615916	0.08610192341590996	134	7754	8
52	21.83697741072641	67.5716599190286	0.11115683648819313	133	7887	11
53	22.2050320970508	58.64244604316536	4.149873213334517	132	8019	9
54	22.591662627144125	60.86808510638298	0.46102464463975695	135	8154	5
55	22.895302962897997	52.95569620253151	0.1530940070081113	134	8288	12
56	23.267192038532176	60.08421052631574	0.29874360826280383	135	8423	1
57	23.623658049181337	58.913793103448164	0.11509669716678449	134	8557	7
58	23.835754802022855	44.83333333333323	0.09870311395445866	134	8691	13
59	24.12884908124515	53.14518272425235	0.11492184436682498	132	8823	2
60	23.999455327274806	11.189473684210853	0.3676395750882333	171	8994	6
61	24.326801911125802	56.734113712374445	0.22184336363379634	134	9128	10
62	24.67770055868121	59.41666666666657	0.027276323802435574	134	9262	4
63	24.992367997538842	56.14444444444431	0.08480646393515846	132	9394	3
64	25.33937132486272	59.69270072992691	0.08113660956874039	132	9526	11
65	25.67914427828076	59.316666666666556	0.09611548671015986	135	9661	8
66	25.903984414445322	48.16315789473725	0.15979826207063635	196	9857	14
67	26.24399404026553	59.90494699646634	0.06871107934226453	142	9999	5
68	26.510631022939798	52.907692307692166	0.08400146110908135	143	10142	12
69	26.917645335278493	67.2120622568096	0.08402289946873982	144	10286	1
70	27.298923427380256	65.0454545454548	0.08360966708925036	144	10430	7
71	28.210840667926604	118.4906474820148	0.1435794935700643	181	10611	9
72	28.50145581073539	57.272354948805344	0.08152348178249973	143	10754	13
73	28.853110397609452	63.66691449814148	0.08128453634835624	143	10897	10
74	29.03620008874039	47.16207951070324	0.07550334930419922	139	11036	4
75	29.222307114401655	47.6469026548671	0.07981736223462602	142	11178	2
76	29.48752848770208	55.744444444444305	0.0801938912447761	136	11314	8
77	29.76837675231311	57.57235494880535	0.0657198360988072	140	11454	3
78	30.04797869907569	57.728571428571286	0.09116946949678309	136	11590	14
79	31.14209150467753	139.45925925925988	0.23336034861918029	197	11787	6
80	32.20639472756179	137.57241379310398	0.16667374747140068	175	11962	11
81	32.518389603815585	63.405882352941404	0.11119068452041514	137	12099	5
82	32.81060139123067	61.739568345323825	0.11591599457455377	137	12236	12
83	33.028767486161904	54.62721088435362	0.11807393669185781	133	12369	1
84	33.261479811300276	56.29999999999988	0.1221465783960679	136	12505	7
85	33.48593432011796	55.706930693069154	0.1194004906548394	135	12640	13
86	33.66432416785529	51.324919093851015	0.11819395624605336	133	12773	9
87	33.82459575267516	49.69148264984217	0.12307700537201158	133	12906	10
88	34.07199927968449	58.56494845360813	0.10854834097403067	135	13041	2
89	34.367338110417066	63.60588235294142	0.09734162224663628	135	13176	8
90	35.15162875808988	112.7964028776982	0.17362896792859916	166	13342	4
91	35.45956701596353	65.94545454545481	0.09358367919921876	135	13477	14
92	35.610215248242916	50.524390243902296	0.09310362943962439	134	13611	3
93	35.82857255521995	57.44594594594582	0.09647530940041613	134	13745	11
94	35.92249250342662	45.22056737588716	0.24852381871399268	179	13924	6
95	36.105686933231055	54.241935483870854	0.2352973881052501	134	14058	5
96	36.39810374810928	65.34736842105288	0.36955193413628473	135	14193	1
97	36.638130090701985	60.400738007380056	0.15250884321399202	133	14326	7
98	36.97912228377087	70.73734939759066	0.13808751989293983	135	14461	13
99	37.245389884462575	63.60588235294142	0.13612532439055267	135	14596	10
100	37.31465429547711	44.17183098591599	0.2461550851886192	178	14774	12
101	37.542349857785496	60.08421052631574	0.09820045188621239	135	14909	2
102	37.711892460902554	54.49661016949137	0.0811230197097316	132	15041	8
103	37.95146170833654	61.668817204301135	0.08895351268627026	135	15176	4
104	38.93971740927438	136.77703180212058	0.17135788292013188	186	15362	9
105	39.067494148225116	51.71739130434771	0.1363970343746356	134	15496	11
106	38.840282621377014	16.346341463415	0.22559498133284323	178	15674	14
107	39.04858711223641	59.67073170731696	0.27615589882010844	134	15808	6
108	39.90954834009016	125.14470989761148	0.21419358648647918	181	15989	3
109	40.14273638159348	63.228352490421656	0.4589693169844778	133	16122	1
110	40.37453978700832	63.323076923077146	0.0872590806749132	135	16257	7
111	40.22270483689943	25.191044776119895	0.2035391474344644	166	16423	5
112	40.363153464206114	54.26756756756745	0.11059827515573213	132	16555	12
113	40.237388849716154	27.78669201520964	0.15759366429494526	167	16722	13
114	40.33693559613963	50.1920634920634	0.11832579699429599	132	16854	2
115	40.530273557251405	59.67073170731696	0.09292717122319918	134	16988	8
116	40.663047744755815	53.80769230769218	0.08131219379937471	134	17122	4
117	40.81909168591291	56.26744186046497	0.07851315968072237	134	17256	9
118	40.548481414215075	13.758064516129423	0.14221978058686127	185	17441	10
119	40.7271746822647	58.41780821917797	0.08841665467219566	134	17575	11
120	40.91417566271478	59.42727272727261	0.10161256790161133	132	17707	14
121	41.054072994035515	54.90390879478814	0.12134795402412984	134	17841	6
122	41.154686110249	51.11538461538452	0.1205147985202163	134	17975	3
123	41.3035034875571	56.03642384105945	0.09949070660036001	134	18109	1
124	41.40967406015817	51.92056074766345	0.17686959167024982	134	18243	7
125	41.579755401748365	58.41780821917797	0.3241927588163917	134	18377	12
126	41.76322358199661	59.92657342657339	0.12507719068384882	134	18511	2
127	41.92487706046236	57.92857142857131	0.10846352933058098	134	18645	13
128	41.626342575572025	12.071428571428939	0.15000747911857837	165	18810	5
129	41.72432834075481	51.42491909385102	0.08354413148128625	132	18942	8
130	41.787581989862595	48.04969325153365	0.14039026607166638	132	19074	9
131	41.910106843364645	54.04006734006724	0.243585442051743	132	19206	10
132	41.672523505427456	18.151773049645897	0.17869951638830714	166	19372	4
133	41.86979827037318	61.40000000000005	0.07674329545762804	135	19507	6
134	42.0519423929326	60.08421052631574	0.09623290167914497	135	19642	3
135	42.20828737578294	57.68644067796594	0.08645906021345907	134	19776	1
136	42.99093272502163	120.47282229965204	0.13218486055414727	188	19964	11
137	42.81724437155419	25.622097378277573	0.14720258884087295	167	20131	14
138	43.03084970561643	64.17777777777803	0.06688466955114294	135	20266	7
139	43.23660003208968	63.60588235294142	0.10707230744538483	135	20401	12
140	43.327541241800134	52.33072100313466	0.15170175637771835	134	20535	13
141	43.45463006779273	56.03642384105945	0.22661473857822703	134	20669	5
142	43.544978503956905	52.48947368421042	0.3626097187851415	132	20801	8
143	43.21869650415224	10.916778523490379	0.17659991620534873	166	20967	2
144	43.37814722027014	59.16376811594193	0.09322201844417688	132	21099	9
145	43.59488260200002	65.05168539325868	0.0713072176332827	135	21234	4
146	43.755641093053185	59.67073170731696	0.09409365013464173	134	21368	6
147	44.6388440806189	132.07593984962466	0.11342283395620492	182	21550	10
148	44.78409923842863	59.1643598615916	0.09524931836484084	134	21684	1
149	44.90595623262153	56.96979865771797	0.09689150995282984	134	21818	3
150	45.07358484233833	61.668817204301135	0.1231112868697555	135	21953	14
151	45.16526834875365	54.241935483870854	0.08097887750881821	134	22087	11
152	45.262654753213994	54.90390879478814	0.08542533419025478	134	22221	7
153	45.41346482540016	60.34366197183099	0.07223567256221065	135	22356	12
154	45.49973085054683	54.04006734006724	1.1237142158277107	132	22488	5
155	45.631383026577446	58.66494845360813	0.20265246149319321	134	22622	9
156	46.48460650974451	130.95373134328415	0.1802174285217956	182	22804	13
157	47.1820423238417	116.22818791946362	0.18864347148873953	179	22983	8
158	47.23352911063463	52.33072100313466	0.13123755668526266	134	23117	4
159	47.890383362011946	112.91895424836653	0.11898886685991018	177	23294	2
160	48.02547952839182	61.40000000000005	0.06799610985649956	135	23429	1
161	48.15655569396199	61.13309608540927	0.051386246857819735	135	23564	3
162	48.31676791480015	64.17777777777803	0.051851329097041376	135	23699	14
163	48.38487474545607	55.127450980392055	0.05475206517461521	134	23833	11
164	48.06835933133485	16.733333333333746	0.10985024004097445	166	23999	6
165	48.176697398671315	58.902166064981834	0.05360911831711278	132	24131	12
166	48.25529466309519	56.03642384105945	0.0504338919226803	134	24265	7
167	49.11190528523748	133.91635687732395	0.09396865056908649	184	24449	10
168	49.165397882870536	54.46116504854357	0.1352628451674732	134	24583	5
169	49.41274390404183	73.90000000000029	0.21662507233796297	135	24718	9
170	49.45885762255768	54.02411575562691	0.2797745946627944	134	24852	13
171	49.60032786986152	63.60588235294142	0.4779770462601273	135	24987	8
172	49.633881553188225	52.95569620253151	0.12770547439802937	134	25121	4
173	49.74887369851043	61.13309608540927	0.07026139012089481	135	25256	1
174	49.873507705207636	62.21227436823118	0.07429209815131294	135	25391	14
175	49.9220447369991	54.727210884353624	0.08894553329005386	132	25523	6
176	50.026260909347414	60.34366197183099	0.05242918509024161	135	25658	7
177	50.029296172594364	50.32978723404241	0.059198333256280246	134	25792	11
178	49.681447655312866	15.244444444444966	0.12087758001453149	167	25959	2
179	49.79412760255156	60.94944237918218	0.06491043693140934	133	26092	10
180	50.4649876733274	116.8801346801351	0.09366899695100084	177	26269	3
181	50.36614094620043	40.580314960630346	0.15375273890749236	169	26438	12
182	50.375627684886574	51.31481481481468	0.07498536892791292	134	26572	5
183	50.47792087800237	60.604946996466396	0.21988536693431712	135	26707	13
184	50.50693147813955	53.37898089171963	0.30983865083153567	134	26841	9
185	50.57156014993534	56.96979865771797	0.10695151428678143	134	26975	4
186	50.66001121510265	59.41666666666657	0.09754169521047108	134	27109	1
187	50.878066840656544	72.4655737704921	0.08214718853985822	135	27244	14
188	51.001569697154196	63.228352490421656	0.05300669562547727	133	27377	6
189	51.717981562020114	122.64275618374602	0.10857162680677189	186	27563	8
190	51.76580174639991	56.499999999999886	0.04876178769922968	134	27697	7
191	51.74407454654597	49.5930817610062	0.039515108773202606	132	27829	11
192	51.81577173211499	58.913793103448164	0.04167403747786337	134	27963	2
193	51.911614014793834	61.40000000000005	0.03856882165979456	135	28098	10
194	51.95394231909034	56.14444444444431	0.04519411289330685	132	28230	3
195	52.08787658010996	65.34736842105288	0.12403394911024306	135	28365	12
196	52.136695800886045	56.96979865771797	1.0470519564045009	134	28499	13
197	52.2513876664066	63.60588235294142	0.4888328834816262	135	28634	9
198	53.189115034878725	146.02412451361909	0.21941243430782606	173	28807	5
199	53.290454653760705	63.323076923077146	0.09477175253408926	135	28942	4
200	53.30714396387839	54.959385665528906	0.05970454216003418	132	29074	1
201	53.40730329347038	63.323076923077146	0.05543185693246347	135	29209	14
202	53.46739692720234	59.41666666666657	0.044005667985375245	134	29343	6
203	53.60132065907975	66.85977011494279	0.041920700779667606	135	29478	8
204	53.61027355418386	54.49661016949137	0.03190302126335375	132	29610	7
205	53.65545653292774	58.12857142857129	0.042406833533084755	132	29742	2
206	53.66794105554634	54.90390879478814	0.07256966918262082	134	29876	10
207	53.658327651591534	52.70660066006586	0.12564240079937558	132	30008	3
208	53.600365170182656	47.862079510703246	0.09351429072293369	132	30140	12
209	54.23351536463468	116.91538461538505	0.14394428513266824	176	30316	11
210	54.262405563101005	57.12253521126751	0.08909555637475217	132	30448	9
211	54.331112468324086	61.13309608540927	0.08655758610478154	135	30583	13
212	54.32804250119711	54.02411575562691	0.09240576046616283	134	30717	4
213	54.33828666634907	55.35245901639335	0.09868777687869855	134	30851	1
214	54.36460178626276	56.96979865771797	0.0966463231328708	134	30985	14
215	54.05483346624186	23.38776978417303	0.18534407531015973	169	31154	5
216	54.11772175129775	60.34366197183099	0.09600331341778791	135	31289	6
217	54.118963888623476	54.241935483870854	0.1022807448657591	134	31423	8
218	54.179068367384296	60.12941176470587	0.09565134693805437	133	31556	2
219	54.08736806271919	45.0090379008745	0.09180266929395271	132	31688	7
220	54.091106032577436	54.46116504854357	0.09124506765337133	134	31822	10
221	54.194864117233074	64.46691449814152	0.09175184744375724	135	31957	3
222	54.15422224896911	50.1306772908371	0.30864906311035156	172	32129	12
223	54.24310338414366	63.042335766423534	0.23515797367802374	135	32264	13
224	54.09355784648543	39.28854961832113	0.2511131153550259	172	32436	11
225	54.069796181064056	51.71739130434771	0.25752486043901585	134	32570	9
226	54.06276488592008	53.36666666666655	0.24127676992705374	132	32702	4
227	54.06237839461715	54.02411575562691	0.08268634596867348	134	32836	1
228	54.03690940943258	51.515479876160875	0.06454157473436042	134	32970	14
229	54.00870160566084	51.21612903225795	0.06731019598065001	132	33102	5
230	54.09625095324059	62.763636363636515	0.057924927605523	135	33237	6
231	54.23960094370819	68.43125000000026	0.05805321799384223	135	33372	7
232	54.24181658475654	54.46116504854357	0.05466034874987247	134	33506	8
233	54.820468186350844	112.10697674418643	0.11120973574887415	157	33663	2
234	54.86390710310325	59.1643598615916	0.08149484378188404	134	33797	3
235	54.91219503937149	59.69270072992691	0.3420843644575639	132	33929	11
236	54.99630385820854	63.323076923077146	0.39302136456524883	135	34064	13
237	55.10881990707893	66.24790874524741	0.32510110360604744	135	34199	9
238	54.85841591853446	30.068421052632004	0.27762475868180997	173	34372	10
239	54.86562123303332	55.57894736842094	0.3411320643638497	134	34506	4
240	54.69835261760222	38.13875968992292	0.20214683487570498	169	34675	12
241	54.74553575809286	59.41666666666657	0.06766151314351096	134	34809	1
242	54.77179418143066	57.371378091872636	0.04582515268614798	132	34941	6
243	54.1336958715182	-9.038036809815551	0.09401784873590237	164	35105	14
244	54.18652557946968	59.41666666666657	0.06858936708364914	134	35239	2
245	54.17845013259218	53.37898089171963	0.06493795451833241	134	35373	8
246	53.78399360554279	14.732797427653068	0.19660967553568165	171	35544	5
247	53.744068495985786	49.79148264984217	0.09164020509430856	132	35676	3
248	54.55290053829866	134.62727272727327	0.16328417460123698	180	35856	7
249	54.6759692340651	66.85977011494279	0.08687970196759259	135	35991	13
250	54.78566237191313	65.64528301886818	0.08891279432508681	135	36126	9
251	54.69304104231165	45.52352941176459	0.09478293043194395	132	36258	11
252	54.82406412026063	67.79534883720956	0.08575384351942274	135	36393	10
253	54.79097827781963	51.515479876160875	0.08375972064573374	134	36527	4
254	54.77896481611167	53.58963210702328	0.08940516096172911	132	36659	12
255	55.38269897747437	115.15238095238144	0.14813393999816507	157	36816	1
256	55.32261450266969	49.37425149700588	0.19436228453223384	134	36950	14
257	55.34560821579902	57.6219858156027	0.2292907599246863	132	37082	2
258	55.38379573225694	59.1643598615916	0.22774670728996618	134	37216	8
259	56.124831014371	129.48732394366246	0.22807239053027878	183	37399	6
260	56.09950922179917	53.592651757188364	0.09210392254502026	134	37533	5
261	56.117799843866884	57.92857142857131	0.09660182782073519	134	37667	7
262	56.07379575847169	51.71739130434771	0.08932754174986882	134	37801	3
263	56.06433231069089	55.127450980392055	0.06274599103785272	134	37935	13
264	56.09282691861846	58.913793103448164	0.05506839681027541	134	38069	9
265	56.09689864943227	56.499999999999886	0.055721179762882975	134	38203	11
266	56.069596329604614	53.36666666666655	0.0524966861262466	132	38335	10
267	56.04697728938549	53.80769230769218	0.05386979188492049	134	38469	4
268	56.07068559868341	58.41780821917797	0.05756867109839596	134	38603	12
269	56.08204944976728	57.207070707070606	0.1032913549622493	134	38737	1
270	56.01914378176803	49.79148264984217	0.16463518142700195	132	38869	2
271	55.956867170448774	49.79148264984217	0.17339665961988043	132	39001	14
272	55.86131342411742	46.40149253731334	0.16739709449536871	132	39133	8
273	55.881444062118234	57.874377224199144	0.10276714238253506	132	39265	6
274	55.95586039072782	63.323076923077146	0.14523581045645254	135	39400	5
275	55.9971438920837	60.08421052631574	0.12291508427372685	135	39535	7
276	56.02382193769894	58.66494845360813	0.10390980563946624	134	39669	3
277	56.111165807874194	64.75820895522416	0.10498783676712602	135	39804	9
278	56.15349076951376	60.34366197183099	0.11765016626428675	135	39939	4
279	56.95435740622017	136.24015444015504	0.16519684554463593	181	40120	13
280	57.5766768458566	119.18630136986353	0.18245550468143096	177	40297	11
281	58.317271779525704	131.63617021276653	0.2379440041475518	172	40469	10
282	58.34277991279428	60.86808510638298	0.22309717248987268	135	40604	1
283	59.016201034529644	125.68489208633136	0.15452514564134798	181	40785	12
284	59.012463484616	58.64244604316536	0.06787205464912183	132	40917	2
285	59.06124659884733	63.89077490774932	0.07744482534903067	135	41052	14
286	59.045093592318324	57.44594594594582	0.05700008193058754	134	41186	8
287	59.046286255011054	59.1643598615916	0.09659280349959189	134	41320	3
288	58.98749005912761	53.16666666666657	0.08530833116218225	134	41454	7
289	58.90876900469018	51.11538461538452	0.07318733699286162	134	41588	5
290	58.91384798130994	59.41666666666657	0.06835784485091025	134	41722	9
291	58.61799521578256	29.32857142857185	0.1603955609059473	171	41893	6
292	58.58308977342865	55.127450980392055	0.08492249161449832	134	42027	4
293	58.586396806728835	58.913793103448164	0.6656997452920942	134	42161	11
294	58.601374943924704	60.08421052631574	0.3897434093334057	135	42296	10
295	58.56217937630364	54.68181818181803	0.09703815517140858	134	42430	1
296	58.19641889640922	21.986131386861715	0.19562217575347352	167	42597	13
297	58.228454707445124	61.40000000000005	0.07941898769802518	135	42732	12
298	58.21824086744138	57.207070707070606	0.06317876701924338	134	42866	2
299	58.187332968570885	55.127450980392055	0.05494316300349449	134	43000	14
300	58.130354375727286	52.48947368421042	0.029957865223740086	132	43132	7
301	58.14321749863668	59.41666666666657	0.027127443854488544	134	43266	5
302	58.09557513256751	53.37898089171963	0.042664296591459816	134	43400	3
303	58.048286047908505	53.36666666666655	0.07033788074146617	132	43532	9
304	58.81152074468133	134.3717557251914	0.10033726954198145	182	43714	8
305	58.770677646078056	54.727210884353624	0.11484734217325847	132	43846	6
306	58.8515685707667	66.85977011494279	0.0944284509729456	135	43981	10
307	58.885175628741344	62.21227436823118	0.11171622099699798	135	44116	11
308	59.534763588766	123.84397163120627	0.18091758003447975	179	44295	4
309	59.55341595287833	61.40000000000005	0.1128374735514323	135	44430	1
310	59.558723898612705	60.08421052631574	0.10137004145869502	135	44565	12
311	59.61661034383711	65.34736842105288	0.11327939210114656	135	44700	14
312	59.545821598889304	52.53773584905651	0.1180539273504001	134	44834	2
313	59.510727621311005	56.03642384105945	0.11679228739951973	134	44968	7
314	59.425707161818146	51.008681672025624	0.10763072967529297	132	45100	3
315	59.96458210340129	113.31320132013259	0.1455330797421035	186	45286	13
316	59.92072575605148	55.57894736842094	0.10334968566894531	134	45420	9
317	59.887819197791664	56.63006993006983	0.057494517528649536	132	45552	6
318	59.83575918763193	54.68181818181803	0.05533714436773044	134	45686	8
319	59.541221739640505	30.38201438848961	0.17039523208350466	171	45857	5
320	59.56520520569734	61.93956834532384	0.20710912633825232	135	45992	10
321	59.614222298621776	64.46691449814152	0.34130709612811055	135	46127	4
322	59.64571643927192	62.763636363636515	0.09220992194281684	135	46262	1
323	59.682490044109976	63.323076923077146	0.07792227003309461	135	46397	12
324	59.382196612200346	29.653146853147263	0.2280322230139444	172	46569	11
325	59.47914629962165	69.07716535433097	0.06463950828269675	135	46704	2
326	59.48362057089116	59.92657342657339	0.07060927063671511	134	46838	14
327	59.42692530477956	53.8140939597314	0.12152362592292554	132	46970	7
328	59.29765605173176	46.499999999999865	0.16603721789459683	134	47104	13
329	59.26046896489864	55.57894736842094	0.09719694194509022	134	47238	9
330	59.21690336319754	54.90390879478814	0.07875853865893918	134	47372	6
331	59.13988912832717	51.515479876160875	0.08232791388212744	134	47506	8
332	59.16788592049714	61.93956834532384	0.09035945468478733	135	47641	5
333	59.9085834053782	133.2376344086026	0.1693938499273256	172	47813	3
334	59.873361682822676	56.386411149825626	0.08994062019116951	132	47945	4
335	59.875470171257604	60.08421052631574	0.10034562570077402	135	48080	1
336	59.75533626465206	47.862079510703246	0.17725406993519177	132	48212	12
337	59.39299692414576	23.521402214022658	0.19016277290389924	167	48379	10
338	59.33720789450162	53.8140939597314	0.08216780604738178	132	48511	2
339	59.2650858155566	52.12499999999988	0.1414812571966826	134	48645	11
340	59.308493780930455	63.60588235294142	0.07436935989945023	135	48780	14
341	59.281709542421844	56.63006993006983	0.09841582269379587	132	48912	7
342	59.27061599648568	58.172354948805356	0.04390807294133884	134	49046	9
343	59.24290983652082	56.499999999999886	0.05902551892978042	134	49180	13
344	59.261811699009705	61.13309608540927	0.04344374691998517	135	49315	6
345	59.2805245428737	61.13309608540927	0.03857211713437681	135	49450	8
346	59.20489321048844	51.71739130434771	0.08250112675908786	134	49584	5
347	59.26336113231614	65.05168539325868	0.07971895005967881	135	49719	3
348	59.228796827923674	55.806930693069155	0.2101751868404559	134	49853	4
349	59.23735096490759	60.08421052631574	0.3947802225748698	135	49988	1
350	59.16013225402012	51.515479876160875	0.34756703163260844	134	50122	10
351	59.26257045717162	69.40395256917022	0.26529789677372684	135	50257	14
352	59.329399298054454	65.94545454545481	0.20845263445818865	135	50392	2
353	59.22057433162258	48.44690265486711	0.1780811139007113	134	50526	11
354	58.82403525497302	19.566666666667018	0.15782058448122258	171	50697	12
355	58.70885550848389	47.3060606060605	0.06831271720655037	132	50829	7
356	58.75405047830327	63.228352490421656	0.07287986296460144	133	50962	13
357	58.70892932835894	54.241935483870854	0.07075161008692499	134	51096	9
358	58.6891811721991	56.734113712374445	0.04920841330912576	134	51230	6
359	58.58675838702578	48.44690265486711	0.04924762426917233	134	51364	8
360	58.62028648660876	61.93956834532384	0.06464853639955874	135	51499	3
361	58.596758040347325	56.26744186046497	0.05839343213323337	134	51633	5
362	58.59743994447993	58.66494845360813	0.14243192815068942	134	51767	4
363	58.58116353161231	56.96979865771797	0.09031213219486066	134	51901	1
364	58.58200138083227	58.66494845360813	0.08573882259539704	134	52035	10
365	58.53658204042462	54.04006734006724	0.08529945575829709	132	52167	11
366	58.422445827271126	47.122960725075416	0.08642496484698671	132	52299	2
367	58.47712911807591	63.89077490774932	0.08350642168963397	135	52434	14
368	58.48652449356182	59.41666666666657	0.5234858384772912	134	52568	9
369	59.41500845497541	151.3349206349214	0.23374833663304648	192	52760	12
370	59.427599111166394	60.674074074074056	0.215863421447295	133	52893	8
371	59.432588854320464	59.92657342657338	0.13959847635297634	134	53027	5
372	59.05285998070264	21.459701492537803	0.2502436350627118	166	53193	7
373	58.87423704127298	41.19056603773626	0.251684508571735	173	53366	13
374	58.306392106757684	2.0897435897439607	0.10156113595673533	165	53531	3
375	58.152917226786	42.9589041095895	0.145889949798584	180	53711	6
376	58.24308036221045	67.16923076923102	0.033122952779134116	135	53846	1
377	58.30823164814059	64.75820895522416	0.045970326882821544	135	53981	2
378	58.30932741385096	58.41780821917797	0.051271214413998734	134	54115	11
379	58.35387050334881	62.763636363636515	0.057742655718768084	135	54250	14
380	58.99098326411337	122.06514657980512	0.11247634887695312	179	54429	4
381	58.674735403303224	27.36619718309899	0.16634460898006664	170	54599	10
382	58.68928216691725	60.12941176470587	0.3577255019567963	133	54732	12
383	58.60183043286137	49.94410876132919	0.2066857209846155	134	54866	8
384	58.48599944841748	47.018731988472496	0.20246863009324714	134	55000	13
385	58.38744122908123	48.630177514792756	0.170966931243441	134	55134	7
386	58.8934521671089	108.98853503184763	0.15203974155780395	183	55317	9
387	59.31812243585697	101.36047904191658	0.09756506205907936	183	55500	5
388	59.283010518429094	55.806930693069155	0.051474425330090876	134	55634	1
389	59.25752155036855	56.734113712374445	0.05538581734272971	134	55768	11
390	59.227620753469516	56.26744186046497	0.05135221267814067	134	55902	2
391	59.14959373687333	51.42491909385102	0.06608572873202237	132	56034	4
392	59.83190924731605	127.3811447811452	0.08458063092534941	173	56207	3
393	60.485281911115294	125.16917562724063	0.06488271049373058	181	56388	6
394	60.42284844684285	54.241935483870854	0.12621681725800926	134	56522	10
395	60.32256263753366	50.39426751592345	0.22853764620694247	132	56654	12
396	60.77457303600305	105.52360248447255	0.1225002657982611	186	56840	14
397	60.763534622716186	59.67073170731696	0.16823260463885406	134	56974	8
398	60.81235210667771	65.64528301886818	0.08026425396954572	135	57109	13
399	60.81290943667476	60.86808510638298	0.071237345095034	135	57244	7
400	60.87030705986527	66.55267175572546	0.05414480633205838	135	57379	9
401	60.85853099656589	59.69270072992691	0.07860921368454442	132	57511	11
402	60.87206843028254	62.21227436823118	0.06422849584508825	135	57646	1
403	60.786085450897744	52.273770491803184	0.08338971571488814	132	57778	5
404	60.736293903319456	55.806930693069155	0.0918207453258002	134	57912	3
405	60.58052314305721	45.159217877094854	0.1053186744006712	134	58046	2
406	60.60794868085741	63.323076923077146	0.07609055836995443	135	58181	6
407	60.47492980010944	47.3060606060605	0.0894776980082194	132	58313	10
408	61.10560806394581	123.54275618374598	0.09969417119430284	177	58490	4
409	61.02410894533167	52.95569620253151	0.16489110064150683	134	58624	12
410	61.03326353933159	61.93956834532384	0.12852944268120658	135	58759	14
411	61.050567267574635	62.763636363636515	0.23450395089608653	135	58894	8
412	61.02671107943497	58.66494845360813	0.07140283442255277	134	59028	13
413	61.038566712322925	62.21227436823118	0.08221878475613065	135	59163	7
414	61.01981872635911	59.16376811594193	0.07479632262027625	132	59295	9
415	61.066073369284204	65.64528301886818	0.10219236303258825	135	59430	11
416	61.04206212012745	58.66494845360813	0.15284879883723473	134	59564	1
417	60.888612000401096	45.69705014749248	0.15713616573449338	132	59696	5
418	60.67582640949762	39.6100529100528	0.18727074247418027	132	59828	3
419	60.56850923301593	49.94410876132919	0.12805998503272212	134	59962	6
420	60.70601712314191	74.31929824561433	0.10177967960673168	133	60095	10
421	61.54461001313499	144.56530612244956	0.12465194989276189	186	60281	2
422	61.44231206115179	51.31481481481468	0.1910226736495744	134	60415	12
423	61.41431340097192	58.64244604316536	0.16355251543449634	132	60547	13
424	61.157887824214114	35.771755725191326	0.1645253536969247	169	60716	4
425	61.01130894597197	46.499999999999865	0.08236143482265187	134	60850	7
426	61.76841449450508	136.7218637992836	0.1028762552779534	173	61023	8
427	62.46548974805628	131.4759398496247	0.09781163804074551	188	61211	14
428	62.42012056486143	57.92857142857131	0.10938787460327148	134	61345	11
429	62.31016855015132	51.42491909385102	0.10452317469047778	132	61477	9
430	62.22514378772672	53.80769230769218	0.179482018769677	134	61611	1
431	62.06513044508755	46.223809523809386	0.20459689516009708	132	61743	5
432	62.018938600096135	57.44594594594582	0.09836821057903233	134	61877	6
433	61.86374921409517	46.499999999999865	0.1232613805514663	134	62011	10
434	61.48456242617957	23.945070422535593	0.1483331375573514	169	62180	3
435	61.57709029589368	70.73734939759066	0.1459578620062934	135	62315	12
436	61.567368862899414	60.604946996466396	0.1741989559597439	135	62450	2
437	61.54333285542984	59.16376811594193	0.08748852122913707	132	62582	13
438	61.43905337302939	51.11538461538452	0.07989899080191086	134	62716	4
439	61.403948553584804	57.92857142857131	0.08756887378977306	134	62850	8
440	61.38407573471562	59.41666666666657	0.08276119516856635	134	62984	7
441	61.341460329481144	57.12253521126751	0.11245341734452681	132	63116	11
442	61.212514752735004	48.44690265486711	0.10173437488612844	134	63250	14
443	61.12964126083679	52.92516556291376	0.1786398743138169	132	63382	1
444	61.07413432191263	55.57894736842094	0.11717375000910972	134	63516	5
445	61.052414639343326	58.902166064981834	0.171791596846147	132	63648	6
446	61.631361873421284	118.94713804713854	0.08538461986340974	190	63838	9
447	61.63991781990447	62.48695652173927	0.09248122462519894	135	63973	10
448	61.65287742033138	62.935877862595596	0.11313970465409129	133	64106	12
449	61.60841935319877	57.207070707070606	0.10180261953553157	134	64240	3
450	61.66402746735909	67.16923076923102	0.08155966158266421	135	64375	13
451	61.54112970765556	49.374251497005865	0.08583973414862334	134	64509	2
452	61.50017787003846	57.44594594594582	0.0783709056341826	134	64643	4
453	61.46446180562379	57.92857142857131	0.17159091892527112	134	64777	8
454	61.33220180295217	48.23846153846144	0.14886912432583896	132	64909	11
455	61.26791887287053	54.90390879478814	0.15116513665042705	134	65043	14
456	61.29414743321932	63.89077490774932	0.07420231854474103	135	65178	1
457	61.26763041931878	58.64244604316536	0.08664530696290912	132	65310	5
458	61.31776686412958	66.28127490039866	0.08231036107342943	133	65443	6
459	61.6247003065994	92.01111111111155	0.15522910670230264	190	65633	7
460	61.644512127062825	63.60588235294142	0.08698721991644966	135	65768	12
461	61.70602049416429	67.79534883720956	0.07839736938476563	135	65903	10
462	61.60742608726825	51.84657980456013	0.09493042483474269	132	66035	3
463	61.602682787249655	61.133096085409285	0.10499531074806497	135	66170	13
464	61.57330544391324	58.66494845360813	0.1139350720305941	134	66304	2
465	61.549215988090026	59.1643598615916	0.10686836669694132	134	66438	4
466	61.0376091785276	10.388535031847553	0.1074788261862362	170	66608	9
467	61.063291910271744	63.60588235294142	0.2219800030743634	135	66743	11
468	61.05870846113369	60.604946996466396	0.20084025065104166	135	66878	14
469	61.029407090808064	58.12857142857129	0.11097007086782744	132	67010	1
470	60.706336900497	28.722388059701984	0.16000264031546457	168	67178	8
471	60.715961703535044	61.668817204301135	0.11188056380660445	135	67313	6
472	60.37691061363148	26.81085271317872	0.08508605267628129	166	67479	5
473	60.37657812721348	60.34366197183099	0.12006957442672164	135	67614	7
474	60.315231700780046	54.241935483870854	0.0909514071336433	134	67748	10
475	61.081610915303784	136.95315315315366	0.12057862370650961	161	67909	12
476	61.0572192665824	58.64244604316536	0.07473029512347597	132	68041	13
477	60.98043688283377	53.37898089171963	0.08390499228861795	134	68175	3
478	60.95705697443709	58.64244604316536	0.08126804322907419	132	68307	2
479	60.92435081147238	57.68644067796594	0.07472856720881675	134	68441	4
480	60.78816790941826	47.3060606060605	0.2916162953232274	132	68573	11
481	60.60612564638248	42.583941605839954	0.3992804209391276	180	68753	9
482	60.56392850141691	56.386411149825626	0.21774663347186465	132	68885	8
483	60.173267939807	21.497872340426056	0.1686251617613293	168	69053	14
484	60.06945008690735	49.79148264984217	0.05630979032227487	132	69185	7
485	60.00465190710851	53.58963210702328	0.0648728356216893	132	69317	5
486	60.02818114561318	62.357575757575894	0.07426605368019047	133	69450	12
487	59.47495684214427	4.705750798722505	0.08570326730876626	167	69617	6
488	59.41613379129471	53.592651757188364	0.06674414962085325	134	69751	10
489	60.28738421808765	146.5411764705888	0.07614712512239497	188	69939	1
490	60.263796090192486	57.92857142857131	0.0530080475024323	134	70073	13
491	60.25280172790648	59.1643598615916	0.07148021726465936	134	70207	3
492	60.241917309243334	59.1643598615916	0.07880210164767593	134	70341	2
493	60.186770244994435	54.727210884353624	0.09113711299318256	132	70473	4
494	60.05162174025222	46.67191977077355	0.1280213825738252	134	70607	11
495	59.93925092344317	48.81454005934706	0.10787175306633337	134	70741	9
496	59.89113292401265	55.127450980392055	0.06266152680809818	134	70875	14
497	60.357658417877225	106.54368231046963	0.13013763901609812	161	71036	8
498	60.3358053831865	58.172354948805356	0.05230428567573206	134	71170	7
499	60.23964916421702	50.72018348623841	0.04506976213028182	134	71304	12
500	60.13318349018491	49.5930817610062	0.13554612073031339	132	71436	10
501	60.08992096221375	55.806930693069155	0.1760163093680766	134	71570	13
502	60.08572906966479	59.67073170731696	0.05014395002108901	134	71704	3
503	60.02294870204506	53.80769230769218	0.11233018049553259	134	71838	2
504	59.57976102687131	15.704181184669338	0.09878183696084394	167	72005	6
505	60.2999634166026	131.60000000000045	0.1269221800923999	183	72188	5
506	60.139348397821195	44.23846153846188	0.11597549570778201	173	72361	4
507	61.06038502136987	152.24301075268875	0.10776881881171677	197	72558	1
508	61.063781171156165	61.40000000000005	0.12623630099826388	135	72693	11
509	61.06447432029869	61.133096085409285	0.12601698416250723	135	72828	9
510	61.05512369474276	60.12941176470587	0.10205925676159393	133	72961	14
511	60.97836226671253	53.37898089171963	0.07917251871592963	134	73095	8
512	60.96817937664614	59.96007326007321	0.17331816933371805	132	73227	7
513	60.9527703101524	59.42727272727261	0.09943080670905835	132	73359	10
514	61.05312446359096	70.98818565400872	0.07026070042660362	133	73492	13
515	61.46964357866729	102.70503597122335	0.22906035897116991	159	73651	12
516	61.39534781628129	54.04006734006724	0.054551312417695015	132	73783	2
517	61.339463645049165	55.806930693069155	0.06445515333716549	134	73917	3
518	61.2795935987626	55.35245901639335	0.050399748247061206	134	74051	6
519	61.275478513838806	60.86808510638298	0.08137618170844184	135	74186	4
520	61.28484647238273	62.21227436823118	0.10818623436821831	135	74321	1
521	61.16595725530781	49.395924764890154	0.20412130066842743	132	74453	11
522	61.17369336620797	61.93956834532384	0.24871187563295719	135	74588	9
523	60.864219590440634	30.22631578947403	0.1970235203089339	178	74766	5
524	60.844715325570704	58.913793103448164	0.0783288585605906	134	74900	14
525	60.855663855768235	61.93956834532384	0.12823056821469908	135	75035	13
526	60.626200642816094	37.909342560553995	0.12197604875886038	178	75213	8
527	60.72578382467246	70.58451882845247	0.09351672156382415	177	75390	7
528	60.65445250399762	53.592651757188364	0.10579526958180897	134	75524	12
529	60.63455746349372	58.66494845360813	0.09881870070500161	134	75658	2
530	60.45231495292563	42.41030640668513	0.12109012314767549	132	75790	3
531	60.48102257262715	63.323076923077146	0.0827328364054362	135	75925	6
532	60.40327835350153	52.70660066006586	0.10735123085253166	132	76057	4
533	60.96204691676786	116.28013468013513	0.13873162816782467	183	76240	10
534	60.90202030425547	54.959385665528906	0.09457614205100319	132	76372	9
535	60.73177059301619	43.87704918032774	0.10241716299484026	134	76506	11
536	60.7211602041592	59.67073170731696	0.18071110568829438	134	76640	5
537	60.33429743932691	22.034883720930623	0.2796820286342076	175	76815	1
538	60.19717583897945	46.62213740458071	0.12667238507952008	175	76990	14
539	60.16395846655456	56.8754385964911	0.04352624849839644	132	77122	7
540	60.13107326785392	56.8754385964911	0.050269368923071656	132	77254	8
541	60.11641201971146	58.66494845360813	0.05153631452304214	134	77388	12
542	60.12392875057818	60.86808510638298	0.06327496281376592	135	77523	2
543	59.91911603649898	39.64265734265777	0.10436273564053121	177	77700	13
544	59.774812516583424	45.488764044943714	0.04758212103772519	134	77834	6
545	59.68230829385661	50.524390243902296	0.0474499517412328	134	77968	3
546	59.62790456575675	54.241935483870854	0.0616642254502026	134	78102	10
547	59.113177121522675	8.155160142349189	0.08526353719757825	164	78266	4
548	59.166714495288865	64.46691449814152	0.07561386249683522	135	78401	9
549	59.142388487459726	56.734113712374445	0.1597851710533028	134	78535	11
550	59.12782900936479	57.68644067796594	0.07077077609389576	134	78669	5
551	59.055756326747776	51.92056074766345	0.08888056029134722	134	78803	1
552	59.06604086874345	60.08421052631574	0.10333843937626591	135	78938	14
553	59.13483500551057	65.94545454545481	0.07372933140507451	135	79073	7
554	59.21517896314777	67.16923076923102	0.07053212059868706	135	79208	12
555	59.199891580295954	57.68644067796594	0.06409243683316815	134	79342	2
556	59.096010676915355	48.81180124223591	0.06899340947469075	132	79474	8
557	59.09932329741893	59.42727272727261	0.07523285981380579	132	79606	13
558	59.04647100404205	53.8140939597314	0.07559898405364066	132	79738	6
559	59.059442913719934	60.34366197183099	0.0833939516985858	135	79873	10
560	58.98199663273088	51.31481481481468	0.07739543914794922	134	80007	3
561	58.90433795672615	51.21612903225795	0.11241880330172452	132	80139	4
562	58.85569525055956	54.04006734006724	0.08459457484158603	132	80271	9
563	58.825207604984655	55.806930693069155	0.07458531678612552	134	80405	11
564	58.81381993571447	57.68644067796594	0.059843604244402986	134	80539	1
565	58.968342824223434	74.26610878661114	0.061267294707121674	135	80674	12
566	58.92993390578512	55.127450980392055	0.060549422876158755	134	80808	7
567	59.572062128564724	123.142756183746	0.10996196810053198	181	80989	5
568	59.635796052733625	65.94545454545481	0.05500734823721427	135	81124	8
569	59.52573986735422	48.630177514792756	0.055129496019278	134	81258	2
570	59.572260246458455	64.17777777777803	0.060689403392650464	135	81393	13
571	59.46720431066054	49.06666666666712	0.10691415179859508	176	81569	14
572	59.41060919063086	53.80769230769218	0.07912097048403612	134	81703	6
573	59.388573805795254	57.207070707070606	0.09232426401394517	134	81837	10
574	59.37641161722535	58.172354948805356	0.09281280859192806	134	81971	4
575	59.40751706627049	62.48695652173927	0.10696534050835503	135	82106	3
576	59.326590043755935	51.31481481481468	0.0527795072811753	134	82240	9
577	59.339373613283044	60.604946996466396	0.04819896486070421	135	82375	1
578	58.80600145988403	6.002158273381639	0.13819815044754122	163	82538	11
579	58.80211952747697	58.41780821917797	0.037730647556817355	134	82672	12
580	58.82542929305629	61.133096085409285	0.03835505379570855	135	82807	7
581	58.84322447009039	60.604946996466396	0.038134550165247035	135	82942	8
582	58.858228845107796	60.34366197183099	0.038855859968397355	135	83077	2
583	58.8186856446046	54.90390879478814	0.04139945756143598	134	83211	5
584	58.781773297962474	55.127450980392055	0.04378778187196646	134	83345	13
585	58.72762223164952	53.36666666666655	0.04047549493385084	132	83477	14
586	58.73994674193376	59.96007326007321	0.039077014634103485	132	83609	3
587	58.736725356706195	58.41780821917797	0.03848691484821377	134	83743	4
588	58.68743502621606	53.80769230769218	0.03866885313347204	134	83877	6
589	58.675020135413355	57.44594594594582	0.04715479665727758	134	84011	10
590	58.51778606309148	42.95161290322569	0.21550770659944904	134	84145	9
591	58.507067661920026	57.44594594594582	0.05668076472495919	134	84279	1
592	58.52804645526549	60.604946996466396	0.051719421810574	135	84414	11
593	58.501807513204184	55.90415224913484	0.03652526754321474	132	84546	8
594	58.45703059562841	54.02411575562691	0.028385342057071515	134	84680	2
595	58.55358091224022	68.11206225680961	0.029831858034487124	135	84815	5
596	58.385378436451155	41.7333333333338	0.10950337835105069	166	84981	12
597	58.25311683085759	45.159217877094854	0.029695553566092877	134	85115	7
598	58.24745006932868	57.68644067796594	0.04190194428856693	134	85249	14
599	58.17021947107441	50.524390243902296	0.04820014113810525	134	85383	13
600	58.16297673582313	57.44594594594582	0.04766155356791482	134	85517	10
601	58.15821137524456	57.68644067796594	0.04759441560773707	134	85651	4
602	58.07415938197404	49.75301204819263	0.05423096400588306	134	85785	6
603	57.72201918675571	22.86013986014025	0.15047919329474954	170	85955	3
604	57.664004602364784	51.92056074766345	0.04919885165655791	134	86089	9
605	57.32087332827096	23.350877192982892	0.09154485253726735	170	86259	1
606	56.8247993467613	7.71347517730544	0.097908310773896	164	86423	11
607	56.828622060364395	57.207070707070606	0.050816005735255	134	86557	8
608	56.8230102583654	56.26744186046497	0.05079055188307122	134	86691	2
609	56.89001092501252	63.523076923077134	0.05041070809041647	133	86824	7
610	56.88611081576239	56.499999999999886	0.04769320274466899	134	86958	5
611	56.88694769418195	56.96979865771797	0.04797811294669536	134	87092	14
612	56.842972954082235	52.48947368421042	0.05790226026014848	132	87224	13
613	56.88322407560524	60.86808510638298	0.06489847677725333	135	87359	4
614	56.89611538433724	58.172354948805356	0.06716309732465602	134	87493	10
615	56.97746795598407	65.03137254901986	0.06799467703453581	133	87626	6
616	57.44132341341053	103.36301369863057	0.0813955562870677	164	87790	12
617	57.500140948507195	63.323076923077146	0.06134741747820819	135	87925	3
618	57.465540212422795	54.04006734006724	0.04202747706210974	132	88057	9
619	57.47260835978662	58.172354948805356	0.05216348705007069	134	88191	1
620	57.479167990474465	58.12857142857129	0.04161560896671179	132	88323	14
621	57.513057161633554	60.86808510638298	0.0353303556089048	135	88458	5
622	57.54136320973553	60.34366197183099	0.03475997712877062	135	88593	10
623	57.40237528044942	43.64257028112513	0.11082462983972886	170	88763	2
624	58.073606846793865	124.525531914894	0.1081118764756601	158	88921	13
625	58.137080895057444	64.42101167315201	0.04542674516376696	133	89054	12
626	59.32541144357294	176.97013574660699	0.12482481820242745	175	89229	8
627	59.239359163999595	50.72018348623841	0.0331112306509445	134	89363	4
628	59.25564642342343	60.86808510638298	0.025580453872680663	135	89498	6
629	59.129311333235	46.62213740458071	0.1820334952218192	175	89673	7
630	60.06156367444811	152.35454545454584	0.14756361643473306	180	89853	11
631	60.08307078138594	62.21227436823118	0.04922274130362052	135	89988	3
632	60.04030938050277	55.806930693069155	0.07687880387946741	134	90122	9
633	60.006247423821485	56.63411371237444	0.12711024814181857	135	90257	14
634	59.912356728724376	50.617177914110336	0.06507911125238794	137	90394	10
635	59.955815250989374	64.25820895522416	0.06750148364475796	140	90534	12
636	59.88492376514615	52.86666666666657	0.06017297201783118	137	90671	2
637	59.81014053409534	52.40660066006586	0.04674334349455657	135	90806	6
638	59.72638977810503	51.435064935064794	0.05189825527703584	134	90940	4
639	59.797818188016294	66.86923076923102	0.05294563459313434	138	91078	11
640	59.74211211497966	54.22721088435363	0.05161287488728544	137	91215	7
641	59.31565337627501	17.09623824451461	0.12382591376870365	177	91392	1
642	59.08221112822655	35.971428571429044	0.11584119363264604	176	91568	5
643	59.05638901694428	56.499999999999886	0.06150542444257594	134	91702	3
644	59.96447260878923	149.86474820143937	0.16963812942904327	191	91893	13
645	60.903161216034675	153.83333333333388	0.16108330008909874	194	92087	8
646	61.49436904049405	120.02394366197224	0.0979636879854424	172	92259	9
647	61.40480270857967	52.53773584905651	0.05041873988820546	134	92393	14
648	61.335823988424565	54.50693069306916	0.09565846449663849	147	92540	2
649	61.321588492222624	59.912274368231	0.07483829425860054	158	92698	11
650	61.1885443864415	48.0171779141103	0.06485733664108932	163	92861	10
651	61.145308427113164	56.86494845360814	0.06884310747447767	152	93013	7
652	61.056924649772725	52.30693069306913	0.04852017284145017	169	93182	12
653	61.02081486273446	57.44594594594582	0.07399777512052166	134	93316	13
654	60.97660671410711	56.59999999999983	0.04849104021416336	183	93499	4
655	60.87087973491392	50.40390879478811	0.04455052008175983	179	93678	6
656	60.87262548301933	61.04545454545456	0.048357823620671814	184	93862	1
657	61.79038039973725	152.64811715481227	0.16294795908826462	188	94050	3
658	61.67754590267057	50.50693069306917	0.039517147655793054	187	94237	5
659	61.61422990310333	55.345945945945836	0.023322139247771233	155	94392	8
660	61.527644566097614	52.95569620253151	0.024180154302226965	134	94526	9
661	61.420516268584784	50.814814814814675	0.035773431654456705	139	94665	14
662	61.44098025088035	63.46691449814148	0.05759721953293373	145	94810	7
663	61.38864115544225	56.20707070707062	0.05733469459745619	144	94954	11
664	61.314544217572035	53.97894736842095	0.045067243576049805	150	95104	12
665	61.250440297887664	54.904152249134846	0.08600306175124477	142	95246	6
666	61.8071420804758	116.9206185567015	0.11243566625258501	170	95416	2
667	61.70596539651314	51.68947368421042	0.04980410848345075	140	95556	1
668	61.65336520200747	56.44594594594584	0.07279855675167507	144	95700	4
669	61.65270111520479	61.586956521739204	0.05741805500454373	144	95844	3
670	61.65556978750598	61.93956834532384	0.03738088607788086	135	95979	8
671	62.12400689538632	108.49928057553991	0.10640262317106214	173	96152	13
672	62.95939596550531	145.66291390728531	0.10283630062835385	198	96350	10
673	62.909087720135965	57.92857142857131	0.03162935598572688	134	96484	9
674	63.765173313522844	148.51764705882417	0.10231527002846322	205	96689	5
675	63.715202431451445	58.768085106382806	0.035894002669896834	156	96845	14
676	63.74186121794774	66.38108108108135	0.06751451100388618	146	96991	11
677	63.625109272434926	52.06666666666657	0.08046358042749865	145	97136	7
678	63.63331100989926	64.4452830188682	0.07124420088164661	147	97283	1
679	63.59604157021225	59.90636704119844	0.05661733998548264	149	97432	12
680	63.51352559895457	55.344444444444306	0.06663471630641392	140	97572	8
681	63.36230516946345	48.39148264984218	0.057236658383722175	146	97718	4
682	63.219045754132445	49.03636363636353	0.08658856359021418	145	97863	6
683	63.114521963257786	52.766666666666566	0.06053341298863508	138	98001	13
684	63.017043410291876	53.36666666666655	0.04000757318554503	132	98133	9
685	62.88250360681958	49.56306306306293	0.051460824795623326	134	98267	10
686	63.22217538603802	96.8496815286628	0.15091672994322697	177	98444	2
687	62.91874499908412	32.8791366906479	0.1521693847991608	182	98626	3
688	62.898238400157105	60.86808510638298	0.024561504081443503	135	98761	5
689	62.85590550069161	58.66494845360813	0.025577449086886733	134	98895	14
690	62.790020864289346	56.26744186046497	0.04527659558538181	134	99029	11
691	62.653986327288244	49.18656716417901	0.050922308395157996	134	99163	7
692	62.60673217830107	57.92857142857131	0.043219025455304046	134	99297	8
693	62.5421093009625	56.14444444444431	0.04512655373775598	132	99429	6
694	62.491147667412335	57.44594594594582	0.03693852495791307	134	99563	4
695	62.477567151592304	61.13309608540927	0.04142946313928675	135	99698	13
696	62.348722297686436	49.5930817610062	0.03595463796095415	132	99830	9
697	62.35565843237381	63.042335766423534	0.02137406137254503	135	99965	10
698	63.19910184805008	146.7000000000005	0.1466503254202909	172	100137	12
699	63.92282838682149	135.57175572519134	0.1357687894035788	170	100307	1
700	63.908469668170675	62.48695652173927	0.023253968909934714	135	100442	3
701	63.866092288562136	59.67073170731696	0.020760561103251442	134	100576	2
702	63.70049197173712	47.3060606060605	0.15865103403727213	132	100708	5
703	63.676911709554	61.34246575342471	0.04947370419399344	139	100847	14
704	63.72445509245846	68.43125000000026	0.039786042107476126	135	100982	11
705	63.63624962948176	54.90390879478814	0.028909300690266624	134	101116	8
706	63.71754566977231	71.76585365853686	0.029257255130343968	135	101251	6
707	63.646670912375285	56.63006993006983	0.03838362477042458	132	101383	13
708	63.643434972482304	63.323076923077146	0.04040930006239149	135	101518	4
709	63.654582712309725	64.75820895522416	0.027910193690547237	135	101653	9
710	63.61230961245935	59.42727272727261	0.025171709783149487	132	101785	10
711	63.51426343941168	53.80769230769218	0.02896282032354554	134	101919	12
712	63.38509844080031	50.59776357827463	0.07538719610734419	132	102051	1
713	63.80624132142299	105.49938650306794	0.1260420592904788	171	102222	7
714	64.28131450142911	111.31355932203425	0.24391577709680315	174	102396	2
715	64.79517268508614	115.66713286713328	0.17969193932605765	171	102567	3
716	64.71492827530845	56.77073170731687	0.034853914764029846	163	102730	14
717	64.55108076770328	48.33017751479275	0.03681685106597678	137	102867	11
718	65.10343297372488	119.7863013698635	0.12554031505919339	171	103038	5
719	65.10291549792022	65.05168539325868	0.034303725207293474	135	103173	8
720	65.01225058135162	56.03642384105945	0.031091846636871794	134	103307	13
721	64.87728287429972	51.515479876160875	0.03481134016122391	134	103441	6
722	64.74697584360233	51.84657980456013	0.06267148798162286	132	103573	4
723	64.67073143727899	57.12253521126751	0.04315808325102835	132	103705	12
724	64.59272210948338	56.86979865771797	0.03894130212289316	135	103840	1
725	64.40102449563929	45.422960725075434	0.07542453996287096	149	103989	9
726	64.92253198117936	116.55177304964592	0.13440009902195377	181	104170	10
727	64.89694302500394	62.363636363636466	0.03709881940333963	139	104309	3
728	65.57600919345941	132.80355987055077	0.16674325863520303	192	104501	7
729	65.54511866674221	62.48695652173927	0.04921692035816334	135	104636	11
730	65.45234189867944	56.26744186046497	0.04962733966201099	134	104770	14
731	66.27123024439852	147.34117647058875	0.12164236704508463	180	104950	2
732	66.24742569103202	63.89077490774932	0.046481121910942926	135	105085	5
733	66.16912951631349	58.41780821917797	0.044761600779063666	134	105219	8
734	66.12143822115036	61.40000000000005	0.04901573393079969	135	105354	6
735	66.04194738842692	58.172354948805356	0.047372430118162244	134	105488	13
736	65.92176907209891	54.02411575562691	0.047974184377869565	134	105622	4
737	65.90546953084412	64.29181494661948	0.03838166230016475	139	105761	1
738	65.85774579638976	61.133096085409285	0.03019712589405201	135	105896	10
739	65.71763413647146	51.84657980456013	0.03741923606756962	132	106028	3
740	65.75673948524759	69.62816901408503	0.04396636629365181	183	106211	9
741	65.84255304277607	74.33809523809586	0.07303667068481445	208	106419	12
742	65.80352319580155	61.93956834532384	0.031227376725938585	135	106554	7
743	65.73712564500296	59.16376811594193	0.030125296477115517	132	106686	14
744	65.68319100827124	60.34366197183099	0.03326108014142072	135	106821	11
745	65.5960570847657	56.96979865771797	0.03491269296674586	134	106955	2
746	65.5074376510418	56.734113712374445	0.026072035974531033	134	107089	5
747	65.4690514465744	61.668817204301135	0.022522606673064056	135	107224	6
748	65.41106824918182	59.67073170731696	0.02237169600244778	134	107358	13
749	65.2488232383318	49.18656716417901	0.019702879350576828	134	107492	4
750	65.78050167261515	118.41666666666721	0.1657479641705575	169	107661	8
751	65.76389045433861	64.11937984496149	0.04444013323102679	133	107794	10
752	65.99785419880185	89.16026490066268	0.08388828802965358	167	107961	1
753	65.88423391226553	54.63582554517124	0.0334620475769043	138	108099	12
754	65.78118104682709	55.57894736842094	0.02552011475634219	134	108233	14
755	65.71753590302548	59.41666666666657	0.029156067478122997	134	108367	7
756	65.6494984750297	58.913793103448164	0.022731232998976066	134	108501	11
757	65.54652808044334	55.35245901639335	0.023549138610042743	134	108635	2
758	66.17386084524152	128.27980456026117	0.15410726149003584	182	108817	3
759	66.92322824385626	141.11060070671417	0.15207536033030306	178	108995	9
760	66.78989228248793	53.58963210702328	0.031416278896909774	132	109127	13
761	67.33989371553494	121.7900355871891	0.13108887757069965	169	109296	6
762	67.22590747679229	55.941269841269744	0.023861439331718113	138	109434	8
763	67.90676604908319	135.3117647058829	0.14691035622044613	190	109624	5
764	67.87136753357377	64.36691449814153	0.026049498249502742	136	109760	10
765	67.87644123365331	68.37873754152848	0.10656725494555255	179	109939	4
766	67.76380502644498	56.61282051282038	0.02118139336074608	138	110077	12
767	68.31322579970995	122.70588235294157	0.18459974661381287	169	110246	1
768	68.21674302624893	58.66494845360813	0.028933409434645924	134	110380	14
769	68.07149867290951	53.692307692307594	0.03164217626448158	139	110519	11
770	68.0021146470345	61.133096085409285	0.032942397506148725	135	110654	3
771	67.85376016723082	53.16666666666657	0.03648452972298238	134	110788	2
772	67.76949529283124	59.42727272727261	0.03807307734633937	132	110920	9
773	67.59704424234194	50.524390243902296	0.028219086020740112	134	111054	13
774	67.53207379991852	61.09999999999999	0.07982907903955337	188	111242	7
775	67.54428247368405	68.75294117647086	0.018004272602222583	135	111377	8
776	68.07130149633676	120.24618473895637	0.12931125546679084	162	111539	6
777	68.1557608951665	76.51724137931066	0.025268436335831236	139	111678	10
778	68.59044890024992	111.62456140350928	0.1082474197471998	181	111859	5
779	68.53123272293574	62.66883116883122	0.02970693940701692	184	112043	4
780	68.4232061099921	57.72857142857131	0.021977028426002052	136	112179	1
781	68.345654899956	60.66808510638296	0.021293843749665867	137	112316	14
782	67.89667547513945	23.447712418300565	0.06278520245705882	124	112440	9
783	67.74916054763057	53.14518272425235	0.04137005227984804	132	112572	2
784	67.63254434151528	56.08753993610209	0.03276171920992804	141	112713	11
785	67.51200837178435	55.57894736842094	0.025222109324896512	134	112847	3
786	68.0049164570806	116.80281690140885	0.12813653889492418	169	113016	12
787	68.02552067896399	70.06533864541859	0.027708302603827582	135	113151	13
788	67.81371374803642	46.84482758620679	0.02757220303834374	134	113285	8
789	67.62953585820496	49.395924764890154	0.029502357497359768	132	113417	10
790	68.01187849245446	105.86379928315448	0.12812618039688975	159	113576	7
791	68.405102991112	107.33432835820939	0.18083721816919412	157	113733	6
792	68.3431747048832	62.21227436823118	0.026062389656349466	135	113868	1
793	68.20878204578224	54.90390879478814	0.02488092344198654	134	114002	14
794	68.0979195774371	57.12253521126751	0.03895691308108243	132	114134	9
795	68.73392922924637	131.69888475836476	0.14295830811269183	169	114303	5
796	68.5196505430145	47.3060606060605	0.03871614282781428	132	114435	2
797	68.40415202416155	56.96979865771797	0.03184610338353399	134	114569	3
798	68.24966746594524	52.95569620253151	0.05384834488826012	134	114703	12
799	69.15625026148447	158.90794701986812	0.20865374863749803	198	114901	4
800	69.57554982783515	111.08620689655217	0.1824246964803556	164	115065	13
801	70.37600485587258	149.62105263157937	0.25367496102888953	187	115252	11
802	70.17216544223449	49.992063492063394	0.02671112409278528	134	115386	8
803	70.09808015144851	62.763636363636515	0.021256994318079064	135	115521	10
804	69.88715230943558	49.00529595015566	0.02506475015120073	132	115653	7
805	69.77741871737571	58.913793103448164	0.02771718644384128	134	115787	6
806	69.64934251677913	56.96979865771797	0.016474825232776245	134	115921	1
807	69.59175684068883	63.89077490774932	0.01915567715962728	135	116056	9
808	69.45162874596616	55.57894736842094	0.021486721821685335	134	116190	14
809	69.31615398099784	55.90415224913484	0.0320094751589226	132	116322	2
810	69.28851915874512	66.55267175572546	0.02264383280718768	135	116457	3
811	69.06932961933158	47.36956521739117	0.02518759022897749	134	116591	5
812	68.90353105998037	52.48947368421042	0.028028466484763405	132	116723	12
813	68.79378146366628	57.92857142857131	0.017016958834520028	134	116857	4
814	68.69002173122139	58.41780821917797	0.01215557198026287	134	116991	13
815	68.54773316439461	54.46116504854357	0.016825684860571108	134	117125	8
816	68.3828506039925	52.059477124182905	0.058513117559028396	132	117257	10
817	68.23181190686977	53.27898089171963	0.05444166395399305	135	117392	7
818	69.11091803022532	156.14242424242462	0.12909943262736004	180	117572	11
819	69.86035020330654	144.05413533834644	0.10678004673549107	175	117747	6
820	69.70386125235706	54.21145510835901	0.030305959176326145	138	117885	9
821	69.55641649648878	54.959385665528906	0.040454561060125176	132	118017	12
822	70.01328090295246	115.24285714285753	0.13227938470386325	168	118185	14
823	70.4754994452743	116.23513513513555	0.08085395934733938	188	118373	1
824	70.2982050186449	52.746056782334286	0.033100494697912416	134	118507	4
825	70.09852084079887	50.32978723404241	0.03802521193205421	134	118641	13
826	70.04899464878433	65.1459016393446	0.0646855115890503	200	118841	2
827	69.97239359118537	62.388888888889035	0.03676695103267971	139	118980	10
828	69.9231865092061	65.05168539325868	0.029100734216195565	135	119115	7
829	69.90507526668215	68.11206225680961	0.027579611319082754	135	119250	11
830	69.92908811825562	72.306360424029	0.17005880604619567	230	119480	5
831	69.9770297952126	74.72325581395401	0.11497779468913655	182	119662	8
832	69.9543504063514	67.70909090909146	0.11319986979166667	231	119893	3
833	69.78436386431319	52.95569620253151	0.018411814276851825	134	120027	6
834	69.66097968512952	57.44594594594582	0.022479559058573708	134	120161	12
835	69.60175504728883	63.738515901060275	0.021846079997879138	139	120300	14
836	69.48502321110166	57.92857142857131	0.01863212727788669	134	120434	1
837	69.37145869327635	58.12857142857129	0.018794886993639397	132	120566	4
838	70.0148956214951	133.71515151515197	0.1276397274038886	177	120743	9
839	69.78234726588076	46.76006006005993	0.032791791540203674	132	120875	13
840	69.65898325268141	57.44594594594582	0.0199831137016638	134	121009	10
841	69.55656008682126	59.41666666666657	0.023705676420411066	134	121143	7
842	69.41678395963727	55.57894736842094	0.019275989105452352	134	121277	8
843	69.23896676939154	51.63506493506479	0.029095978447885223	132	121409	3
844	69.2030299318863	65.64528301886818	0.05428371429443359	135	121544	6
845	69.67450451856094	116.35048859934903	0.12255599484806172	171	121715	11
846	70.04119629648002	106.34368231046966	0.12525652083882524	163	121878	5
847	70.52613727469169	118.53529411764752	0.17716705555818518	196	122074	2
848	70.38621703906851	56.53411371237444	0.034720231505001295	136	122210	12
849	70.29103571974164	60.86808510638298	0.025457675368697554	135	122345	1
850	70.17477484708031	58.66494845360813	0.026934460027893976	134	122479	4
851	69.98022893347189	50.72018348623841	0.030750246190313083	134	122613	9
852	70.51364066627741	123.32140221402267	0.13010768663315547	168	122781	14
853	70.31965810576848	51.11538461538452	0.033331885266659866	134	122915	13
854	70.13363543775428	51.71739130434771	0.028551653249939874	134	123049	10
855	70.11661158337674	68.43125000000026	0.023632581145675093	135	123184	3
856	70.72592694902445	131.04814814814867	0.1221458210664637	170	123354	7
857	70.60531716407029	58.66494845360813	0.026742767931810067	134	123488	8
858	70.35797996876094	45.871597633135956	0.04005812153671727	132	123620	6
859	70.2511074861465	59.67073170731696	0.03308782648684373	134	123754	5
860	70.16528458332805	61.668817204301135	0.03186856729012948	135	123889	11
861	69.99069774409543	52.70660066006586	0.07519060915166681	132	124021	1
862	69.91467965554335	62.388888888889035	0.046924899807936855	139	124160	4
863	70.5311314984437	131.5598639455786	0.17200293011135526	180	124340	2
864	70.4432158669125	61.739568345323825	0.04775611153484261	137	124477	14
865	70.84709188434401	110.8308176100634	0.13383368386162653	180	124657	12
866	70.70492166480126	56.630069930069816	0.02935900290807088	132	124789	10
867	70.53594937123017	53.80769230769218	0.032756848121756936	134	124923	13
868	70.37769688858798	54.710701107010905	0.14321158914005055	153	125076	3
869	70.4814026783228	80.7482758620697	0.018118647347509332	226	125302	9
870	70.35652413541054	57.993548387096624	0.09282825896458596	161	125463	7
871	70.86978940253101	121.68305084745799	0.12592163751291674	172	125635	8
872	71.59479654447694	143.37050359712282	0.1446927941363791	184	125819	6
873	71.65247997834958	77.36313993174113	0.1921567969559306	181	126000	11
874	71.53819842180931	60.224324324324286	0.04845126696995326	140	126140	4
875	71.36704625125581	54.4229813664595	0.08200017265651537	138	126278	1
876	71.30389264267585	65.05168539325868	0.05613199163366247	135	126413	2
877	71.1701394305348	57.92857142857131	0.048447036031466814	134	126547	14
878	71.04016158571751	58.172354948805356	0.021191107693003183	134	126681	10
879	70.94915565331357	61.93956834532384	0.03309951005158601	135	126816	13
880	70.82880202781492	58.913793103448164	0.03522852997281658	134	126950	12
881	70.75344115985465	63.29271523178822	0.10180189325946018	227	127177	5
882	70.70236129371065	65.64545454545481	0.05998928650565769	138	127315	9
883	70.65681676822602	66.14790874524742	0.03251706151401296	136	127451	7
884	70.53197215003182	58.172354948805356	0.0283494903080499	134	127585	8
885	70.41829602714742	59.1643598615916	0.027452417274019612	134	127719	6
886	70.27315458936728	55.90415224913484	0.04541902469866203	132	127851	11
887	70.75705940710998	118.66363636363673	0.11425189538435503	176	128027	3
888	70.6287745273246	57.92857142857131	0.03987554293959888	134	128161	4
889	70.53648678205136	61.40000000000005	0.036164008246527775	135	128296	1
890	70.49057645968539	65.94545454545481	0.03665769011886032	135	128431	2
891	70.37469235573835	58.902166064981834	0.030292375521226364	132	128563	10
892	70.27178753744411	60.08421052631574	0.016639690045957212	135	128698	14
893	70.23766736321909	66.85977011494279	0.01612511917396828	135	128833	12
894	70.21618621197496	68.08955223880628	0.03528294117330647	139	128972	5
895	70.56197306780393	104.79487179487218	0.13184910836304434	169	129141	13
896	70.31625418698425	45.990084985835566	0.014763262734484316	134	129275	7
897	70.07468255420531	46.15909090909081	0.04021868065221986	134	129409	9
898	69.95322144294897	57.92857142857131	0.06188735677235162	134	129543	4
899	69.83541277800754	58.172354948805356	0.03727677331041934	134	129677	3
900	69.6384222865911	50.13636363636353	0.024189434834380647	134	129811	2
901	69.51326341583786	57.12253521126751	0.03867346951455781	132	129943	12
902	69.35837193923574	54.02411575562691	0.025482841392061605	134	130077	14
903	69.95323881272876	128.84505928853793	0.17039878933415936	173	130250	6
904	69.82104756172521	56.734113712374445	0.027988791465759277	134	130384	10
905	70.47140413591639	134.8567049808433	0.1866513028170893	183	130567	11
906	71.4716751691841	170.49850746268706	0.1894610448537139	197	130764	8
907	71.30157006797769	54.46116504854357	0.024070353650335056	134	130898	5
908	71.64532359806715	105.67692307692357	0.14218467094994694	173	131071	1
909	71.4267851885849	49.79148264984217	0.0424740169987534	132	131203	13
910	71.31756680666372	60.504946996466394	0.029185177648768705	136	131339	7
911	71.23662190782785	63.223076923077144	0.02378175188513363	136	131475	9
912	71.08693010735422	56.26744186046497	0.029599164848896995	134	131609	4
913	70.9141377293576	53.80769230769218	0.033270330571416595	134	131743	3
914	70.78428206634975	57.92857142857131	0.04912501306676153	134	131877	12
915	70.57835988060688	50.1920634920634	0.06505836862506288	132	132009	14
916	70.44464698887153	57.207070707070606	0.05177451959296839	134	132143	2
917	70.21143012623355	47.122960725075416	0.06153905752933386	132	132275	10
918	70.10095942358713	59.1643598615916	0.04262379034241633	134	132409	11
919	69.90519373179028	50.524390243902296	0.05658611610754213	134	132543	6
920	69.74206831204425	53.592651757188364	0.03581819961320108	134	132677	8
921	69.56311342696941	51.84657980456013	0.04424088651483709	132	132809	5
922	69.40127210161691	53.37898089171963	0.06677787695358049	134	132943	13
923	69.35578984655056	64.85304659498233	0.05168179985430601	139	133082	7
924	69.94982018337919	128.75882352941233	0.11591032049158118	182	133264	1
925	69.9035458082602	65.32238267148043	0.04333986214229039	140	133404	9
926	69.84341809925509	63.89077490774932	0.015343120363023545	135	133539	4
927	69.69180210008072	54.68181818181803	0.017986377673362617	134	133673	3
928	69.67577960146797	68.08955223880628	0.011130856953078895	139	133812	14
929	69.69424785909314	71.52260536398508	0.08198133526426372	165	133977	12
930	69.55371807891491	55.64126984126974	0.01945302165146415	141	134118	11
931	69.52351902762217	66.53381294964068	0.091771564128236	161	134279	10
932	69.44759676251601	61.931292517006874	0.0807003621701841	162	134441	2
933	69.3255802543503	57.24594594594582	0.012597361031700583	136	134577	6
934	69.21650253399858	58.41780821917797	0.02704454180020005	134	134711	5
935	69.08973300705087	56.53954983922819	0.024822505653327238	141	134852	8
936	68.99047927559627	59.1643598615916	0.02548097852450698	134	134986	13
937	68.87986019712602	57.92857142857131	0.014491221798000052	134	135120	7
938	68.71643895364532	52.53773584905651	0.014224274834590172	134	135254	1
939	68.57388621459431	54.46116504854357	0.023651268944811465	134	135388	9
940	68.33994267408579	45.179532163742564	0.018882879705140083	132	135520	4
941	68.24296770777659	58.64244604316536	0.027625176039609043	132	135652	14
942	68.17722620274183	61.668817204301135	0.03276036227190936	135	135787	11
943	68.08447560136423	58.902166064981834	0.031828475720954666	132	135919	2
944	67.91165648637623	50.80256410256398	0.026579009764122242	132	136051	10
945	68.61396849294104	138.1428571428577	0.08703656675954344	189	136240	3
946	68.4045849055726	47.67560975609742	0.034166271036321465	132	136372	13
947	68.90089040786823	118.03513513513545	0.11061365464154412	170	136542	6
948	69.42469968560775	121.28181818181868	0.09087325845445905	168	136710	5
949	69.86480051483863	113.43478260869618	0.11249016304693278	169	136879	8
950	70.30665582094854	114.0503311258284	0.08655443347868372	183	137062	12
951	70.13314622476436	52.95569620253151	0.030469535002067907	134	137196	1
952	70.0030401146294	57.12253521126751	0.03932150566216671	132	137328	9
953	70.5797729643665	127.67632508833958	0.1064972236142521	171	137499	7
954	70.46299689537265	58.902166064981834	0.047262357942985764	132	137631	2
955	70.31981137086338	56.14444444444431	0.03389126965493867	132	137763	10
956	70.22062063722854	60.400738007380056	0.02603231874623693	133	137896	3
957	70.61436970242175	109.59552715655008	0.12942614476325104	181	138077	4
958	71.1745249744697	126.62989690721699	0.11131872914054176	176	138253	14
959	71.82424126318655	136.14615384615433	0.10732114315032959	176	138429	11
960	71.78711947312279	68.11206225680961	0.03865148756239149	135	138564	13
961	71.67529774835621	60.604946996466396	0.054622777303059894	135	138699	8
962	71.63335558168346	67.48108108108134	0.05005828716136791	135	138834	12
963	71.49874557535469	58.172354948805356	0.03994351714404661	134	138968	1
964	72.22614273498577	144.23846153846188	0.1587730895641238	172	139140	6
965	72.04655698331158	54.26756756756745	0.02905140139839866	132	139272	9
966	72.62077562400479	129.46842105263204	0.1308134700475114	178	139450	5
967	72.46902732722421	57.44594594594582	0.021390025295428376	134	139584	7
968	72.27578888119449	53.14518272425235	0.019454307628400398	132	139716	2
969	72.17790055759994	62.48695652173927	0.01800965909604673	135	139851	10
970	72.04514321267376	58.902166064981834	0.03587325775262081	132	139983	3
971	71.89676248761774	57.207070707070606	0.023850207898154188	134	140117	4
972	71.80266442795896	62.48695652173927	0.02332830958896213	135	140252	14
973	71.69596874453346	61.13309608540927	0.01633466614617242	135	140387	13
974	71.48703469811376	50.80256410256398	0.035801049434777465	132	140519	11
975	71.41683349611404	64.46691449814152	0.012012352766814055	135	140654	12
976	71.20596303349332	50.32978723404241	0.01991186035213186	134	140788	8
977	71.1105915752014	61.668817204301135	0.02958316449765806	135	140923	1
978	70.9507601692533	55.127450980392055	0.04285160463247726	134	141057	9
979	70.7238996263843	48.26470588235282	0.029415020302160463	134	141191	7
980	71.28745867572307	127.07980456026124	0.1034419561169811	194	141385	6
981	71.81715551753727	124.25714285714335	0.11184222247149493	185	141570	5
982	71.72921473159268	63.02307692307713	0.04011966180110323	138	141708	3
983	72.31151081957087	129.9588235294122	0.11841270222383386	170	141878	2
984	72.14646501830585	55.806930693069155	0.04645159707140567	134	142012	14
985	72.51335576881965	108.83554006968676	0.11706108324455493	165	142177	10
986	72.37040029332323	58.21780821917797	0.0379981608951793	136	142313	11
987	72.27233265402636	62.5636363636365	0.036474812639890795	137	142450	13
988	72.1216800345568	57.207070707070606	0.021593818024023256	134	142584	8
989	72.83130637146614	143.08431372549063	0.09255366975610907	176	142760	4
990	72.68717138994326	58.41780821917797	0.035805524285159894	134	142894	9
991	73.17402789904035	121.37282229965199	0.10658847020325048	179	143073	12
992	73.08406539782773	64.17777777777803	0.03981745684588397	135	143208	7
993	73.79724100401206	144.40162601626065	0.15224760276836585	181	143389	1
994	73.54557036911987	48.630177514792756	0.037713726954673656	134	143523	6
995	73.35970852208396	54.959385665528906	0.04313964554757783	132	143655	11
996	73.16853079170184	54.241935483870854	0.05570009573182063	134	143789	10
997	73.99098341481931	155.41379310344885	0.11498757085856601	169	143958	5
998	74.37477987437741	112.37062937062977	0.10770997493224736	169	144127	2
999	74.8575472271488	122.65151515151554	0.125100651006589	174	144301	3
1000	75.43234809896335	132.33763440860264	0.08971695873618785	181	144482	13
1001	75.87453338990353	119.6508771929831	0.09063273494683423	206	144688	14
1002	75.66206256580841	54.62745098039205	0.06357967596259906	139	144827	12
1003	75.42881929864089	52.33773584905651	0.055086658281438494	136	144963	7
1004	75.15398293289701	47.94518272425228	0.03552165757054868	184	145147	4
1005	74.89890367139138	49.64605678233424	0.047480354887066464	165	145312	9
1006	74.61636291053954	46.64482758620679	0.07121297892402201	136	145448	1
1007	74.50540171058394	63.52024291498014	0.02886349464131293	214	145662	8
1008	74.3253476934781	56.499999999999886	0.04172968152743667	134	145796	6
1009	74.1517922031205	56.96979865771797	0.052215939137473036	134	145930	11
1010	73.99412015922549	58.38458781361994	0.06262420163010106	132	146062	5
1011	73.90765264184375	65.34736842105288	0.02666261461046007	135	146197	2
1012	73.69395347391587	52.53773584905651	0.034809076963965575	134	146331	3
1013	74.27306949473227	131.60555555555615	0.10718872330405495	176	146507	10
1014	74.10240950685565	57.207070707070606	0.028428107944887076	134	146641	12
1015	73.94556349397888	58.41780821917797	0.02852879709272242	134	146775	4
1016	73.81215732900375	60.604946996466396	0.029373790599681714	135	146910	7
1017	73.68803575571371	61.40000000000005	0.03404254206904658	135	147045	9
1018	73.55459201787488	60.34366197183099	0.051134459177653	135	147180	1
1019	74.21605768070772	139.70115830115893	0.10114258431099557	185	147365	13
1020	74.62046467146821	114.65675675675708	0.11651797575109145	170	147535	14
1021	74.4200782065717	54.58181818181803	0.034812856603551795	135	147670	8
1022	74.26005550669777	58.41780821917797	0.025561733032340436	134	147804	6
1023	74.17092863584132	65.34736842105288	0.024635140101114908	135	147939	11
1024	74.0540889147003	62.48695652173927	0.023600998631230108	135	148074	2
1025	73.82870282431492	51.515479876160875	0.02579447404662175	134	148208	3
1026	74.28027880977041	118.98630136986354	0.09403575066081639	179	148387	5
1027	74.04756283839296	51.008681672025624	0.02449362205736565	132	148519	10
1028	73.93751056767327	63.042335766423534	0.022591076956854927	135	148654	12
1029	73.77020616906725	57.207070707070606	0.03879702980838605	134	148788	9
1030	73.68008619692883	64.75820895522416	0.029353872934977213	135	148923	7
1031	73.41347265484427	47.018731988472496	0.04595472207709925	134	149057	4
1032	73.35414873910663	67.48108108108134	0.04197978266963252	135	149192	13
1033	73.09366785777617	47.3060606060605	0.04116395748022831	132	149324	1
1034	72.96199691346413	59.92657342657339	0.02648224047760465	134	149458	14
1035	72.85177262778272	61.93956834532384	0.020757676936961986	135	149593	8
1036	72.75367825916913	63.042335766423534	0.016043963255705656	135	149728	6
1037	72.54249212592808	51.63506493506479	0.025572343306107956	132	149860	11
1038	72.35296352573903	53.58963210702328	0.03805727669686982	132	149992	2
1039	72.2062982972613	57.68644067796594	0.022103772234560837	134	150126	3
1040	72.21600390933001	73.17685950413251	0.020798971034862376	135	150261	5
1041	72.03845552072215	54.46116504854357	0.03691322056215201	134	150395	10
1042	71.91733669978066	59.92657342657338	0.019361707701611875	134	150529	7
1043	71.75623263971355	55.806930693069155	0.02035166612311975	134	150663	9
1044	71.5724601222336	53.37898089171963	0.021736201955311334	134	150797	4
1045	72.44105769674348	158.43221757322232	0.11559032839398052	172	150969	12
1046	72.23789711977605	52.12499999999988	0.01702385873936895	134	151103	13
1047	72.09238255535796	57.68644067796594	0.021882295608520508	134	151237	8
1048	71.91607038028981	54.46116504854357	0.02237548579030962	134	151371	14
1049	71.80295914645157	60.604946996466396	0.02514110141330295	135	151506	6
1050	72.44534131969294	136.04117647058865	0.11073898133777436	168	151674	1
1051	72.23604270525763	51.515479876160875	0.021030484740413836	134	151808	11
1052	72.06947175188927	55.57894736842094	0.03888939031914099	134	151942	3
1053	72.0805456294117	73.17685950413251	0.048721165127224395	135	152077	5
1054	71.995798996647	63.60588235294142	0.05475465986463759	135	152212	10
1055	72.51228072299259	123.64397163120628	0.1498821637907081	181	152393	2
1056	72.32308443333454	53.592651757188364	0.015854351556123192	134	152527	4
1057	72.02451280687829	42.465921787709384	0.05073462751574982	133	152660	14
1058	71.84802654405773	54.37588652482256	0.08287524437719537	129	152789	1
1059	71.65661228521782	52.70660066006586	0.055730462074279785	132	152921	6
1060	72.16572843661314	122.56822742474976	0.11204895276701853	178	153099	7
1061	72.37159746803648	92.75263157894766	0.13312247452462556	157	153256	8
1062	72.21116850241957	56.32870090634422	0.02730098195100954	191	153447	9
1063	72.59237939804053	110.33225806451654	0.09314075593025453	186	153633	12
1064	72.42111915546201	55.46635514018674	0.03159058094024658	192	153825	13
1065	72.84835240835184	115.14444444444497	0.1373768423845668	167	153992	11
1066	72.64942584629364	52.95569620253151	0.037598602807343895	134	154126	3
1067	72.52636820754901	60.34366197183099	0.03136531335336191	135	154261	10
1068	72.49187617901683	69.07716535433097	0.0163858484338831	135	154396	2
1069	73.1648386432803	139.78812260536432	0.09921487542085869	172	154568	5
1070	73.03403236211065	60.08421052631574	0.020373220796938294	135	154703	4
1071	72.91237288955337	60.86808510638298	0.031090316066035517	135	154838	14
1072	72.79193001172166	60.86808510638298	0.041514015197753905	135	154973	1
1073	72.67534167245853	61.13309608540927	0.03498586725305628	135	155108	6
1074	72.63290075573394	68.43125000000026	0.03354688220553928	135	155243	7
1075	72.50583748244233	59.92657342657338	0.01558812696542313	134	155377	9
1076	72.22581378969883	44.50346820809236	0.031016049963055237	132	155509	8
1077	72.13994081081245	63.63851590106027	0.033121466636657715	140	155649	11
1078	71.95233121162151	53.37898089171963	0.049196033335443756	134	155783	10
1079	71.90461601758649	67.18081180811836	0.04995152247037819	139	155922	3
1080	72.44611531195609	126.05454545454609	0.11852628085279712	193	156115	12
1081	72.94033643308403	121.8682274247498	0.1538746601826436	185	156300	13
1082	72.7667225424374	55.57894736842094	0.03290198098367719	134	156434	4
1083	72.55020916316688	51.11538461538452	0.037023743586753734	134	156568	2
1084	72.37197918037874	54.727210884353624	0.042640393430536445	132	156700	14
1085	72.8708172117042	122.25578231292549	0.13392324614943119	171	156871	5
1086	72.64079019900745	49.868115942028844	0.0406998482303343	138	157009	6
1087	72.46817177070159	55.37894736842094	0.03402758345884435	136	157145	8
1088	73.11378582764246	137.0295774647892	0.1101042286733563	178	157323	1
1089	73.53905169607411	115.6403726708079	0.10141373752208238	178	157501	7
1090	73.43589194834414	63.223076923077144	0.04536651162540212	136	157637	11
1091	73.3155330288607	61.40000000000005	0.04841892101146557	135	157772	12
1092	73.16702718310817	58.46494845360813	0.03421654771356022	136	157908	4
1093	73.95927216551439	152.39152542372926	0.10733445111443014	170	158078	13
1094	73.82292268710249	60.3243243243243	0.030204484788633936	139	158217	2
1095	73.7151168178957	63.042335766423534	0.026394646256058304	135	158352	14
1096	73.61656024431134	63.85945945945973	0.0404410059859113	205	158557	3
1097	73.38956642100933	50.91717791411033	0.020285604605034216	134	158691	6
1098	73.27628081969232	62.06100628930827	0.04003713812146868	196	158887	10
1099	73.19188491797021	64.8366906474823	0.06305861808884312	142	159029	5
1100	73.3162209707513	85.62549019607953	0.16639272144862582	280	159309	9
1101	73.14342299945439	56.03642384105945	0.04336145030918406	134	159443	8
1102	72.96551335962377	55.35245901639335	0.03473280792805686	134	159577	1
1103	72.72216000117545	48.630177514792756	0.023149248379379955	134	159711	11
1104	72.48868091613376	49.37425149700588	0.023577853814879462	134	159845	7
1105	72.30621346181114	54.241935483870854	0.022974500015600405	134	159979	4
1106	72.08912896297576	50.59776357827463	0.04418759635000518	132	160111	2
1107	71.96750340761173	59.92657342657338	0.0448368663218484	134	160245	14
1108	72.48022434668998	123.23959731543675	0.09415350177071312	176	160421	12
1109	73.06533119413218	130.99090909090964	0.08919262356228298	180	160601	13
1110	72.92632148080678	59.1643598615916	0.04211788035150784	134	160735	6
1111	72.70921955632129	51.21612903225795	0.054688699317700935	132	160867	10
1112	72.49427550890621	51.21481481481468	0.039986207750108506	135	161002	3
1113	72.36917485908032	59.98421052631573	0.04503163169412052	136	161138	5
1114	72.21518109706669	56.96979865771797	0.05808429931526753	134	161272	8
1115	72.04881875978023	55.57894736842094	0.05835661247595033	134	161406	9
1116	71.91250865437421	58.41780821917797	0.0377480094112567	134	161540	1
1117	71.77756165002225	58.41780821917797	0.030094459875306085	134	161674	4
1118	71.40341394049878	34.36279069767485	0.11637692224411737	168	161842	7
1119	71.22316961001098	53.37898089171963	0.01501480501089523	134	161976	2
1120	71.15852000346312	64.75820895522416	0.01717350924456561	135	162111	14
1121	70.95291243921123	50.59776357827463	0.027804707035873875	132	162243	12
1122	71.41266519401375	116.92818791946358	0.10159437046494595	172	162415	11
1123	71.25660784900431	55.806930693069155	0.030764910712170957	134	162549	13
1124	70.98741064659497	44.33688760806904	0.03579338391621908	132	162681	6
1125	70.7847383749914	50.72018348623841	0.03179952279845281	134	162815	5
1126	70.62593007918936	54.90390879478814	0.02554523411081798	134	162949	1
1127	71.13148896021565	121.18181818181868	0.16287270946615545	169	163118	3
1128	71.90169067577955	148.1516605166057	0.12484682276007834	178	163296	10
1129	72.36947568595465	118.68019169329133	0.15275579883206275	186	163482	8
1130	72.78511426242845	113.93333333333382	0.10651333467948004	193	163675	9
1131	72.59766379320483	54.04006734006724	0.03384741869839755	132	163807	4
1132	72.4633307538887	59.1643598615916	0.03041348528506151	134	163941	7
1133	72.31315690580927	57.44594594594582	0.026149418816637637	134	164075	12
1134	72.14431056011887	55.428522336769646	0.021675481940760757	132	164207	11
1135	71.97190654246555	54.90390879478814	0.023887972333538	134	164341	2
1136	71.7971535787358	54.49661016949137	0.02761190768444177	132	164473	14
1137	71.59764784099404	51.84657980456013	0.019033473549467144	132	164605	13
1138	71.38887319744649	50.72018348623841	0.010323101904854845	134	164739	1
1139	71.36902399116373	69.40395256917022	0.01903930770026313	135	164874	3
1140	72.11679988671025	146.1466135458172	0.11078986229255186	171	165045	6
1141	72.02886265707393	63.323076923077146	0.024618109950312862	135	165180	10
1142	72.67014108031162	136.15670498084324	0.12251696867101333	170	165350	5
1143	72.51219405547342	56.8754385964911	0.039631168047587075	132	165482	8
1144	72.42230288414946	63.523076923077134	0.0348700401478244	133	165615	9
1145	72.42273559301289	72.4655737704921	0.020001805270159687	135	165750	7
1146	72.23017490374943	53.16666666666657	0.02562497978779807	134	165884	11
1147	72.04601409430924	53.8140939597314	0.03100449749917695	132	166016	14
1148	72.54828217636268	122.27282229965193	0.11304624220904182	170	166186	4
1149	72.29220899315325	46.94096385542155	0.03999604600848573	132	166318	13
1150	72.912721532197	134.34346289752688	0.10838850838797433	175	166493	2
1151	73.83105014726372	164.74558303886968	0.14638282130004238	189	166682	12
1152	73.68690631245775	59.41666666666657	0.032584652971865524	134	166816	1
1153	73.61556396689043	66.55267175572546	0.02764964633517795	135	166951	3
1154	73.41307499388819	53.36666666666655	0.049327691396077476	132	167083	5
1155	73.04226643239915	36.33221884498469	0.1402568504458568	122	167205	8
1156	73.28878336539059	97.69395973154404	0.13766210357104341	163	167368	6
1157	73.70175695495766	114.5861423220978	0.1278217943703256	164	167532	10
1158	73.44557516253418	48.08357771260984	0.03646811798437318	134	167666	7
1159	73.30025734194332	58.913793103448164	0.03647428484105352	134	167800	11
1160	73.18797174965596	62.07169811320766	0.03603157602754751	133	167933	14
1161	73.74623643649154	129.01444043321345	0.09951117177488943	189	168122	9
1162	73.58323353158609	57.44594594594582	0.027191382735522827	134	168256	13
1163	73.40319066995444	55.57894736842094	0.022402017863828744	134	168390	12
1164	73.73082945811895	106.16706948640527	0.089004554531791	176	168566	4
1165	73.61709692111353	62.357575757575894	0.02008635836436336	133	168699	3
1166	74.18161016242871	130.068421052632	0.12112687354864077	172	168871	2
1167	74.05918974425765	61.93956834532384	0.03759030589350948	135	169006	5
1168	73.99340865762589	67.48108108108134	0.04515579364917897	135	169141	8
1169	74.57747457104963	132.40000000000046	0.10300666809082032	175	169316	1
1170	74.35500703537049	52.33072100313466	0.04161033345692193	134	169450	6
1171	74.16105082167208	54.959385665528906	0.05211636153134433	132	169582	7
1172	74.47793010937373	105.84897959183705	0.11478274952281606	165	169747	10
1173	74.98837178206276	125.52209737827758	0.11427465884271495	167	169914	9
1174	75.30059398324525	106.21059190031207	0.09065968873070888	183	170097	14
1175	75.08243466917968	53.484662576687015	0.042775469718219564	139	170236	3
1176	74.93637303435229	60.47627118644063	0.04325893947056362	140	170376	4
1177	74.72942865884748	54.241935483870854	0.04045083273702593	134	170510	2
1178	74.70798846478571	72.58540925266985	0.09719453306279631	234	170744	11
1179	74.44519253075514	48.42839506172827	0.0157031976815426	132	170876	5
1180	74.45324060544759	75.25000000000055	0.08068218438521675	184	171060	12
1181	74.2953576839292	58.66494845360813	0.025077613432015946	134	171194	6
1182	74.18954595106153	63.71418439716337	0.028939441895820726	142	171336	8
1183	74.22496045465056	77.73099630996386	0.06769158862052707	218	171554	13
1184	74.92933247172569	144.66216216216273	0.10816840467781856	174	171728	1
1185	74.69928914700843	51.924999999999876	0.02777003891327802	136	171864	7
1186	74.58943809950998	63.71418439716337	0.03142564397462657	142	172006	10
1187	74.40019889092868	55.6655172413792	0.026559230053063595	132	172138	9
1188	74.26846555873581	61.226865671641846	0.022683347974504744	133	172271	4
1189	74.01006485376574	48.42839506172827	0.02696743155970718	132	172403	14
1190	73.78212549555066	51.21612903225795	0.02759848218975645	132	172535	3
1191	73.53435720009671	49.00529595015566	0.027037311684001576	132	172667	2
1192	73.32826528372487	52.92516556291376	0.02633170286814372	132	172799	11
1193	73.06988536644994	47.49027355623087	0.027114506923791134	132	172931	5
1194	72.88379816327087	54.46116504854357	0.02336333758795439	134	173065	6
1195	72.73182458841782	57.68644067796594	0.0254687675789221	134	173199	13
1196	72.63214270617001	62.763636363636515	0.018544606809262877	135	173334	8
1197	73.053547257756	114.77259786476915	0.11162552379426502	168	173502	12
1198	72.9885385027357	66.55267175572546	0.014604263835483126	135	173637	1
1199	72.77180126585648	51.31481481481468	0.02286834325363387	134	173771	7
1200	72.66620599688022	62.21227436823118	0.023647855829309533	135	173906	9
1201	73.28606245542994	134.65185185185237	0.09832629822848137	171	174077	10
1202	73.11127113780633	55.806930693069155	0.03348045562630269	134	174211	4
1203	73.02482757140969	64.46691449814152	0.025997596316867405	135	174346	14
1204	72.85494353410618	56.03642384105945	0.025301296319534528	134	174480	3
1205	72.68304927117892	55.6655172413792	0.03825678608634255	132	174612	2
1206	72.57561446192037	61.93956834532384	0.02555781117192021	135	174747	13
1207	72.33069409442726	48.08357771260984	0.02555746106959101	134	174881	6
1208	72.8668342524591	125.94470989761143	0.0863813223866369	173	175054	11
1209	72.72980950855043	59.1643598615916	0.026514419868810854	134	175188	12
1210	72.56287565187553	56.03642384105945	0.03592526734764896	134	175322	1
1211	72.4134667535128	57.6219858156027	0.045320958802194306	132	175454	7
1212	72.57189476819342	88.25626822157466	0.10210502578551511	166	175620	5
1213	73.07377721911288	122.76013986014026	0.0864372309516458	170	175790	8
1214	72.98194719599924	63.89077490774932	0.021827522913614908	135	175925	9
1215	72.94946105737257	69.7333333333336	0.02508610796045374	135	176060	10
1216	73.38196644679886	116.20000000000041	0.11260395900459047	157	176217	4
1217	73.1673523898075	51.92056074766345	0.029089440160722874	134	176351	3
1218	73.52595701160479	109.0278145695369	0.11604930397993077	167	176518	14
1219	73.38740475856191	59.67073170731696	0.037486104822870514	134	176652	13
1220	73.2784002761937	62.48695652173927	0.04673597547743055	135	176787	6
1221	73.21421397458118	66.85977011494279	0.03522875397293656	135	176922	12
1222	73.50754802531156	102.54761904761936	0.07518662475958103	164	177086	2
1223	73.37452201502312	60.20494699646636	0.03904324469806479	139	177225	1
1224	73.18117746827356	54.04006734006724	0.04154530799750126	132	177357	5
1225	74.0402771980156	159.09115044247847	0.08751791514707415	178	177535	11
1226	73.75684492751037	45.69705014749248	0.04727898944507946	132	177667	7
1227	73.56069583307398	54.14193548387085	0.03660079108344184	135	177802	8
1228	73.39478686132043	56.96979865771797	0.02345659839573191	134	177936	9
1229	73.17300028302981	51.21612903225795	0.024998160925778477	132	178068	10
1230	73.05914997944762	61.78796992481208	0.0205236700244416	133	178201	4
1231	72.89825646623034	56.96979865771797	0.037866891320072	134	178335	3
1232	72.80155742647224	63.228352490421656	0.024123354961997585	133	178468	13
1233	72.64725563312625	57.371378091872636	0.03878913503704649	132	178600	6
1234	72.49048106337217	56.96979865771797	0.028579267103280594	134	178734	2
1235	72.40163507626787	63.60588235294142	0.0346220405013473	135	178869	1
1236	73.21090443979091	153.328571428572	0.10967193179660373	180	179049	14
1237	73.0822320151113	60.34366197183099	0.04318868142587167	135	179184	5
1238	73.57925915732578	122.78494623655955	0.10792181477744199	169	179353	12
1239	73.38588592059124	54.241935483870854	0.041357648906423086	134	179487	7
1240	73.20555165154926	55.35245901639335	0.0519445760926204	134	179621	11
1241	72.96549613503377	49.19999999999988	0.03159815253633441	132	179753	8
1242	72.86347753731981	62.763636363636515	0.017766009436713324	135	179888	10
1243	72.62858527691668	49.37425149700588	0.018834827551201208	134	180022	9
1244	72.56221913217671	65.99197080292	0.030276909680433676	142	180164	4
1245	72.37683809841121	54.02411575562691	0.028116044713490045	134	180298	3
1246	72.23724779961888	58.41780821917797	0.04180174443259168	134	180432	13
1247	72.04632714886522	53.14518272425235	0.03391921158992883	132	180564	6
1248	71.8298065525358	50.39426751592345	0.04564399430246064	132	180696	2
1249	71.7123505922736	60.08421052631574	0.026880101804380063	135	180831	1
1250	71.75666298378675	76.14358974359003	0.02737130059136285	135	180966	12
1251	71.64739567367678	60.829931972789126	0.02070403785156689	139	181105	5
1252	71.65366681497923	72.27450980392186	0.014759739525884176	139	181244	11
1253	71.5101042568618	57.29741100323612	0.026641282482423645	138	181382	8
1254	72.17988871047639	138.48854961832117	0.10202130791861251	179	181561	14
1255	72.07548550682486	61.739568345323825	0.04560568732936887	137	181698	9
1256	72.6338053848527	127.90747330960909	0.10134897285333559	179	181877	7
1257	72.97858073306604	107.111340206186	0.11880866542006983	165	182042	10
1258	72.8689176694177	62.01227436823115	0.04988682183035969	137	182179	4
1259	73.46183179850865	132.1603305785128	0.11728794213497278	165	182344	13
1260	74.22636523149635	149.91517509727666	0.13067672156185084	173	182517	3
1261	74.09752623671564	61.34246575342471	0.039881222539668464	139	182656	2
1262	73.92901043380793	57.24594594594582	0.031739708255319035	136	182792	12
1263	74.60662942037895	141.69090909090946	0.09084981576555726	173	182965	1
1264	74.49098648383941	63.042335766423534	0.04152626108240198	135	183100	8
1265	74.39074576398244	64.46691449814152	0.02999617611920392	135	183235	14
1266	74.30431713370419	65.74788273615675	0.13898343737848204	221	183456	6
1267	74.13749382052316	57.6219858156027	0.03913357402339126	132	183588	9
1268	73.9387945579936	54.26756756756745	0.0420428839596835	132	183720	10
1269	74.3613388158035	116.19322033898354	0.10023116077166147	193	183913	5
1270	74.13087357579361	51.31481481481468	0.03461284068093371	134	184047	7
1271	74.53873367120451	114.91688311688351	0.0968172273583175	181	184228	11
1272	74.40467729534656	61.133096085409285	0.02148458692762587	135	184363	3
1273	74.87674011143419	121.61095890411016	0.09915926112210686	187	184550	4
1274	74.71711064135434	58.913793103448164	0.028557695559601286	134	184684	13
1275	74.5420102420115	57.207070707070606	0.026101496682238223	134	184818	2
1276	74.45304296978007	65.64528301886818	0.016119621418140554	135	184953	1
1277	74.22486318943291	51.63506493506479	0.031218709367694275	132	185085	14
1278	73.9563102097125	47.36956521739117	0.01662991829772494	134	185219	8
1279	73.78061121911364	56.386411149825626	0.037690112085053414	132	185351	6
1280	74.08079897195319	103.79938650306804	0.09195466751747942	188	185539	12
1281	73.84916276137476	50.91717791411033	0.03726706931840128	134	185673	7
1282	73.65309048859972	54.241935483870854	0.052952908757907244	134	185807	10
1283	73.41792322007736	50.13636363636353	0.046420065324697925	134	185941	5
1284	73.1988987866382	51.515479876160875	0.07731596391592453	134	186075	11
1285	73.91453942840144	144.7629629629635	0.11440795561226692	181	186256	9
1286	73.70918384303462	53.37898089171963	0.019468791449247902	134	186390	4
1287	73.59148768805751	61.93956834532384	0.02626797358194987	135	186525	13
1288	74.05776031117695	120.21875000000043	0.15714517453821694	164	186689	3
1289	74.73509179897427	141.79090909090945	0.14182875877202944	172	186861	2
1290	74.41930844855209	43.15675675675663	0.0702187149612992	135	186996	14
1291	74.19636536406657	52.12499999999988	0.08260197425956156	134	187130	8
1292	73.9756517104259	52.12499999999988	0.07006236688414616	134	187264	11
1293	74.39617707251628	116.02818791946363	0.12402627217835484	181	187445	1
1294	74.188141819363	53.592651757188364	0.0711544520819365	134	187579	12
1295	74.04042706783603	59.41666666666657	0.054479335671040546	134	187713	10
1296	73.81719671020116	51.71739130434771	0.06645073107819059	134	187847	5
1297	74.19352312497617	111.44983818770285	0.13795839874438068	179	188026	6
1298	74.74940803761129	129.7820143884896	0.10680163990367543	176	188202	7
1299	74.53116561286431	52.92516556291376	0.03511666890346643	132	188334	13
1300	75.07839241827413	129.2538461538465	0.07573139099847703	168	188502	9
1301	74.8700278489301	54.241935483870854	0.025704873141957754	134	188636	4
1302	74.72216967570397	60.08421052631574	0.021800367920487014	135	188771	3
1303	74.49415358642356	51.92056074766345	0.022762058386162146	134	188905	2
1304	74.2960302323775	54.68181818181803	0.018259084046776616	134	189039	14
1305	74.12993433683339	57.68644067796594	0.02317247817765421	134	189173	8
1306	74.07616440522976	68.75294117647086	0.019565230828744395	135	189308	1
1307	73.95046643158945	61.506367041198565	0.057238209516482244	133	189441	12
1308	73.82229272812764	61.13309608540927	0.049980001096372254	135	189576	10
1309	73.67071928538245	58.66494845360813	0.05299624044503739	134	189710	5
1310	73.48980156621283	55.57894736842094	0.03125066899541599	134	189844	6
1311	74.15241059280423	139.75070422535265	0.1371926030805034	186	190030	11
1312	73.97233093132064	56.14444444444431	0.0456923788244074	132	190162	4
1313	73.77942580382562	54.68181818181803	0.037782658391924046	134	190296	9
1314	73.61749595256701	57.58644067796594	0.043312853353994867	135	190431	3
1315	74.22306012347613	134.17391304347862	0.10189546553116272	179	190610	7
1316	74.72274844116029	124.19189189189223	0.11044385216452858	176	190786	13
1317	74.53696540119313	56.14444444444431	0.035775549484021736	132	190918	8
1318	74.41546531239858	62.38695652173927	0.04258786229526296	136	191054	12
1319	75.00522578842589	133.3915129151297	0.09073960379268346	178	191232	2
1320	74.74205664742475	48.68831168831155	0.03756612215855325	129	191361	5
1321	75.30511756243199	131.04814814814867	0.12627831627340877	170	191531	14
1322	75.07237359683901	52.03072100313466	0.048672515980518645	137	191668	10
1323	74.84554459771273	52.389473684210415	0.03218647232629303	133	191801	6
1324	75.75624299788946	165.915384615385	0.2272853236044607	186	191987	1
1325	75.60473003787523	60.604946996466396	0.02792531472665292	135	192122	11
1326	75.41838072407366	56.96979865771797	0.02209721394439242	134	192256	4
1327	75.23626762390363	57.207070707070606	0.028840997325840282	134	192390	9
1328	74.94614304290269	46.223809523809386	0.02728360891342163	132	192522	3
1329	75.53147311826518	133.4791505791511	0.115490442163804	170	192692	7
1330	75.34128659221074	56.512820512820376	0.018834035173594523	139	192831	8
1331	75.23345581584087	64.55820895522416	0.04694792127957309	137	192968	2
1332	75.13159494189298	65.04736842105288	0.03225778496783713	138	193106	12
1333	75.56174586944567	118.14668769716135	0.09710002767628637	174	193280	13
1334	75.30749204711485	50.13636363636353	0.03785508782116335	134	193414	5
1335	75.02460444652843	47.018731988472496	0.04957276671680052	134	193548	14
1336	74.86349633309763	58.913793103448164	0.04483258546288334	134	193682	10
1337	74.69147374761683	57.66123778501614	0.03970434339784032	139	193821	6
1338	74.48697836497936	54.241935483870854	0.0304529488976322	134	193955	4
1339	74.35879675337259	61.668817204301135	0.026401629271330655	135	194090	9
1340	74.19216303420487	57.6954248366012	0.038931762073056916	141	194231	11
1341	74.7773687446868	132.71273408239742	0.11791479447308709	170	194401	1
1342	74.6572314208763	62.763636363636515	0.0492333730061849	135	194536	3
1343	74.43125387790937	52.059477124182905	0.09959376219547156	132	194668	8
1344	74.1695883979538	48.26470588235282	0.042751191267326696	134	194802	7
1345	73.97031186881297	54.241935483870854	0.03298586162168588	134	194936	2
1346	74.5114228765189	128.08141263940564	0.11936505635579427	168	195104	12
1347	74.35820565772049	59.18970099667761	0.020705720652704655	138	195242	5
1348	74.76168033873194	114.70567375886574	0.12959825701829863	164	195406	13
1349	74.65773268032603	64.36691449814153	0.1173708579119514	136	195542	9
1350	75.0713241846916	116.01688311688345	0.14879486981560203	170	195712	14
1351	75.56737564872705	124.67647058823573	0.09208251790302556	164	195876	6
1352	75.39301336764962	58.131147540983505	0.10546540184844312	139	196015	11
1353	75.16554380179647	52.646056782334284	0.12352261013454861	135	196150	1
1354	74.98018906307921	56.63006993006983	0.02493531053716486	132	196282	3
1355	75.53614657094467	130.57593984962475	0.07614670187083598	197	196479	10
1356	75.87283638728651	109.20512820512867	0.20856655463970528	189	196668	4
1357	75.66989749709786	55.57894736842094	0.060808943278753934	134	196802	8
1358	75.58241137353252	66.92128514056253	0.05675598373986725	133	196935	7
1359	75.42585299406292	59.92657342657338	0.031174880355151733	134	197069	12
1360	75.8996532876517	122.80588235294158	0.08488665875934419	168	197237	2
1361	75.71752116155484	57.68644067796594	0.01886042552207833	134	197371	13
1362	75.50761805878282	54.727210884353624	0.021987598953825054	132	197503	9
1363	75.30158096614286	54.90390879478814	0.02816925297922163	134	197637	11
1364	75.1254295632611	57.68644067796594	0.031912810766874855	134	197771	6
1365	74.88137710249087	50.72018348623841	0.03145710034156913	134	197905	14
1366	74.74124418252978	60.86808510638298	0.03775678564001013	135	198040	1
1367	74.60889541111646	61.506367041198565	0.051415472102344484	133	198173	3
1368	74.91537435823987	105.2567901234572	0.06651746633961715	181	198354	5
1369	74.68747061465747	52.12499999999988	0.028132379944644757	134	198488	10
1370	74.47426257517756	53.36666666666655	0.02868401101141265	132	198620	4
1371	74.30826372166777	57.87437722419916	0.039579218084161934	132	198752	8
1372	74.10110760202298	53.592651757188364	0.017625538270864913	134	198886	12
1373	74.40621128010112	104.61147540983652	0.09659273078642695	166	199052	7
1374	74.21567375746403	55.35245901639335	0.018750114227408795	134	199186	2
1375	74.0422714058543	56.8754385964911	0.030992977546923088	132	199318	6
1376	73.82891469839642	52.70660066006586	0.03487694985938795	132	199450	14
1377	73.68989128567819	59.92657342657339	0.04518772239115701	134	199584	3
1378	74.4048993495656	145.19069767441908	0.11107022966657366	175	199759	13
1379	74.17720100542059	51.63506493506479	0.05262483250011097	132	199891	10
1380	73.917813610751	48.23846153846144	0.05797840609694972	132	200023	5
1381	74.40431774889099	122.56822742474976	0.12327584255947156	178	200201	9
1382	75.0025200587667	134.22454873646245	0.09302049978620056	173	200374	1
1383	74.83667294037082	58.41780821917797	0.03515652400344165	134	200508	4
1384	75.21078162080317	112.24754098360714	0.10861551000716839	188	200696	11
1385	75.10138809030943	64.27142857142884	0.02779109880957805	142	200838	8
1386	74.92105162876116	57.06774193548375	0.03442831315856049	138	200976	12
1387	74.65448817129707	48.264705882352835	0.028423946295211566	134	201110	7
1388	74.45255494006953	54.46116504854357	0.037833907710972114	134	201244	2
1389	74.33566575430521	62.763636363636515	0.02862423614219383	135	201379	6
1390	74.18394677792159	59.16376811594193	0.03311183958342581	132	201511	14
1391	74.10763402769963	66.55267175572546	0.03170815220585576	135	201646	3
1392	73.98595337087588	61.93956834532384	0.025174107374968353	135	201781	5
1393	73.76940104719847	52.33072100313466	0.026279668309795324	134	201915	10
1394	73.67637618170791	64.46691449814152	0.020062006844414604	135	202050	1
1395	73.51889813417655	57.92857142857131	0.023387211472240845	134	202184	4
1396	73.90547385871714	112.17647058823567	0.10497524680160894	164	202348	9
1397	73.75306860466605	58.66494845360813	0.03100356770985162	134	202482	11
1398	73.6478214435236	63.228352490421656	0.04586323042561237	133	202615	8
1399	73.97916585905779	106.7822629969425	0.10698050421637458	185	202800	13
1400	73.80001114314237	56.0636942675158	0.02117658690582934	139	202939	12
1401	73.58466359968678	52.26525679758296	0.03106120968541355	141	203080	7
1402	73.40745390636508	55.8636942675158	0.03718871258674784	141	203221	2
1403	73.20504603396809	53.16666666666657	0.015624044546440466	134	203355	14
1404	73.1418036917096	66.88081180811838	0.024745333362633074	142	203497	3
1405	73.13995087218382	72.95652173913071	0.019274034088464093	139	203636	5
1406	73.0172322145258	60.86808510638298	0.027700945183082862	135	203771	10
1407	72.96501338075264	67.79534883720956	0.018357580679434316	135	203906	4
1408	73.31326488628937	107.79016393442669	0.09723736426073634	167	204073	6
1409	73.14626044255469	56.61282051282038	0.025013902912969174	138	204211	1
1410	73.02986150854113	61.506367041198565	0.03368582402853141	133	204344	8
1411	72.8837409756475	58.41780821917797	0.025612674542327424	134	204478	9
1412	73.23890356589102	108.4000000000005	0.10712985414447207	165	204643	11
1413	73.13844435479352	63.19298245614055	0.02181995686867254	139	204782	12
1414	73.98945292434603	158.23930131004434	0.06696095673934273	207	204989	13
1415	73.82577825325859	57.6219858156027	0.030684897393891304	132	205121	14
1416	73.65819789008084	57.06774193548375	0.029869024304376133	138	205259	3
1417	73.52637862304444	60.47627118644063	0.02978168215070452	140	205399	5
1418	74.20212641982557	141.10115830115885	0.12139506646764209	171	205570	7
1419	74.03539086991303	57.52857142857127	0.03612862117048623	138	205708	4
1420	73.87399120957991	57.8954248366012	0.026143290156083143	139	205847	10
1421	73.69332060441481	55.806930693069155	0.046561084576507115	134	205981	6
1422	73.45629879077573	49.9911392405062	0.02756139003869259	132	206113	1
1423	73.23890971591145	51.71739130434771	0.028071691740804643	134	206247	8
1424	73.13084714936458	62.432653061224684	0.03186928913855428	191	206438	2
1425	72.85442631832038	45.488764044943714	0.031749921058540916	134	206572	9
1426	72.61788205513717	49.19999999999988	0.02151601603536895	132	206704	11
1427	72.47588131677759	58.41780821917797	0.032551857962537165	134	206838	12
1428	72.30691197729402	55.57894736842094	0.03403102106122828	134	206972	13
1429	72.16556640700914	58.172354948805356	0.028963259796598063	134	207106	14
1430	72.06603348662135	62.21227436823118	0.01935861905415853	135	207241	3
1431	71.92955123394692	58.41780821917797	0.024719103058772302	134	207375	5
1432	71.74618223917933	53.592651757188364	0.02042583565213787	134	207509	7
1433	71.62832114938827	59.96007326007321	0.02634736444010879	132	207641	6
1434	71.38048621375646	46.84482758620679	0.02242063230542994	134	207775	4
1435	71.2479670659046	58.12857142857129	0.04211811585859819	132	207907	8
1436	71.17840554471175	64.29181494661948	0.022461992373569405	139	208046	1
1437	71.15368915843757	68.7067669172935	0.02496486430545505	139	208185	2
1438	71.89077388847483	144.86216216216272	0.1123506412949673	172	208357	10
1439	71.73686614959007	56.499999999999886	0.03271266595641179	134	208491	9
1440	71.57232138746524	55.28238993710682	0.021466664645982826	138	208629	11
1441	71.3946750966675	53.80769230769218	0.019735855842704205	134	208763	12
1442	71.3225061234786	64.17777777777803	0.024345343201248735	135	208898	3
1443	71.14952221980009	54.02411575562691	0.026593793683977268	134	209032	14
1444	71.5324854693629	109.4458471760801	0.09261797145455183	167	209199	13
1445	71.3446211824926	52.746056782334286	0.0360584187863478	134	209333	5
1446	71.23518235074147	60.400738007380056	0.034835299154869596	133	209466	6
1447	71.07242438388934	54.959385665528906	0.04691536498792244	132	209598	7
1448	70.87805078940109	51.63506493506479	0.02084201754945697	132	209730	4
1449	70.78327028150709	61.40000000000005	0.013159467555858471	135	209865	8
1450	70.67470331295775	59.92657342657338	0.012381581228170822	134	209999	1
1451	70.5672220140939	59.92657342657339	0.018198902927227874	134	210133	9
1452	70.37579898489147	51.42491909385102	0.037252274426546966	132	210265	10
1453	70.16018639563603	48.81454005934706	0.023464615665264983	134	210399	2
1454	70.03304399113914	57.44594594594582	0.02720686215073315	134	210533	11
1455	69.90699926551345	57.42857142857127	0.017937751125088698	139	210672	3
1456	69.65296395493924	44.50346820809236	0.033306031516104034	132	210804	5
1457	69.54291113658189	58.647682119205136	0.03492278241096659	141	210945	13
1458	69.3702197301341	52.273770491803184	0.03597310095122366	132	211077	6
1459	69.39254866123741	71.60311284046722	0.021702665219204033	139	211216	4
1460	69.29886641786828	60.02432432432427	0.020871296734877035	142	211358	7
1461	69.16732219813404	56.14444444444431	0.02578016844662753	132	211490	8
1462	69.74923721144683	127.35882352941232	0.07439162779827507	196	211686	14
1463	69.84528869898149	79.35438596491299	0.17471883115212478	223	211909	12
1464	69.69884212113995	55.20063091482639	0.028948127800691212	141	212050	1
1465	69.55378520677786	55.193150684931396	0.028242412841681278	132	212182	9
1466	69.3878043167354	52.95569620253151	0.02996825460177749	134	212316	2
1467	69.25480167292906	56.08753993610209	0.03601956536583867	141	212457	10
1468	69.10907183801795	54.68181818181803	0.017057735528518903	134	212591	11
1469	69.10702638712749	68.90452674897149	0.01872063400153827	133	212724	3
1470	68.98565410983339	56.96979865771797	0.022173450953924832	134	212858	13
1471	68.82746423540172	53.16666666666657	0.034561409879086624	134	212992	6
1472	68.6972588999784	55.806930693069155	0.040880644499365966	134	213126	7
1473	68.51553021341763	50.524390243902296	0.04212087659693476	134	213260	4
1474	68.41405912180977	58.36842105263146	0.05977810372551568	139	213399	14
1475	68.25947549261699	52.95569620253151	0.03532669437465383	134	213533	1
1476	68.24240745524807	66.55267175572546	0.03745932049221463	135	213668	10
1477	68.25031671402893	69.03333333333363	0.0407221451611586	142	213810	12
1478	68.25488121606156	68.7067669172935	0.04049058955350368	139	213949	2
1479	68.06419807554273	49.18656716417901	0.03245070799073176	134	214083	9
1480	68.67809014496652	129.4534050179216	0.07842714485080762	174	214257	8
1481	68.5503507660082	55.90415224913484	0.0284651517868042	132	214389	11
1482	68.95634564022514	109.14983818770298	0.10888379163081104	202	214591	5
1483	68.89720554148712	63.042335766423534	0.020848466731883862	135	214726	3
1484	69.1740613006418	96.58278145695405	0.0804394835945945	159	214885	13
1485	69.12990277718762	64.75820895522416	0.017902213555795174	135	215020	7
1486	68.98764283736362	54.90390879478814	0.04445204805971971	134	215154	1
1487	69.61389374981395	131.61273408239748	0.1155897003511039	181	215335	6
1488	69.49461921909548	57.68644067796594	0.05020233410507886	134	215469	10
1489	69.32092302690452	52.12499999999988	0.055693960901516584	134	215603	2
1490	69.14086194478362	51.31481481481468	0.057645577103344364	134	215737	12
1491	69.00752263226647	55.806930693069155	0.05528853544548376	134	215871	9
1492	69.61688255238732	129.9435146443519	0.13370292942698409	164	216035	14
1493	69.50713818729511	58.64244604316536	0.025661342071764397	132	216167	5
1494	69.35230796297843	54.02411575562691	0.02816134424351934	134	216301	8
1495	70.24400259552577	158.5217712177127	0.13986295751623204	185	216486	4
1496	71.02413399814195	148.2571428571435	0.13306223551432292	195	216681	11
1497	71.52762088115705	121.37282229965199	0.12886105968965497	179	216860	3
1498	71.47816820175724	66.58235294117678	0.061772158448125274	142	217002	7
1499	71.44128204212774	67.7895522388063	0.06718192973607023	142	217144	13
1500	71.3256099624472	59.87407407407403	0.04032956454770785	141	217285	1
1501	71.28716867763755	67.48148148148177	0.016953766774788177	139	217424	2
1502	71.19169267431441	61.739568345323825	0.03990242603051401	137	217561	12
1503	71.02400556123587	54.4229813664595	0.02114126302193904	138	217699	6
1504	70.99466102801156	68.08955223880628	0.02557956229010932	139	217838	8
1505	70.87661142769822	59.18970099667761	0.028599035912665768	138	217976	5
1506	71.46802678060271	130.01814671814722	0.13587848249688206	166	218142	9
1507	71.25391367697578	50.05671641791029	0.034793853759765625	185	218327	10
1508	71.76648412924712	122.51095890411011	0.11159154270472152	178	218505	14
1509	71.71173899598384	66.29197080291998	0.03448879804542596	139	218644	11
1510	71.6375397554902	64.29181494661947	0.039795323241528846	139	218783	13
1511	71.49562381739476	57.44594594594582	0.04093534199159537	134	218917	7
1512	71.31362923113821	53.296165191740116	0.04328512429167784	233	219150	4
1513	71.16112988150198	56.0636942675158	0.04300438242850544	139	219289	3
1514	70.96669249573044	51.71739130434771	0.04090022684922859	134	219423	1
1515	70.95672022726168	69.96946564885525	0.03120115678087413	139	219562	12
1516	70.88321184851847	63.60588235294142	0.009428931165624549	135	219697	5
1517	70.74505714938812	57.06774193548375	0.017518546270287556	138	219835	8
1518	70.59480910953981	55.72025316455682	0.01755198361217112	138	219973	9
1519	71.31891445355893	143.00534351145092	0.09540168629136196	172	220145	6
1520	72.00863439993243	140.29090909090957	0.18061834733116436	187	220332	2
1521	71.81821472259978	52.96666666666657	0.01745934521450716	136	220468	10
1522	71.70027581861702	60.02432432432427	0.021531096646483516	142	220610	14
1523	71.63972589061953	65.64528301886818	0.02360542438648365	135	220745	11
1524	71.43757782265185	51.42491909385102	0.03286383729992491	132	220877	13
1525	71.25066261224866	52.746056782334286	0.018761035221726147	134	221011	4
1526	71.13005299609294	59.18970099667761	0.022581020991007488	138	221149	3
1527	71.01859457139517	59.98421052631573	0.0240078866481781	136	221285	1
1528	70.85302027616666	54.46116504854357	0.03467189020185328	134	221419	5
1529	70.82538559579305	68.08955223880628	0.03390609274665229	139	221558	8
1530	70.71842585748217	60.12941176470587	0.038929996633888186	133	221691	9
1531	71.3139397121149	130.26981132075508	0.13330501601809547	168	221859	12
1532	71.25216722146857	65.13669064748228	0.03530021365597951	139	221998	6
1533	71.80059919163799	126.09536423841124	0.11580711755997096	195	222193	7
1534	71.73969464899696	65.7101449275365	0.021940375403534593	139	222332	2
1535	71.54719243934909	52.48947368421042	0.03178473674889767	132	222464	14
1536	72.05960940384449	122.7888888888894	0.14107521772384643	160	222624	11
1537	71.95407698021803	61.506367041198565	0.029657148777094102	133	222757	13
1538	72.61542170659907	138.0885496183212	0.10185276094030161	183	222940	10
1539	72.53393663451449	64.46691449814152	0.02514618061206959	135	223075	4
1540	72.36666657510004	55.806930693069155	0.025091982599514635	134	223209	3
1541	72.20799990934904	56.499999999999886	0.030332156081697835	134	223343	1
1542	72.11355627389192	62.763636363636515	0.03211636719880281	135	223478	12
1543	72.01030041040111	61.78796992481208	0.03853336850503333	133	223611	9
1544	71.8444826296648	55.428522336769646	0.0437711441155636	132	223743	5
1545	71.73830646008457	61.226865671641846	0.045541189666977504	133	223876	6
1546	71.52616729792274	50.524390243902296	0.04258201371377973	134	224010	8
1547	71.38712548309954	57.6219858156027	0.05169829455288974	132	224142	7
1548	71.16137224069091	48.81180124223591	0.020471056302388508	132	224274	2
1549	71.00328310844793	55.35245901639335	0.020067663335088474	134	224408	14
1550	70.88541694403013	59.216666666666555	0.019423369099112117	136	224544	10
1551	70.90312799198114	72.65652173913072	0.02661428988819391	142	224686	13
1552	70.85695751792213	66.2860805860809	0.02105709196816028	142	224828	4
1553	71.32421552894981	117.58275862069013	0.10076622735886347	168	224996	11
1554	71.16817590530589	55.72025316455682	0.01892778147821841	138	225134	3
1555	71.12235495211362	66.58608058608088	0.023415893101863722	139	225273	1
1556	70.98484518351121	57.371378091872636	0.03296066052985914	132	225405	12
1557	70.89888562056498	62.388888888889035	0.015796841477318635	139	225544	5
1558	70.78423009769267	59.43333333333325	0.012937760871389637	138	225682	6
1559	70.6628646179078	58.647682119205136	0.03841854663605385	141	225823	7
1560	70.45567705934201	49.94410876132919	0.03848574054774953	134	225957	2
1561	70.81278923072811	106.16689419795269	0.1136493223259248	166	226123	9
1562	70.70866871849462	60.400738007380056	0.04320021321002702	133	226256	14
1563	71.04747858303382	104.58965517241421	0.10885173082351685	160	226416	8
1564	70.91574756944547	57.874377224199144	0.023858861489729447	132	226548	10
1565	70.76695433216162	56.03642384105945	0.019303990833794894	134	226682	4
1566	70.65092838745592	59.1643598615916	0.02231423534564118	134	226816	11
1567	70.60387364903592	65.94545454545481	0.015763720759639034	135	226951	12
1568	70.4605093311502	56.26744186046497	0.019789546283323373	134	227085	1
1569	70.95321458266629	119.73103448275917	0.11748420335969872	181	227266	13
1570	70.81575314391034	57.207070707070606	0.018330803558007994	134	227400	5
1571	70.2897494586251	18.215384615384934	0.0646985972799906	164	227564	3
1572	70.11015917407019	52.33072100313466	0.02532818068319292	134	227698	6
1573	70.00832331659521	59.92657342657339	0.021194246277880312	134	227832	2
1574	69.87454078272995	56.63006993006983	0.03965260043288722	132	227964	14
1575	69.75508108918837	57.92857142857131	0.028445943077998376	134	228098	9
1576	69.61105486846041	55.35245901639335	0.026138663291931152	134	228232	8
1577	70.22983359313221	131.4889273356405	0.0885279566742653	172	228404	7
1578	70.11886859053423	59.13333333333322	0.034169115918747925	141	228545	4
1579	69.99699138003874	57.9311475409835	0.038970656428776736	141	228686	11
1580	70.46052635223184	116.35048859934903	0.09814797786244175	171	228857	10
1581	70.28758775537618	53.16666666666657	0.03130851574798128	134	228991	12
1582	70.16643542731047	58.172354948805356	0.03460304772675927	134	229125	1
1583	70.04405678732309	57.92857142857131	0.0344437627650019	134	229259	13
1584	69.95404087698411	61.04246575342469	0.024360166469090422	142	229401	3
1585	69.88213683185064	62.763636363636515	0.012813070085313585	135	229536	9
1586	69.77495906214806	59.1643598615916	0.014887892488223402	134	229670	2
1587	69.61761014492724	54.04006734006724	0.027441163857777912	132	229802	8
1588	70.24363012190935	132.21960784313768	0.08368448154655045	167	229969	6
1589	70.72612602408009	118.4932203389834	0.09918650458840762	170	230139	5
1590	70.58386476383929	56.499999999999886	0.03111562800051561	134	230273	7
1591	71.24437949965956	136.63533834586522	0.07508425877012055	174	230447	14
1592	71.09000501159365	55.806930693069155	0.031831559850208795	134	230581	11
1593	71.05391577228852	67.48108108108134	0.029138626875700773	135	230716	12
1594	70.94942608453029	60.604946996466396	0.029283756679958767	135	230851	1
1595	70.81200253075569	57.207070707070606	0.03008778059660499	134	230985	13
1596	70.69302043648263	58.913793103448164	0.02799239087460646	134	231119	3
1597	71.16191781832471	117.58275862069013	0.10628883043924968	168	231287	10
1598	71.75342598096545	130.31273408239755	0.07781017441110513	194	231481	4
1599	71.5510465199174	51.515479876160875	0.019233093332888473	134	231615	9
1600	71.44686701557232	61.13309608540927	0.02556438092832212	135	231750	2
1601	71.30685780487606	57.44594594594582	0.026236172932297436	134	231884	6
1602	71.10494307298114	51.11538461538452	0.02784373333205038	134	232018	5
1603	70.89791928327696	50.40256410256398	0.05207998962963328	136	232154	7
1604	70.70967779536223	52.07377049180319	0.05223461051485432	134	232288	14
1605	71.09687294287444	109.4291925465843	0.09275435329823012	178	232466	8
1606	71.01054057708207	62.463636363636496	0.02413322960121044	138	232604	1
1607	70.83651209438817	53.607692307692176	0.03398347251555499	136	232740	11
1608	70.7930077793051	66.48608058608089	0.023501382555280413	140	232880	12
1609	70.75688581959324	67.18081180811836	0.027757305035488213	139	233019	13
1610	70.7284375839654	67.91206225680962	0.039835606178228004	137	233156	3
1611	70.70512324557895	68.39700374531863	0.026727239004999615	139	233295	4
1612	70.5654131502469	56.734113712374445	0.01882402220768715	134	233429	2
1613	70.4783797083996	61.86206896551734	0.017984861950222537	139	233568	9
1614	70.8608331994512	108.72372881355966	0.12160836644919522	166	233734	10
1615	70.77047054219717	61.82456747404855	0.021309795513959	142	233876	6
1616	70.68931635942329	62.65505226480849	0.019912079941454552	139	234015	14
1617	70.58226530109222	59.98421052631573	0.02048947530634263	136	234151	5
1618	70.39774985811265	52.13072100313466	0.01779482469839208	136	234287	7
1619	70.31464192474891	62.08695652173924	0.06304474700269082	139	234426	8
1620	70.1481711811771	53.66756756756746	0.06793266793955928	138	234564	11
1621	69.98730111985077	54.06116504854357	0.057728335477303765	138	234702	1
1622	69.81467976428141	52.725165562913766	0.06501587825034981	134	234836	12
1623	69.74176373586936	62.523076923077106	0.08775805760096837	143	234979	3
1624	70.6974330550324	165.30869565217444	0.10458916287089504	172	235151	4
1625	71.31645872448209	132.60000000000045	0.08712034831846381	173	235324	13
1626	71.24521228670346	64.19181494661947	0.018650472164154053	140	235464	2
1627	71.01895521027606	48.619504643962735	0.06896863561688048	132	235596	9
1628	70.8594208305871	55.06551724137917	0.028779162876847862	138	235734	10
1629	70.75426324199954	60.34366197183099	0.04703206309565791	135	235869	7
1630	71.21726482726662	117.05442176870791	0.11729274729572275	189	236058	6
1631	71.09411383964377	58.902166064981834	0.031496831865021675	132	236190	11
1632	71.50248039355503	111.93076923076973	0.1391011171562727	172	236362	14
1633	71.31283294811004	52.53773584905651	0.033891172551397064	134	236496	1
1634	71.08385001922242	48.41454005934706	0.07520500127820001	138	236634	12
1635	71.64977476991359	127.67632508833958	0.12146835996393572	171	236805	8
1636	72.08491338585083	115.16363636363693	0.1733709037021438	211	237016	5
1637	71.80439758532565	44.033333333333225	0.10466539356070505	142	237158	3
1638	71.65142431654309	56.50707070707062	0.10962250215787414	141	237299	13
1639	71.48469954706187	54.97894736842095	0.11473105294363839	140	237439	2
1640	71.38872211680864	61.88695652173921	0.12631763972289173	141	237580	10
1641	71.23513559494124	56.03006993006982	0.05046397361202516	138	237718	7
1642	71.65568839234648	113.29041533546379	0.11234988949515602	176	237894	4
1643	72.01792275421427	107.87912457912495	0.1143280052276979	166	238060	9
1644	71.88401625394485	58.627272727272576	0.07495118549891881	140	238200	12
1645	71.79323491493481	62.80588235294137	0.09731468120654979	143	238343	1
1646	71.51081496247967	43.55123966942138	0.09438023768680197	142	238485	11
1647	71.3889725471206	59.326573426573354	0.07887969698224749	140	238625	8
1648	71.23075724025405	55.56744186046498	0.0707070641483821	141	238766	5
1649	71.88084142042884	136.23917525773246	0.15048586735959912	183	238949	6
1650	72.4596962364651	129.76632302405548	0.14556553377119522	179	239128	14
1651	72.43209927410045	69.70000000000027	0.06339909996784909	142	239270	3
1652	72.34544742634087	63.76691449814151	0.07256252664915273	142	239412	13
1653	72.17899295207746	55.6999999999999	0.08266982897906236	142	239554	10
1654	72.08062638022092	62.34233576642347	0.06953976859509105	142	239696	7
1655	71.91318435482931	55.336423841059464	0.08520778358405363	141	239837	4
1656	71.80644819473426	61.239568345323804	0.061696804745096555	142	239979	9
1657	72.2794328931148	119.10491803278745	0.1021753672006968	185	240164	2
1658	72.12033655076084	56.36979865771798	0.05249095644269671	140	240304	1
1659	71.97141889953895	57.22857142857132	0.056238823748649434	141	240445	12
1660	71.84914133026186	59.74366197183095	0.07469679108748199	141	240586	8
1661	71.79534222465155	66.46923076923103	0.06649492827939316	142	240728	14
1662	71.70081216006928	62.34233576642347	0.06686993719826281	142	240870	5
1663	71.52141568895401	53.76116504854357	0.06508535019894864	141	241011	6
1664	71.37794530430645	57.174377224199155	0.04751875074647313	139	241150	3
1665	71.81833468243222	115.41688311688348	0.12457856264981357	176	241326	11
1666	72.5487046952917	144.85533596837982	0.10815948352479098	171	241497	13
1667	72.38355878546253	56.034113712374456	0.06553333363634475	141	241638	4
1668	72.17938986427457	51.966666666666555	0.07520433974592652	146	241784	10
1669	72.11919366678126	66.15977011494279	0.06463978324137942	142	241926	9
1670	71.99026746437919	59.226573426573324	0.06558153138938524	141	242067	7
1671	71.8015057293327	53.114093959731406	0.029439610543010905	139	242206	2
1672	71.68354014200403	60.00494699646636	0.03584263510737859	141	242347	12
1673	72.47491961661706	150.82148760330628	0.08871689873772698	185	242532	1
1674	72.40709012848008	65.69197080291998	0.03444741347740436	145	242677	5
1675	72.29441491064851	61.13956834532379	0.042850240960821406	143	242820	14
1676	72.10154768461895	53.00769230769218	0.04405427314865757	142	242962	6
1677	72.73480493504549	135.42727272727322	0.10943406127219976	172	243134	11
1678	73.0459466816134	103.84897959183715	0.10203331612251901	185	243319	8
1679	72.86477243816496	54.92852233676964	0.03944059009969669	137	243456	4
1680	72.73556133350162	59.94366197183097	0.0429479612720956	139	243595	9
1681	72.54028264324353	53.20769230769218	0.0502561160496303	140	243735	10
1682	72.89741827834956	108.25384615384668	0.09180257561501493	178	243913	3
1683	72.8120261851183	64.35820895522416	0.052848589506080686	139	244052	7
1684	73.52720350112179	144.3297577854675	0.1511009237268469	182	244234	13
1685	73.31348842813588	52.155696202531516	0.02477190528117435	142	244376	12
1686	73.21343605210535	63.30825082508263	0.04757515173307888	191	244567	2
1687	73.0797383113026	59.843661971830954	0.02742694616317749	140	244707	5
1688	72.9422066624553	59.326573426573354	0.023062522070748465	140	244847	6
1689	73.42851307265195	121.57284768211974	0.0903768539428711	174	245021	1
1690	74.16828676545485	147.40588235294157	0.11379997120347134	172	245193	14
1691	73.94398125629087	51.73773584905651	0.05634172869400239	142	245335	4
1692	73.7240020115513	51.94605678233429	0.05901018330748652	142	245477	9
1693	73.60200766617628	61.52456747404852	0.051553331572434	145	245622	7
1694	73.54255280690583	67.6565217391307	0.05307710667451223	192	245814	11
1695	73.35865186900071	55.152459016393344	0.06489395394044764	136	245950	13
1696	73.85685845375899	123.17931034482814	0.11735686412832355	181	246131	10
1697	73.82171071864225	70.34208494208524	0.03909088660930765	145	246276	12
1698	73.60716027812249	52.36666666666657	0.03932588872775226	142	246418	2
1699	73.48110242104573	61.00137457044677	0.04305333104626886	145	246563	5
1700	73.4063014302801	66.00100334448209	0.05551491493035939	242	246805	8
1701	73.23463391436957	56.2395498392282	0.04384478595521715	144	246949	6
1702	73.26411790013562	76.18303249097555	0.03323185443878174	248	247197	3
1703	73.11564338780092	58.41666666666653	0.04391579495535956	144	247341	1
1704	72.96696377511495	58.24768211920515	0.048602248882425245	145	247486	14
1705	72.94966913736381	71.2375000000003	0.07054040856557349	146	247632	4
1706	72.77584686459483	55.56744186046498	0.05380852340806461	141	247773	9
1707	72.60608839594887	55.7999999999999	0.057333114299368354	141	247914	7
1708	72.4025844740147	52.25569620253152	0.05104423076548475	141	248055	11
1709	72.30448845383596	62.59298245614051	0.032658849913498454	145	248200	10
1710	72.86285340536318	128.140983606558	0.11143907734767143	193	248393	13
1711	72.74507811363037	61.08532423208196	0.03900545449565641	139	248532	6
1712	72.79429399916074	77.66666666666698	0.04194299780207572	139	248671	3
1713	72.70888152511895	64.25304659498234	0.037010959099079	145	248816	8
1714	73.02975712267916	104.79644128113921	0.15368696177227897	161	248977	2
1715	72.88893637264442	58.94768211920515	0.055068009141562645	138	249115	1
1716	73.26800228048349	110.79552715655001	0.12258755384817631	169	249284	5
1717	73.22641316676958	69.1090909090914	0.00832684743239583	217	249501	12
1718	73.17121670427483	67.70676691729352	0.0874067984971424	149	249650	4
1719	73.02583787056541	58.63333333333323	0.08545618841092881	146	249796	9
1720	72.89434220372416	59.87627118644059	0.08295798628297571	146	249942	7
1721	73.39308105593442	122.76822742474975	0.09940389069643887	176	250118	14
1722	73.28308006993647	62.392982456140494	0.06864551622040417	147	250265	11
1723	73.0850674510553	53.481818181818035	0.042430698055110565	146	250411	10
1724	72.99113492601094	63.69181494661943	0.040899500353582974	145	250556	13
1725	72.80249568559438	54.12721088435363	0.02976198472838471	138	250694	8
1726	72.56600084922036	49.15301204819263	0.038075923919677734	140	250834	6
1727	72.4714826846998	63.114184397163335	0.038955997776340796	148	250982	2
1728	72.9225954440597	117.58275862069013	0.08999746186392647	168	251150	3
1729	72.79466880934699	60.12993197278909	0.02593539838921534	146	251296	5
1730	72.6453716057896	57.86494845360813	0.03184525395782901	142	251438	4
1731	73.1732755539653	125.43576642335807	0.07877772762661889	168	251606	12
1732	73.64055541672218	119.90126182965355	0.10330064245995055	188	251794	1
1733	73.44496804437314	54.08181818181803	0.03596913133348737	140	251934	9
1734	73.33644818849082	62.59298245614051	0.04110478368298761	145	252079	7
1735	73.21447939005915	61.13956834532379	0.04096359306282097	143	252222	14
1736	73.15014941097338	66.78148148148176	0.040089048751413	146	252368	11
1737	72.93931458353032	52.066666666666556	0.0402322506082469	145	252513	10
1738	72.86540052514749	65.5479087452474	0.02596875479523565	142	252655	8
1739	72.66782344297295	53.10769230769218	0.0350013996692414	141	252796	6
1740	73.19771663711465	125.65714285714324	0.07770043088678728	171	252967	13
1741	72.94238652956703	47.66470588235284	0.030578027452741352	140	253107	2
1742	72.68186539983367	46.890273556230866	0.027516468711521313	138	253245	5
1743	72.60850129128988	65.34545454545481	0.06884012154653563	141	253386	12
1744	72.40308294504365	52.066666666666556	0.04992411383267107	145	253531	4
1745	72.25536359100305	57.63114754098351	0.042442268795437284	144	253675	1
1746	72.73853817808954	120.57282229965203	0.08109698066099442	187	253862	3
1747	72.53470975833396	52.35569620253152	0.026518709318978446	140	254002	7
1748	72.36603707935527	55.66744186046498	0.027376977034977504	140	254142	11
1749	72.24338408863551	60.10073800738004	0.021232424413456637	136	254278	10
1750	72.81345749412597	129.2507246376816	0.07823148866494496	192	254470	9
1751	73.26098958585138	117.56666666666713	0.08120729546797903	190	254660	14
1752	73.04297446123469	51.45947712418291	0.015330103860385176	138	254798	8
1753	72.86461402355303	55.20693069306916	0.020530588286263602	140	254938	6
1754	72.767875632395	63.19077490774928	0.038243448230582226	142	255080	2
1755	73.39591443332296	135.57175572519134	0.10776646557976217	170	255250	13
1756	73.22465327556691	56.26979865771798	0.0515175609723896	141	255391	12
1757	73.0821140598844	58.97073170731692	0.04085223556410336	141	255532	4
1758	72.86867027777612	51.73773584905651	0.04898574990285954	142	255674	5
1759	72.66254053702367	52.25569620253152	0.02945080209285655	141	255815	1
1760	72.43694077267907	50.10256410256398	0.01630958207219625	139	255954	11
1761	72.34295652396287	63.03851590106022	0.03093022842929788	146	256100	3
1762	72.9703777049919	135.0850746268662	0.07759169782145639	178	256278	7
1763	72.83038124501515	58.97073170731692	0.03900711248952446	141	256419	14
1764	72.60722558071315	50.514814814814684	0.04353545417248363	142	256561	9
1765	73.22658795388129	134.54346289752687	0.08180243431488214	173	256734	10
1766	73.05671757273475	56.2395498392282	0.034429712427986994	144	256878	6
1767	72.93100363932822	60.48532423208192	0.022377895486765893	145	257023	8
1768	72.90840678122952	70.67131782945766	0.038163421893941944	145	257168	2
1769	72.87201736990578	69.26946564885523	0.032662829307660665	146	257314	4
1770	72.67630954188573	53.30123456790109	0.04111498470964103	145	257459	13
1771	72.44879034890589	49.924390243902295	0.03080073084150042	140	257599	12
1772	72.27495761783062	55.0655172413792	0.02625415981679723	138	257737	1
1773	72.18026686518174	62.80588235294137	0.020949473747840293	143	257880	11
1774	72.037113681066	57.864948453608136	0.03158470610497703	142	258022	3
1775	72.45287455745667	113.61320132013257	0.0677879938010961	183	258205	5
1776	72.36426396134829	63.591814946619444	0.04993606920111669	146	258351	7
1777	72.27553947120099	63.49181494661944	0.04504558667033708	147	258498	14
1778	72.16840476614415	61.56206896551732	0.04284085018534056	142	258640	10
1779	72.02203219389254	57.53114754098351	0.05206587561245622	145	258785	9
1780	71.8504670443674	54.8655172413792	0.02711409500667027	140	258925	2
1781	72.40882929407583	127.68669201520964	0.09708742609994854	167	259092	6
1782	72.18014041804469	49.53994169096197	0.03620787653429755	145	259237	8
1783	72.05458225710747	59.62432432432425	0.060730215621321165	146	259383	13
1784	71.86645578937511	53.241935483870854	0.04985264274809095	144	259527	12
1785	71.75680497718584	60.901374570446755	0.05702526928627328	146	259673	11
1786	72.37602829432046	133.6791366906479	0.0808201607941203	173	259846	4
1787	72.98209951320877	132.98315018315066	0.10648274561117964	171	260017	1
1788	72.83075533926873	57.847682119205146	0.05434523972888921	149	260166	3
1789	72.80822197942445	70.577419354839	0.03748429843357631	140	260306	7
1790	72.58931367267368	50.91739130434771	0.039068134737686375	142	260448	5
1791	72.36266443838596	49.924390243902295	0.026699757575988768	140	260588	14
1792	72.24233711373	60.329931972789105	0.043113903866873846	144	260732	10
1793	72.57442593771466	105.45121951219546	0.2027973547214415	164	260896	9
1794	72.45498099806541	60.62993197278912	0.06573334822417996	141	261037	2
1795	72.37979809455958	64.9366906474823	0.06729604842814993	141	261178	6
1796	72.31600011361398	66.00000000000027	0.05799589225714155	139	261317	8
1797	72.25031919993032	65.7479087452474	0.11503956658499581	140	261457	12
1798	72.06482835361003	53.70123456790109	0.05513006575564121	141	261598	13
1799	71.93788738714709	59.37073170731694	0.03602193219818338	137	261735	3
1800	71.76678302307953	54.82745098039206	0.03594593758130596	137	261872	1
1801	71.1863047353324	13.718954248366487	0.16902135961196002	170	262042	11
1802	71.03611610658373	56.167441860464976	0.032766441062644674	135	262177	5
1803	71.46825825677618	114.25033112582838	0.12484798115261352	181	262358	4
1804	71.28103624203176	52.746056782334286	0.050001692416063	134	262492	14
1805	71.71735789281277	114.9132013201325	0.08766981573665843	170	262662	7
1806	71.74487257299396	74.4688259109315	0.03745655191355738	145	262807	6
1807	71.69024737667579	66.28235294117677	0.03803608993004108	145	262952	2
1808	71.52878934735347	55.54444444444431	0.02619783083597819	138	263090	8
1809	71.35431963569812	54.081818181818036	0.02961428506033761	140	263230	9
1810	71.77535708450243	113.45806451612944	0.07740370092544964	187	263417	10
1811	71.54478742170339	48.71839080459759	0.037037279870775014	144	263561	12
1812	71.37954207913192	55.02025316455683	0.031150202915586275	145	263706	3
1813	71.2018612094242	53.61145510835902	0.04342776205804613	144	263850	1
1814	71.17403127657523	68.41886792452858	0.022346527823086444	145	263995	11
1815	71.09165938486211	62.9368421052633	0.08494494358698527	192	264187	13
1816	71.04060359687429	65.98608058608089	0.02611123117907294	145	264332	4
1817	70.92493830164629	59.47407407407401	0.04073266654179014	145	264477	14
1818	70.81545163049422	59.976271186440606	0.03444286543747475	145	264622	7
1819	71.24170832914255	113.4411214953276	0.0774281838036686	173	264795	5
1820	71.16520939531732	63.591814946619444	0.041968417494264366	146	264941	2
1821	71.54055730136415	108.70000000000037	0.10852449911612051	162	265103	6
1822	71.89403578632152	106.88840579710177	0.10614552909945264	162	265265	8
1823	71.65687605523893	48.17806267806258	0.049179673194885254	144	265409	9
1824	72.15390430961192	121.35970149253781	0.09013380487281156	166	265575	12
1825	71.9748652665158	54.24999999999988	0.03064979116121928	144	265719	1
1826	72.40703774949733	115.19211356466923	0.08314093878102857	172	265891	3
1827	72.34282817786317	65.98608058608089	0.021147568472500506	145	266036	11
1828	72.31331177347917	69.39118773946387	0.04338218070365287	148	266184	13
1829	72.19360331327863	60.342465753424655	0.04317202344036743	149	266333	4
1830	72.25630830578687	78.46410256410341	0.1111092487970988	240	266573	10
1831	72.14346220386109	60.97169811320757	0.04225681225458781	144	266717	14
1832	72.01228261537952	59.02550335570456	0.05647732611416149	147	266864	5
1833	71.96712982667891	67.49700374531864	0.053219034865095806	148	267012	2
1834	71.86538835297353	61.79298245614043	0.038786878772810396	153	267165	7
1835	71.69493700108936	54.820253164556824	0.05119497273244014	147	267312	6
1836	71.53062457375363	55.2636942675158	0.05787930521024328	147	267459	8
1837	71.42333207372056	60.801374570446754	0.04683359626199112	147	267606	9
1838	71.265773171588	55.66744186046498	0.025484023775373187	140	267746	1
1839	71.13944877320544	58.63333333333323	0.03923488643071423	146	267892	12
1840	71.1033667854734	67.53125000000028	0.058022750748528376	144	268036	4
1841	71.01656388684944	62.423076923077076	0.05398095316357083	144	268180	10
1842	70.84521642979914	53.88181818181803	0.048195368807080766	142	268322	3
1843	70.73644511656497	59.96808510638292	0.05437917841805352	144	268466	13
1844	70.45728774986799	42.820708446866355	0.05429008457210514	143	268609	14
1845	70.9132197583628	116.05048859934905	0.08128725797280498	174	268783	11
1846	70.82931833000994	62.52307692307709	0.04012217888465294	143	268926	7
1847	70.66943784512253	54.841269841269735	0.03781805742507013	149	269075	5
1848	70.66977459507596	70.70311284046723	0.03392073914811418	148	269223	6
1849	70.65798872651985	69.49118773946387	0.03885755733567841	147	269370	8
1850	70.91797694556695	96.65681063122958	0.07144139725484966	162	269532	2
1851	70.86071688414047	65.19197080291998	0.033729114532470704	150	269682	9
1852	70.77074607893543	61.86363636363642	0.039540340503056846	144	269826	12
1853	70.66803861814608	60.49999999999998	0.03953601916631063	144	269970	1
1854	70.4715321450081	51.01739130434771	0.055885206723044104	141	270111	4
1855	70.34210253784373	57.52857142857131	0.03148461770320284	138	270249	13
1856	70.2404442243297	60.17627118644061	0.06306984374573181	143	270392	3
1857	70.07865143257185	54.06116504854357	0.031987204067948936	138	270530	14
1858	69.99326060169938	61.53956834532382	0.037961527597989965	139	270669	11
1859	69.94878254113692	65.54545454545482	0.044672554345439666	139	270808	6
1860	69.791906366211	54.26116504854357	0.04861118512995103	136	270944	7
1861	70.42789985007741	133.39125475285235	0.07488138957690167	186	271130	10
1862	70.33362085157664	61.000000000000014	0.05327559546601	139	271269	5
1863	70.2103572503216	58.00726072607246	0.042170123396248656	145	271414	8
1864	70.07422778785073	56.59741100323612	0.04218089005042767	145	271559	2
1865	69.95696233116428	58.347682119205146	0.04279952579074436	144	271703	12
1866	70.86998691075118	161.25942028985548	0.09045457358312126	198	271901	9
1867	70.64251650340003	48.12294617563726	0.04281740662053967	141	272042	1
1868	71.27833682573065	134.22454873646245	0.06900972024553773	173	272215	3
1869	70.99750082589439	43.19473684210515	0.04479337718388806	146	272361	7
1870	71.61228521613168	132.47593984962464	0.06540631712152717	178	272539	14
1871	71.52694014174814	63.07777777777797	0.033585505942775776	146	272685	2
1872	71.6247077773677	81.30370370370447	0.14440067787341473	223	272908	13
1873	71.49824665277129	58.97859531772563	0.04157748386777681	145	273053	8
1874	71.35576267566955	57.24984894259798	0.12527810402636258	212	273265	4
1875	71.29411058637214	65.19055374592857	0.04645728573356707	194	273459	6
1876	71.22755409589304	64.63846153846185	0.03999877194745825	218	273677	11
1877	71.31569031964	80.04117647058897	0.03498274610753645	228	273905	5
1878	71.14257250439147	54.00390879478814	0.03419937453903518	143	274048	12
1879	71.17606227230532	74.4915492957754	0.06806354522705078	240	274288	10
1880	70.98596831624893	52.16666666666656	0.04535417093171014	144	274432	1
1881	71.44626247924029	117.01538461538505	0.07003250667027065	175	274607	9
1882	71.19198717433261	46.018731988472496	0.027071509096357558	144	274751	13
1883	71.10399712715068	62.392982456140494	0.029041987698094376	147	274898	11
1884	71.48669841462043	109.37412587412625	0.09627823713349133	164	275062	6
1885	71.50081724607708	72.89858156028424	0.0265255868434906	192	275254	4
1886	71.66037004922607	87.45609756097632	0.025098600903072872	222	275476	8
1887	71.52440994734974	58.06435986159159	0.0351747282620134	145	275621	1
1888	71.27914337596613	46.99775280898866	0.04389740171886626	147	275768	10
1889	71.23124083109536	66.4888888888893	0.1073928798795281	223	275991	14
1890	71.1707148305514	65.17864077669934	0.031439338873953844	221	276212	7
1891	71.5320458988064	107.30382165605137	0.08993443420955113	168	276380	5
1892	71.58037249864188	76.36470588235368	0.07212302559300472	228	276608	2
1893	71.41346684528081	54.88980716253418	0.0618272114949054	249	276857	3
1894	71.94290360539942	124.35714285714334	0.05747459245764691	184	277041	12
1895	71.85839271881161	63.49181494661944	0.04004628642075727	147	277188	9
1896	71.75669768051239	61.688888888888954	0.04293564574359215	146	277334	13
1897	71.61344217911709	57.43114754098351	0.04000923731555677	146	277480	11
1898	71.44751028897149	55.02025316455683	0.03535531800368737	145	277625	4
1899	71.27239344153348	53.93582554517124	0.04637536016003839	145	277770	1
1900	71.20977095639351	65.01014492753649	0.04601844696149434	146	277916	14
1901	71.0267501699065	52.90769230769218	0.04454854151585719	143	278059	10
1902	70.90037967817422	58.3897009966776	0.06515563024233466	146	278205	7
1903	70.70603654205313	51.46606606606593	0.06355749327560951	145	278350	8
1904	70.57562566116867	57.66494845360813	0.055690374639299184	144	278494	5
1905	70.42323364296757	55.336423841059464	0.03688529873570652	141	278635	9
1906	70.3341240502202	61.512274368231125	0.04116461310588138	142	278777	12
1907	70.16102396727428	53.02411575562691	0.03446246518029107	144	278921	2
1908	70.05465697084477	59.52432432432425	0.03918316250755673	147	279068	3
1909	70.2917059067543	93.75955056179815	0.09590405644597234	185	279253	6
1910	70.2412433931413	65.2454545454548	0.04724908882463482	142	279395	13
1911	70.12014243461972	58.131147540983505	0.03935015973427313	139	279534	11
1912	70.140082742557	72.11417322834676	0.020991817116737366	144	279678	1
1913	70.7965326614001	135.78507462686616	0.08477621468884206	171	279849	4
1914	70.57330984975616	48.47425149700587	0.027168245582313805	143	279992	10
1915	70.46141885652176	59.38421052631569	0.03164413613332829	142	280134	12
1916	70.34551198502972	58.870731707316914	0.030206139658538387	142	280276	9
1917	70.26269322881578	62.063636363636434	0.07391374883517413	142	280418	3
1918	70.07082820128953	51.076190476190334	0.0469843457628797	143	280561	2
1919	70.58800880816553	121.78888888888945	0.10090418422923368	170	280731	7
1920	71.1240476390028	124.19189189189223	0.0963371992111206	176	280907	8
1921	71.73680716261276	132.40000000000046	0.09992628914969308	175	281082	5
1922	71.14746939401695	12.803030303030738	0.08232648032052177	175	281257	14
1923	71.74999470007678	131.40000000000052	0.10712090569573479	185	281442	6
1924	71.49494302893808	46.24482758620679	0.042325592041015624	140	281582	13
1925	71.43847268610118	65.8479087452474	0.042893749346836006	139	281721	11
1926	71.26020251032375	53.61145510835901	0.049647589524587	144	281865	4
1927	71.09512507538444	54.75245901639335	0.033237334660121375	140	282005	3
1928	70.91410034220247	52.99265175718837	0.027383720874786376	140	282145	9
1929	70.74677752059864	54.18181818181804	0.02936319996127122	139	282284	10
1930	70.56809955430985	52.87898089171963	0.026991617765358026	139	282423	2
1931	71.09110083301425	122.86822742474973	0.09094910212925503	175	282598	1
1932	70.98468424847593	60.449442379182145	0.020327403925467228	138	282736	7
1933	70.79108740599116	51.62499999999988	0.020903456982948796	139	282875	8
1934	71.28201545810576	119.88389261745019	0.07084520296616988	176	283051	12
1935	71.15336197019137	58.41666666666652	0.044079720973968506	144	283195	6
1936	71.41125363784579	96.94252873563255	0.06911804156596434	179	283374	5
1937	72.27250342030791	157.5362318840584	0.0877730019727544	199	283573	14
1938	72.73012973745618	118.03513513513545	0.09793979420381434	170	283743	13
1939	72.58885010073143	58.602166064981844	0.03252321172643591	135	283878	3
1940	72.39275140864132	52.97898089171963	0.0266440294790959	138	284016	9
1941	72.3037316436324	63.4907749077493	0.029423734266980948	139	284155	1
1942	72.17696006146181	59.62657342657337	0.02907680943064446	137	284292	2
1943	71.96134430700104	50.61538461538452	0.033074447576948204	139	284431	10
1944	71.8941836941197	65.24528301886818	0.035167906781752335	139	284570	7
1945	71.7050316660957	52.97898089171963	0.022825127062590225	138	284708	8
1946	72.58928930791227	160.13079584775133	0.0992843802205197	197	284905	4
1947	72.49553825880479	63.21418439716332	0.04884485322601941	147	285052	6
1948	73.06826708674305	129.76842105263202	0.07809834616524833	175	285227	12
1949	73.00040794528738	66.28235294117677	0.037059178845635775	145	285372	14
1950	72.85973719916784	58.93333333333323	0.041109528574910195	143	285515	5
1951	72.68420913410685	55.30693069306916	0.016468116705366177	139	285654	13
1952	72.59994913231802	64.25820895522416	0.01721372434071132	140	285794	1
1953	72.44102034806555	56.70707070707062	0.02451221033823576	139	285933	9
1954	72.37226093823568	65.56507936507964	0.03636108175681455	137	286070	10
1955	72.14106844933525	49.25301204819263	0.028587094313806766	139	286209	3
1956	71.9076577648419	48.79999999999988	0.03462201707503375	136	286345	2
1957	71.73139936901165	54.28181818181803	0.03384595677472543	138	286483	7
1958	71.6109274805847	59.68421052631571	0.028050076189658626	139	286622	8
1959	72.67606820577888	178.1250000000011	0.13983828498717935	374	286996	11
1960	72.53138013098182	58.207260726072455	0.045661986290991725	143	287139	6
1961	72.3091251532014	50.30588235294106	0.04106518605372289	143	287282	12
1962	73.0671129530528	148.10790513834033	0.07504744476146913	178	287460	4
1963	72.89307876619742	55.6636942675158	0.03730109021380231	143	287603	14
1964	73.41443830111609	125.02903225806492	0.10150668621063233	160	287763	5
1965	73.21690556859038	53.661165048543566	0.04965882234170403	142	287905	13
1966	73.1204056578859	63.56691449814149	0.054781950182384916	144	288049	1
1967	72.96148731559275	57.22857142857132	0.047631984061383185	141	288190	9
1968	72.69693304849743	46.5060606060605	0.040533985410417826	140	288330	10
1969	72.50878189983064	53.88181818181803	0.05103718394964513	142	288472	2
1970	72.354558487612	57.08644067796595	0.02311922141483852	140	288612	7
1971	72.18901290273587	55.7999999999999	0.027479699317445146	141	288753	8
1972	72.58384499593073	111.67222222222274	0.08470161232405794	167	288920	3
1973	72.47258230354718	61.457575757575825	0.014041476686235885	142	289062	11
1974	72.33075349047849	58.289700996677595	0.03464434746982289	147	289209	6
1975	72.14212163124937	53.46756756756746	0.014870355810437884	140	289349	12
1976	72.03482315861919	61.412274368231124	0.03641045510352075	143	289492	4
1977	72.03704014442431	72.25652173913073	0.0320162054610579	146	289638	14
1978	71.92829043263524	61.162068965517285	0.03633155888074065	146	289784	5
1979	71.87696101668098	66.79534883720959	0.02209802824875404	145	289929	13
1980	71.756872257578	59.86808510638291	0.030717876039702316	145	290074	1
1981	71.62463686833556	58.53333333333323	0.04091429223819655	147	290221	9
1982	71.48652843068668	57.81379310344817	0.04067671545620622	145	290366	10
1983	71.35799647971314	58.63333333333323	0.04409334757556654	146	290512	2
1984	71.23074984824933	58.63333333333323	0.04480489312785946	146	290658	3
1985	71.07631774912787	55.7875399361021	0.04093519184324476	144	290802	8
1986	70.9959397306472	63.03851590106022	0.054301866113323057	146	290948	11
1987	71.57305506643681	128.70747330960904	0.11539021988361202	171	291119	7
1988	71.45437398573709	59.704946996466326	0.028418362140655518	144	291263	6
1989	71.43753873296458	69.77084870848739	0.07193646748860677	150	291413	4
1990	71.24908986320682	52.59265175718837	0.04607273472679986	144	291557	14
1991	71.45351753135	91.69185667752481	0.06749986539221113	157	291714	12
1992	71.28718488768207	54.820253164556824	0.03933401497042909	147	291861	13
1993	71.9972712137102	142.29581749049487	0.06384516589214347	173	292034	5
1994	71.88015174389392	60.285324232081905	0.03219842586387582	147	292181	1
1995	71.74551689312165	58.416666666666536	0.047121690379248724	144	292325	9
1996	71.69287253500124	66.48108108108136	0.04694305946087015	145	292470	3
1997	72.0920750837825	111.61312741312786	0.06546002284736391	157	292627	2
1998	72.01462801715522	64.34736842105289	0.04192756126666891	145	292772	8
1999	71.8931625880475	59.86808510638291	0.03336340805579876	145	292917	11
2000	71.77199367403144	59.77627118644059	0.05588395254952567	147	293064	7
2001	72.18406321097534	112.97894736842146	0.06842234843486064	185	293249	10
2002	72.11714228689478	65.49197080291995	0.06041629946961695	147	293396	6
2003	71.94376033771003	54.778947368420944	0.054627062569201836	142	293538	14
2004	71.70928198198183	48.495924764890155	0.055689608797113946	141	293679	4
2005	71.57583276077793	58.36435986159159	0.05213272067862497	142	293821	12
2006	72.00993585639114	114.98614232209778	0.0849409818649292	160	293981	5
2007	71.81897743742454	52.91409395973141	0.03502005042759239	141	294122	9
2008	71.63202882060655	53.12411575562691	0.046568383703698646	143	294265	1
2009	72.25498125967322	133.9272727272733	0.06326759052786597	187	294452	13
2010	72.14282713052971	61.03956834532379	0.038431793451309204	144	294596	3
2011	72.0015367902589	58.013793103448165	0.0332316418627759	143	294739	8
2012	71.77746409751553	49.594267515923455	0.021467927524021695	140	294879	11
2013	71.55013054415367	49.0441087613292	0.03854125029557235	143	295022	2
2014	71.4093527882002	57.47235494880536	0.029172291992403936	141	295163	10
2015	71.1586688988724	46.34096385542155	0.020143260126528534	138	295301	7
2016	71.02426029207545	57.71780821917797	0.028747186593130126	141	295442	6
2017	71.0000572148464	68.60395256917025	0.023388962645630736	143	295585	12
2018	70.83658123286187	54.65245901639335	0.021668265051875555	141	295726	4
2019	71.25123428845778	112.30188679245315	0.059710076769942756	159	295885	14
2020	71.13415856529151	59.543661971830936	0.03799843621420693	143	296028	5
2021	71.04624033730283	62.34233576642347	0.05102019242837395	142	296170	9
2022	70.96070775849121	62.492982456140496	0.0385049532537591	146	296316	1
2023	70.85115015087096	60.00494699646636	0.029813002187309534	141	296457	3
2024	70.67156516693414	52.892651757188375	0.01714128129025723	141	296598	13
2025	70.5145046876786	54.9655172413792	0.018263554401534925	139	296737	11
2026	70.39284371723494	58.34840764331198	0.08274089323507773	148	296885	2
2027	70.34091528006259	65.20000000000024	0.041644926784800834	147	297032	7
2028	70.25075180200244	61.3245674740485	0.047032550889618545	147	297179	6
2029	70.62407393697926	107.58296529968507	0.09223640029494827	185	297364	8
2030	70.53672208649836	61.88888888888897	0.04055554336971707	144	297508	12
2031	70.40396724348354	57.26123778501614	0.03912750657621797	143	297651	4
2032	70.29666831178945	59.67407407407403	0.03733500567349521	143	297794	14
2033	70.83427305724298	124.05714285714336	0.05196327066676502	187	297981	10
2034	70.69415018482658	56.8219858156027	0.020579772336142405	140	298121	9
2035	70.54565312742277	55.84444444444431	0.03036608519377532	135	298256	13
2036	70.4216734173406	58.14768211920515	0.04812463995528548	146	298402	5
2037	70.39952435234014	68.2067669172935	0.039090474446614586	144	298546	1
2038	70.36133722689792	66.58081180811837	0.03420859040885136	145	298691	3
2039	70.36792628377874	71.02024291498005	0.021125263447384184	139	298830	11
2040	70.30676387487355	64.2516853932587	0.02275703503535344	143	298973	7
2041	70.16482444125302	56.112820512820385	0.029670021750710228	143	299116	2
2042	70.04524880410122	58.207260726072455	0.022971153259277344	143	299259	6
2043	69.93903955930345	59.42432432432423	0.040382700997429924	148	299407	8
2044	69.80793487799612	56.82857142857127	0.05381463807204674	145	299552	12
2045	69.83934955312054	72.94940239043854	0.024461837664042432	146	299698	14
2046	69.72002866485006	57.90726072607246	0.0433897318905347	146	299844	4
2047	69.62412769792945	60.12993197278909	0.03913124293497164	146	299990	10
2048	69.57698787022552	64.91014492753649	0.03800234502675582	147	300137	9
2049	70.36668737927837	148.5469387755108	0.0714298493084423	187	300324	5
2050	70.72719772067546	106.4177215189877	0.09159738777657232	169	300493	11
2051	70.69671311888399	67.67873754152845	0.04203515411705099	186	300679	13
2052	70.63884743697051	64.91014492753649	0.07036837104226457	147	300826	6
2053	70.9965291380394	106.40701754386005	0.1012709798988389	163	300989	7
2054	71.10102538512055	81.44615384615453	0.061049871915124454	223	301212	1
2055	71.12704601930024	73.70308880308912	0.08360209782918294	150	301362	12
2056	71.6554606802145	123.96851211072703	0.05999627809846	178	301540	2
2057	71.60922761682072	67.03215434083633	0.059435203085820225	229	301769	3
2058	71.47946867398583	58.63333333333323	0.07459946201272206	146	301915	8
2059	71.28056872408807	51.589473684210425	0.04152058540506566	141	302056	4
2060	71.1434472473735	57.56842105263147	0.04292531889312121	147	302203	10
2061	71.01008538216048	57.80726072607246	0.05787783252949617	147	302350	14
2062	70.8369968740179	53.701234567901096	0.059969699129145196	141	302491	9
2063	70.63597755462835	50.7350649350648	0.039862883006427305	141	302632	13
2064	70.43376592723021	50.41481481481468	0.05960638539774434	143	302775	11
2065	70.331759228812	60.233096085409215	0.05078948206371731	144	302919	6
2066	70.22128374178705	59.284210526315675	0.06662903632317389	143	303062	7
2067	70.10071450298508	58.16435986159159	0.046721468369166054	144	303206	1
2068	70.63984877209666	124.01414141414182	0.10317688870292178	173	303379	5
2069	70.43960508313731	50.615479876160876	0.04054683738655144	143	303522	12
2070	70.34189720434894	60.668817204301064	0.03770595418995824	145	303667	3
2071	70.27706032185769	63.85820895522414	0.04950872725910611	144	303811	4
2072	70.0571553902809	48.28656716417902	0.046746414024513086	143	303954	8
2073	69.892549938073	53.596610169491385	0.02615919518978038	141	304095	10
2074	69.64184477767532	44.82203389830495	0.03850400116708544	144	304239	2
2075	69.480037980384	53.46116504854357	0.026245938407050237	144	304383	14
2076	69.39125134628463	60.60137457044675	0.04919841945571388	149	304532	9
2077	69.25673433121406	55.93954983922819	0.03562905837078484	147	304679	11
2078	69.17803655311931	61.38695652173917	0.029641896078031357	146	304825	6
2079	69.06673300878018	58.04768211920515	0.03288649215179236	147	304972	7
2080	69.67757292506919	130.15072463768155	0.09592626394469882	183	305155	13
2081	69.54625665527796	56.54594594594584	0.03237255136449854	143	305298	12
2082	69.93379408872518	108.30000000000051	0.16408955907247152	166	305464	1
2083	69.75291671566127	51.84605678233429	0.03683395985956792	143	305607	3
2084	69.58352848810196	52.81409395973141	0.03113684184114698	142	305749	2
2085	69.48337405428478	59.56808510638289	0.03231592113907273	148	305897	8
2086	69.96969415989578	118.11538461538494	0.057514074372082225	164	306061	10
2087	70.64581271645181	137.58154981549868	0.08898409253600016	173	306234	4
2088	71.18239806754816	124.30434782608728	0.08410951512805104	169	306403	14
2089	71.55629231891689	108.57182320442033	0.13160759469737177	184	306587	5
2090	71.43199512999345	59.12657342657332	0.04669895642240283	142	306729	9
2091	71.35258292777101	63.4907749077493	0.02534048505824247	139	306868	6
2092	71.26060762114138	62.155052264808454	0.02795098887549506	144	307012	7
2093	71.12668575545628	57.86842105263147	0.03232832418547736	144	307156	12
2094	71.7519102473827	133.6491349480973	0.11911349940944363	185	307341	11
2095	71.71036118236205	67.59700374531863	0.04557560576873572	147	307488	2
2096	72.0413302348983	104.80726643598649	0.07609405046627846	162	307650	3
2097	72.14013915477153	81.9222222222226	0.16795374217786288	152	307802	10
2098	72.104011906526	68.52741433021838	0.03254976067491757	186	307988	13
2099	72.13573833798338	75.27665505226526	0.10667144041010403	187	308175	1
2100	72.19723908609144	78.28581314878937	0.051331185005806586	185	308360	8
2101	71.99391926320637	51.865256797582965	0.03649111780627021	145	308505	5
2102	72.3568985658721	108.29184952978102	0.11158338434555952	170	308675	4
2103	72.17698475262718	54.36551724137917	0.03955608236378637	145	308820	9
2104	72.0657742271348	61.05593220338977	0.046231987452743074	202	309022	14
2105	71.94441580459134	59.92993197278907	0.04858169040164432	148	309170	6
2106	71.82697164654543	60.19999999999996	0.019610589864302655	147	309317	11
2107	71.65590446172554	54.72025316455683	0.03074939186508591	148	309465	12
2108	72.41136236626083	147.20169491525468	0.2300389675383872	188	309653	7
2109	72.96610275719678	127.8854014598545	0.07953769365946452	180	309833	2
2110	73.40518180182698	116.87400722021695	0.10129303530038121	166	309999	10
2111	73.3636318849494	69.25019011406872	0.04091227471411645	143	310142	4
2112	73.22583767136307	59.584210526315694	0.04636736256735666	140	310282	8
2113	73.80956814223309	131.59888475836476	0.08913348141838523	170	310452	13
2114	74.36075817509648	128.92857142857187	0.07495081013646619	174	310626	3
2115	74.27307030137472	65.59197080291996	0.04673234730550688	146	310772	5
2116	74.08833959836096	55.7999999999999	0.03138626044523631	141	310913	9
2117	74.57589591868941	122.84397163120633	0.05197846952569548	189	311102	1
2118	74.40114009429875	57.10031347962368	0.08335380426189243	149	311251	6
2119	74.2168031119604	55.96744186046497	0.03998536089040937	137	311388	12
2120	74.09225577049597	61.76206896551732	0.06596738951546806	140	311528	11
2121	74.59655796849134	124.52247557003318	0.10200742221771077	187	311715	14
2122	74.50569383808178	65.51014492753649	0.04728065314867818	141	311856	7
2123	74.46965548706157	70.90185873605978	0.030050751258587013	145	312001	2
2124	74.32472164405536	59.976271186440606	0.05949482095652613	145	312146	3
2125	74.16795850404793	58.64840764331198	0.07084060537404027	145	312291	4
2126	74.0337035765417	60.742465753424675	0.0788278448170629	145	312436	13
2127	73.76983556732495	47.64690265486712	0.03733696064478915	142	312578	5
2128	73.60644868706153	57.43114754098351	0.04765112106114218	146	312724	9
2129	74.0182528133296	114.78686131386901	0.09788779056433475	165	312889	8
2130	74.75873695186296	148.0666666666671	0.07767131908519848	185	313074	10
2131	75.47482584133714	146.3676258992811	0.07504607250815944	190	313264	1
2132	75.33669827257894	61.66206896551732	0.04530461629231771	141	313405	11
2133	75.12444584093674	54.11145510835901	0.026383346790890043	139	313544	14
2134	75.84726020605679	147.40588235294157	0.08637138854625613	172	313716	12
2135	75.9216854142152	83.28978102189834	0.11874299353741585	188	313904	6
2136	75.8656224062269	70.31538461538489	0.04785656593215298	142	314046	7
2137	75.68681428343046	57.98481012658213	0.06484271068962252	147	314193	3
2138	76.3198273666498	138.98812260536437	0.06855780813429091	180	314373	2
2139	76.19894201815337	64.23129251700706	0.06402766961845563	139	314512	10
2140	76.58874207165606	115.17894736842153	0.10042689036737922	163	314675	5
2141	76.61925394422572	79.6399293286224	0.06598487496376038	192	314867	4
2142	77.21415729519443	136.10958904109637	0.1358686372554502	179	315046	8
2143	77.29631188948989	85.42961672473918	0.09556963067305715	190	315236	9
2144	77.25216844272614	72.88196721311549	0.10721282613762903	221	315457	13
2145	77.16054228068694	68.08955223880628	0.04658282231941498	139	315596	14
2146	76.98823617760796	59.929931972789085	0.046478857865204684	148	315744	12
2147	76.79883063702393	58.04768211920515	0.04565861760353555	147	315891	7
2148	76.46331726469062	43.24749340369383	0.04096808725473832	147	316038	6
2149	76.36549890685852	66.68148148148177	0.04061129952774567	147	316185	3
2150	76.35070204927783	74.88581314878955	0.11097752993509649	219	316404	11
2151	76.19420877448951	60.70137457044675	0.05606274991422086	148	316552	2
2152	76.49075648266299	105.84897959183705	0.09469052517052853	165	316717	5
2153	76.26634891783635	54.049999999999876	0.033381226944596804	146	316863	4
2154	76.1432158946078	63.95304659498233	0.03584773798246641	148	317011	9
2155	76.64223083463784	126.04470989761143	0.06887041690737702	172	317183	8
2156	76.48023318382572	60.442465753424656	0.027219105411220242	148	317331	13
2157	76.44144672500335	72.60158730158761	0.06193799841893862	146	317477	12
2158	77.04720206907407	137.0169811320759	0.08072109114040028	176	317653	14
2159	76.92120373259385	64.44736842105289	0.061262673801845975	144	317797	7
2160	76.83314401314871	68.11523178807994	0.03592645684067084	245	318042	10
2161	76.69246046034117	62.76478873239457	0.029324008993906518	146	318188	6
2162	76.58145556376695	65.59197080291996	0.04115443033714817	146	318334	3
2163	76.34348763389615	52.78466257668702	0.039667018472331846	146	318480	11
2164	78.52038609089051	294.0333333333328	0.4993196993458028	392	318872	1
2165	78.39799034806279	66.28081180811836	0.05169373267405742	148	319020	4
2166	78.23164680821853	61.763636363636415	0.04445508101890827	145	319165	5
2167	78.12675121555722	67.74208754208782	0.03553349354545477	197	319362	2
2168	77.91276941768736	56.72857142857128	0.037878402291911924	146	319508	9
2169	77.70050613029014	56.686440677965955	0.041382922066582575	144	319652	7
2170	77.45973088265183	53.622981366459506	0.04480818852986375	146	319798	14
2171	77.42403321540237	73.8899641577066	0.04987932244936625	192	319990	8
2172	77.27135220528226	62.155932203389874	0.03609646802173235	191	320181	12
2173	77.26149681471732	76.28581314878949	0.051246475591892146	205	320386	13
2174	77.16521997606655	67.63381294964059	0.05217575709025065	150	320536	1
2175	77.12472009418669	73.11523178807974	0.056506425906450324	195	320731	10
2176	77.07784024018359	72.43673469387805	0.05018401763599771	193	320924	3
2177	76.903305081025	59.62432432432426	0.09860541722545885	146	321070	5
2178	76.73927203021475	60.49999999999998	0.16162443161010742	144	321214	2
2179	76.74362124539647	77.17419354838762	0.043686279883751504	195	321409	11
2180	76.53452617006626	55.83411371237446	0.03202204937701459	143	321552	9
2181	76.45343514565374	68.42542372881387	0.04573591066443402	230	321782	6
2182	76.8076020928985	111.87012987013026	0.0698234728594732	179	321961	4
2183	76.5811199286248	54.15938566552892	0.020775704724448067	140	322101	14
2184	76.47122843736776	65.59197080291996	0.051062988908323524	146	322247	12
2185	76.25017132540788	54.36551724137917	0.0651952809300916	145	322392	13
2186	76.72924104072523	124.15714285714341	0.11808857866512831	186	322578	7
2187	77.46293031529967	150.09816849816897	0.13645291979847057	183	322761	8
2188	77.25658672643239	56.82857142857127	0.039065880611025054	145	322906	1
2189	77.08802085916807	60.39999999999998	0.03900689092175714	145	323051	3
2190	77.55189373699615	123.47530864197572	0.11328300185825514	184	323235	10
2191	77.34611857186817	56.97437722419915	0.05083606260042664	141	323376	6
2192	77.22613647360195	65.34790874524741	0.04383084509107801	144	323520	4
2193	77.8388409791731	138.4965870307173	0.10581158555072287	184	323704	2
2194	78.32775153845354	126.72989690721698	0.08537283761160715	175	323879	11
2195	79.23702504347717	169.25510204081695	0.09304903901141623	184	324063	9
2196	79.79798812637574	135.33333333333377	0.0971710908346336	179	324242	5
2197	79.59127397937772	59.12657342657332	0.049739589153880805	142	324384	14
2198	79.35248944471215	55.71282051282038	0.03461250318150942	147	324531	8
2199	79.04549467074696	48.653012048192636	0.026337635106053844	145	324676	1
2200	78.76969032644912	51.465060240963716	0.035649221770617426	147	324823	7
2201	78.60764131050858	62.564788732394554	0.025445886560388514	148	324971	3
2202	78.57093331845613	74.93684210526371	0.06399727835873056	197	325168	13
2203	78.48965988270747	70.44358974359001	0.0596908430258433	192	325360	12
2204	78.26210442100414	55.73411371237446	0.05045849747127957	144	325504	6
2205	78.11062522076573	63.11418439716332	0.052700957736453495	148	325652	10
2206	77.88891446695034	55.93954983922819	0.05292962197543812	147	325799	4
2207	77.74955578823065	63.95304659498233	0.050992714392172324	148	325947	11
2208	77.54167260819851	56.96123778501615	0.045142232555232635	146	326093	2
2209	77.31107978148759	54.482389937106824	0.04644138519078085	146	326239	9
2210	77.10294309370508	56.497411003236124	0.03887774193123596	146	326385	5
2211	77.02041556390871	68.85019011406872	0.038817123490936904	147	326532	14
2212	76.84989225933344	59.96808510638292	0.027389238278071087	144	326676	7
2213	76.7442014548213	66.28081180811837	0.029363696639602248	148	326824	8
2214	76.52817213868578	55.14126984126974	0.03511164612966041	146	326970	12
2215	76.40442088324875	64.15304659498233	0.03563357705939306	146	327116	10
2216	76.235117415157	59.474074074074025	0.03739226439903522	145	327261	6
2217	76.90388651591952	143.1120274914094	0.10045073462314293	183	327444	13
2218	76.7979334593412	66.30858085808605	0.02896164864608922	194	327638	1
2219	76.58459106742295	55.463694267515805	0.053496235814587824	145	327783	5
2220	77.23665424765781	141.79090909090945	0.1197519302368164	172	327955	2
2221	77.40389094404763	93.96032388664027	0.05386246300731916	193	328148	11
2222	77.26154010800165	63.16880733944969	0.06013647385829471	193	328341	4
2223	77.35714919671756	86.82244897959238	0.03543762117624283	192	328533	14
2224	77.2407265720643	65.7148867313921	0.04476087708627024	248	328781	3
2225	77.26877226801614	80.04529616724794	0.05495518588563472	209	328990	9
2226	77.92064704533598	142.4562500000005	0.11334936185316606	176	329166	7
2227	77.61590950143629	47.446892655367094	0.047966819919951977	146	329312	8
2228	77.4609811756527	62.12307692307704	0.0406310898917062	147	329459	10
2229	77.30061703863666	61.424567474048516	0.047253122068431276	146	329605	6
2230	77.06272541933389	53.511455108359016	0.047580909729003903	145	329750	13
2231	76.8818841183178	58.97859531772563	0.05831407349685143	145	329895	1
2232	76.90108625615561	78.80209790209838	0.03936786651611328	190	330085	12
2233	76.70302964196006	57.095424836601204	0.03145022294959243	147	330232	2
2234	76.46841870037916	53.241935483870854	0.032706899775399104	144	330376	5
2235	76.2780459887852	57.43114754098351	0.0347540607191112	146	330522	11
2236	76.21163902287326	69.63734939759067	0.03559187340409788	146	330668	4
2237	76.17453850566041	72.50158730158762	0.029820059432464394	147	330815	14
2238	75.92744372301344	51.465060240963716	0.02521536463782901	147	330962	3
2239	76.31830129898464	115.0132013201325	0.10984913978350938	169	331131	9
2240	76.2071182859948	65.20000000000023	0.02960716623838256	147	331278	7
2241	76.75652858461633	131.14814814814866	0.10536079858181745	169	331447	8
2242	76.61502212229959	62.605882352941364	0.0330542071112271	145	331592	6
2243	76.43971400633976	59.08421052631567	0.031905871424181706	145	331737	12
2244	76.20632921195538	53.101234567901095	0.058192558029071	147	331884	13
2245	75.9890898192069	54.482389937106824	0.046721095908178044	146	332030	1
2246	75.7584400785711	52.924115755626914	0.04329891533687197	145	332175	5
2247	76.78314979543245	178.2294117647066	0.26692785130869046	202	332377	10
2248	77.01060862005878	99.52903225806483	0.13361281192663943	165	332542	2
2249	76.78115770627198	54.06551724137917	0.057119259963164457	148	332690	14
2250	77.07151169212318	105.8165562913912	0.16944543999361705	166	332856	11
2251	76.84402638886654	54.32298136645951	0.25524004929357297	139	332995	3
2252	76.68633893396664	61.0752808988768	0.11806447238208138	187	333182	4
2253	76.58428366270816	66.48081180811837	0.05372713363333924	146	333328	9
2254	76.33509142849071	51.66506024096372	0.04501866307751886	145	333473	7
2255	76.26207384753914	69.0333333333336	0.08847565718100105	142	333615	8
2256	76.09669635230699	59.724324324324265	0.060143266875168376	145	333760	6
2257	75.93297263202716	59.724324324324265	0.042430088437836744	145	333905	13
2258	75.90917704225308	73.5534136546188	0.04505734216599237	147	334052	1
2259	76.15949880566514	100.94135338345906	0.12303263756536668	155	334207	12
2260	76.02928897661909	63.13851590106024	0.040878690522292566	145	334352	5
2261	75.88561677650807	61.66206896551732	0.04724254337608391	141	334493	10
2262	75.79656872682418	66.98081180811836	0.04557242292038938	141	334634	11
2263	75.66049192844483	62.188888888889004	0.0447635718271242	141	334775	2
2264	75.49405367582703	59.01666666666654	0.04638723705125892	138	334913	14
2265	75.28638764887269	54.72745098039206	0.029980763145115063	138	335051	3
2266	75.17989067885878	64.6366906474823	0.028883523411220975	144	335195	4
2267	75.48480394919197	105.67121771217758	0.05421119332313538	160	335355	9
2268	75.41414458894533	68.41886792452858	0.030860364848169786	145	335500	7
2269	75.23061552090604	57.06123778501615	0.036084247457570044	145	335645	8
2270	75.13322907372618	65.49197080291997	0.024477621325019266	147	335792	6
2271	75.7172497241654	133.5352941176475	0.08429163659525196	171	335963	1
2272	75.51475164552839	55.46744186046498	0.040571622445549765	142	336105	10
2273	75.32657823910547	56.69741100323612	0.044404447078704834	144	336249	11
2274	75.69449317960598	112.1180722891571	0.09261315406402411	173	336422	12
2275	75.63492026146182	69.73720136518811	0.03149492778475323	189	336611	13
2276	75.53002560430174	65.14545454545481	0.03448567023644081	143	336754	14
2277	75.37296859150197	59.824324324324266	0.0332257350285848	144	336898	2
2278	76.0688685352166	144.9629629629635	0.09632281084966393	179	337077	5
2279	75.85696932354864	54.878947368420945	0.05311777236613822	141	337218	4
2280	75.64860216195872	55.02025316455683	0.04431556175495016	145	337363	3
2281	75.52903428980532	63.691814946619445	0.037727612462537044	145	337508	9
2282	75.39038031054363	61.6636363636364	0.031171661533721504	146	337654	8
2283	75.20776222172391	57.12857142857132	0.03575078534408355	142	337796	6
2284	75.68862417654594	123.29395770392799	0.09523520931120842	186	337982	7
2285	75.54235862443566	61.062068965517284	0.04773558402548031	147	338129	1
2286	75.48193503819131	69.50000000000028	0.04759679238001505	144	338273	13
2287	75.32285642855014	59.574074074074026	0.048847595850626625	144	338417	12
2288	75.1402402421148	57.06123778501615	0.047185529511550375	145	338562	10
2289	74.91891476277057	53.00769230769218	0.04627280168130364	142	338704	14
2290	74.6924186242614	52.26930091185396	0.0360369583656048	145	338849	2
2291	74.53420175509197	58.870731707316914	0.03714060111784599	142	338991	4
2292	75.35085973754106	156.2000000000006	0.12387268555993065	187	339178	11
2293	75.12627765773753	52.89265175718837	0.04338729804289256	141	339319	3
2294	75.6484593256046	127.34444444444497	0.10207805633544922	170	339489	5
2295	76.19563796258912	130.36632302405545	0.08689164839728031	173	339662	9
2296	76.70534355479423	127.166197183099	0.08836228666249772	171	339833	6
2297	76.55053579398677	61.2245674740485	0.06303479864790633	148	339981	13
2298	77.26557374313352	148.0543307086619	0.08445143145184185	172	340153	7
2299	77.132448471652	63.95304659498233	0.04862966408600678	148	340301	12
2300	77.05081864342404	68.96946564885523	0.045188302161709576	149	340450	2
2301	77.3473806324284	106.70701754386003	0.15105894804000855	160	340610	14
2302	77.87978006554073	130.5873239436624	0.07641185716141102	172	340782	10
2303	77.94961429951736	84.86320346320417	0.07098700923304405	186	340968	1
2304	77.82613570038184	65.60175438596521	0.041232872009277347	150	341118	11
2305	77.52634336992669	47.846902654867115	0.03305967875889369	140	341258	3
2306	77.29030974989202	53.92298136645951	0.03182413194563005	143	341401	4
2307	77.43934782886369	92.19411764705929	0.07295007175869411	180	341581	5
2308	77.24402695783577	57.90726072607246	0.04042924593572747	146	341727	9
2309	77.04231023774547	57.07235494880537	0.028342727134967674	145	341872	6
2310	77.23008574163981	95.8198606271786	0.13164212775952888	330	342202	8
2311	76.96454678898532	50.676190476190335	0.039338896874667836	147	342349	13
2312	76.75659930767264	56.169798657717976	0.02783679122656164	142	342491	2
2313	76.57781926777317	58.878595317725626	0.03578669077729526	146	342637	12
2314	76.33911799817236	52.70769230769218	0.01563324599430479	145	342782	14
2315	76.18272681819063	60.699999999999996	0.02791143303186121	142	342924	4
2316	76.76594970674854	134.5050156739818	0.12999539626272102	190	343114	7
2317	77.39623757810212	139.7947368421057	0.08647324244181315	180	343294	10
2318	77.82785414968951	120.55789473684244	0.10075192042759487	175	343469	11
2319	77.36063910025611	31.106349206349734	0.09633390942989792	181	343650	1
2320	78.08662052287363	149.95878136200767	0.11146292479141899	184	343834	3
2321	77.88382692490562	57.80726072607246	0.04423673461083652	147	343981	5
2322	77.62144922347991	51.646056782334284	0.04189571183303307	145	344126	9
2323	77.5327366323858	68.75019011406873	0.04035003120834763	148	344274	6
2324	77.32813281554999	57.07235494880537	0.0355184686594996	145	344419	8
2325	77.13150097193056	57.66494845360813	0.03542433844672309	144	344563	13
2326	76.92416007224362	56.39741100323612	0.03229806861098932	147	344710	12
2327	77.5332650419183	137.83465703971154	0.0715872593697785	173	344883	2
2328	77.45508623765296	69.71538461538489	0.02541233558912535	148	345031	4
2329	77.7678907759733	108.73554006968676	0.1537172823067171	166	345197	14
2330	77.59883255786873	60.86206896551727	0.05109558169473738	149	345346	7
2331	77.43839475493812	61.5550522648084	0.05784744262695313	150	345496	11
2332	77.22747026684819	56.345945945945836	0.047529286351697196	145	345641	1
2333	76.96484616658934	50.965060240963716	0.04777452506517109	152	345793	10
2334	76.91776292231475	72.25652173913073	0.058785863118628934	146	345939	9
2335	76.64864411662101	50.005882352941065	0.0484896816619455	146	346085	3
2336	76.48345699518269	60.12993197278909	0.061358190562627084	146	346231	6
2337	76.34085319446163	62.22307692307706	0.07675794052751098	146	346377	8
2338	76.7659042898462	118.8459627329197	0.08279512157547946	177	346554	5
2339	76.62517507150915	62.69298245614051	0.038305322329203285	144	346698	13
2340	76.41012585243963	55.12025316455683	0.05321220556894938	144	346842	12
2341	76.31886846008625	67.28438661710065	0.03925014204449124	144	346986	14
2342	76.16930046514057	61.3620689655173	0.03827888104650709	144	347130	4
2343	75.99208428168122	58.44768211920515	0.046772149892953724	143	347273	2
2344	75.85279980250077	62.063636363636434	0.030756560849471832	142	347415	7
2345	75.77946048372105	68.51886792452858	0.03098381559054057	144	347559	11
2346	75.55490703644011	53.324115755626906	0.03605040421722629	141	347700	1
2347	75.38043057333644	58.107260726072454	0.04723582002851698	144	347844	6
2348	75.14293347763441	51.63072100313466	0.04170618327796882	141	347985	8
2349	75.80395179628768	141.24476534296065	0.07003514971051897	175	348160	3
2350	75.683830427791	63.79181494661946	0.03641445769204034	144	348304	5
2351	75.91342702656019	98.64349030470954	0.07914710586721246	176	348480	10
2352	75.76791344594976	61.3620689655173	0.030361857679155137	144	348624	13
2353	75.75583162692651	74.55973154362448	0.038412091645552086	193	348817	12
2354	75.58953904492297	59.12657342657332	0.036622235472773164	142	348959	1
2355	76.25748307053215	142.38394160583996	0.0770435596697897	181	349140	2
2356	76.11324048738383	61.83322475570033	0.017303320077749398	195	349335	4
2357	75.90317738944069	55.10693069306916	0.02084220047538162	141	349476	6
2358	75.76039129028676	61.62456747404853	0.02591563595665826	144	349620	8
2359	75.57539975523406	57.26123778501615	0.020038808142388616	143	349763	5
2360	75.46021444777756	64.05686900958514	0.029085794456391468	253	350016	14
2361	75.52225108656975	81.6638783269971	0.021736453901900935	247	350263	7
2362	76.17977325655514	141.27446808510703	0.06894153553050952	182	350445	3
2363	77.90811838113245	249.01428571428704	0.4504673858809341	366	350811	9
2364	77.815458072742	68.64208754208784	0.017077763029869568	188	350999	10
2365	77.79768444439554	76.0380952380958	0.03329298259076024	191	351190	13
2366	77.93943763797441	91.97300380228256	0.049484562229465796	296	351486	11
2367	77.7941851055663	63.41418439716334	0.05394538353229391	145	351631	12
2368	77.59631586177136	58.00726072607246	0.051268916294492525	145	351776	1
2369	77.44158347238442	62.12307692307704	0.038613997349122756	147	351923	4
2370	77.2690208799814	60.1853242320819	0.0471069200618847	148	352071	6
2371	77.0636163854673	56.72857142857127	0.04572771999933948	146	352217	8
2372	77.57187012986951	127.88899082568875	0.11833813849915849	188	352405	2
2373	77.40777211822598	61.162068965517285	0.03234822782751632	146	352551	14
2374	77.28279584631908	64.91014492753649	0.0359607424054827	147	352698	3
2375	77.08192213622189	57.195424836601205	0.03875062890248756	146	352844	7
2376	77.30221842641083	99.11155115511593	0.16518830375437357	163	353007	9
2377	77.12795895401113	59.87627118644059	0.046585331224415404	146	353153	11
2378	77.66777830440036	131.10989399293322	0.07918512543966603	172	353325	10
2379	77.55466573874766	66.35652173913067	0.034413032996945266	205	353530	5
2380	77.88884635408746	110.97272727272772	0.1465847580521195	162	353692	13
2381	77.60911918086916	49.916129032257935	0.03526084176425276	145	353837	1
2382	77.39036912618421	55.73411371237446	0.035207258330451116	144	353981	4
2383	77.25249091262938	63.60254777070084	0.042067712514188275	191	354172	12
2384	77.03137870191578	55.14126984126974	0.04224640702548092	146	354318	6
2385	76.82246041328891	56.139549839228195	0.04530449242427431	145	354463	8
2386	76.69660271563083	64.23669064748229	0.0371837551529343	148	354611	2
2387	76.49792240276022	56.82857142857132	0.026930217085213495	145	354756	14
2388	76.30022889301834	56.72857142857132	0.030546933004300888	146	354902	7
2389	76.72254121082973	118.53146067415771	0.081747767366009	162	355064	3
2390	76.64064913205476	68.53333333333362	0.030546720336083653	147	355211	11
2391	76.47048588397745	59.62432432432425	0.03780419205966061	146	355357	9
2392	76.30454373700208	59.87627118644059	0.033997431193312555	146	355503	5
2393	76.10878401391777	56.72857142857127	0.034659927838469204	146	355649	10
2394	75.95570991948306	60.801374570446754	0.047644316744642194	147	355796	13
2395	75.78741855455395	59.12657342657332	0.03480642278429488	142	355938	1
2396	75.55221103567507	52.266666666666566	0.04593725804682378	143	356081	4
2397	75.83434109923137	103.76521739130465	0.10271464791267541	157	356238	12
2398	75.58188526220356	50.58875739644956	0.024078190326690674	144	356382	2
2399	75.40996341954829	58.3897009966776	0.03331176875388785	146	356528	14
2400	76.3517526742417	169.58888888888944	0.15522637963294983	192	356720	6
2401	76.511476783187	92.32416356877378	0.05177577253411578	191	356911	8
2402	76.31731626372114	57.095424836601204	0.04005163543078364	147	357058	7
2403	76.11521380815464	56.10707070707062	0.027847237422548493	145	357203	3
2404	75.99659213602291	64.25304659498234	0.022098200896690633	145	357348	9
2405	75.85451510355156	61.788888888888955	0.018526458740234376	145	357493	5
2406	75.66992420088205	57.39542483660121	0.022666901350021362	144	357637	10
2407	75.40075507935515	48.75301204819264	0.018074244260787964	144	357781	13
2408	75.22243173908792	57.56842105263147	0.028511319841657366	147	357928	1
2409	75.05554075503038	58.53333333333323	0.036064352308000834	147	358075	12
2410	75.38840659290132	108.34212454212498	0.0751709256853376	161	358236	4
2411	75.23994718450655	60.54246575342466	0.030369784556278565	147	358383	2
2412	76.005109842839	151.75621301775223	0.42789798686157765	227	358610	11
2413	75.86628951364139	62.12307692307704	0.03368884041195824	147	358757	14
2414	75.64323826899042	53.561165048543565	0.035204590617359935	143	358900	6
2415	75.37343651693114	48.66306306306293	0.04136846448991682	143	359043	8
2416	75.11690398662421	49.72018348623841	0.02464503546555837	144	359187	3
2417	75.06288879291182	69.71538461538489	0.03958134393434267	148	359335	5
2418	74.9100226168471	59.77627118644059	0.03851063073086901	147	359482	10
2419	75.75530900777902	159.43866171003774	0.09129098357346954	189	359671	7
2420	76.54733126016698	154.95753424657585	0.14414394145109216	196	359867	9
2421	76.3405559341425	55.86979865771798	0.045604455882105335	145	360012	1
2422	76.85704028305797	127.98899082568875	0.11975560723779036	187	360199	13
2423	77.34591697920351	125.74470989761144	0.11439889090401786	175	360374	12
2424	77.1985166329409	62.605882352941364	0.046454179698023304	145	360519	11
2425	77.99258089626927	156.6049429657801	0.09895784776289385	182	360701	4
2426	77.91407593672744	70.14208494208523	0.05340876546846766	147	360848	8
2427	77.65158774533599	51.66525679758297	0.07273528689429873	147	360995	6
2428	77.46234542411362	58.727355623100074	0.0425132949753563	202	361197	2
2429	78.03226829575108	134.45463258786006	0.08794006388238136	188	361385	14
2430	77.86783450168245	61.58888888888894	0.03410179760991311	147	361532	5
2431	77.72968662261545	64.05304659498233	0.033029819021419604	147	361679	10
2432	77.74479121624331	79.24014598540194	0.03345615416765213	192	361871	3
2433	77.53231741411325	56.497411003236124	0.040118478748896354	146	362017	9
2434	78.03243868441656	127.54444444444496	0.11911913326808385	168	362185	7
2435	77.83359111876445	58.14768211920515	0.044683472750938105	146	362331	1
2436	77.63193941810312	57.668421052631466	0.03295308269866525	146	362477	13
2437	77.46624071357726	61.062068965517284	0.025859411070946935	147	362624	12
2438	77.35538642452266	66.38081180811837	0.025853315989176433	147	362771	11
2439	77.1055642675945	52.37317073170717	0.025458054999782615	146	362917	4
2440	76.98096145510723	64.6452830188682	0.03270489594032024	145	363062	14
2441	76.87595995863734	66.48081180811837	0.02944767965029364	146	363208	5
2442	76.83592827424532	72.87279151943508	0.034637514245573174	189	363397	6
2443	77.65292842210786	158.53594306049888	0.16411381064301328	193	363590	8
2444	77.47264238113002	59.62432432432425	0.031779893457073057	146	363736	3
2445	78.07323799121703	137.53220338983093	0.10001409770361061	183	363919	2
2446	77.88724635204561	59.474074074074025	0.04239355942298626	145	364064	9
2447	78.35994531709659	125.15714285714321	0.09812524101950905	176	364240	10
2448	78.28872086392563	71.2375000000003	0.04096690922567289	146	364386	1
2449	77.9831354304343	47.730177514792764	0.04908736435683457	143	364529	7
2450	77.86811219421114	66.48081180811837	0.02327580158024618	146	364675	12
2451	77.67676440560236	58.73333333333323	0.04652502125707166	145	364820	11
2452	77.5281111310478	62.81143695014674	0.04365995526313782	192	365012	13
2453	77.57066034464707	81.78303249097523	0.05027066171169281	192	365204	4
2454	77.33631199665231	54.13582554517124	0.0321825667694732	143	365347	14
2455	77.1349031250518	57.195424836601205	0.02945524372466623	146	365493	8
2456	76.99020198112522	62.664788732394555	0.05013699109862451	147	365640	2
2457	77.31529276706937	109.49928057553991	0.21010196428357458	163	365803	3
2458	77.11782404992499	57.56842105263147	0.058838779423512566	147	365950	9
2459	76.90534379600292	55.86979865771798	0.04625237563560749	145	366095	10
2460	77.77364856699813	163.7358208955229	0.12672820844148336	190	366285	6
2461	78.43689900943274	144.09869281045815	0.16056973735491434	192	366477	5
2462	78.29289692581324	64.03669064748229	0.05338871002197266	150	366627	7
2463	78.97030372297847	146.03357664233633	0.10982287918006517	181	366808	1
2464	79.35618336291404	117.55826771653585	0.2225907172685788	162	366970	12
2465	79.15040748246216	58.778595317725625	0.059138343447730654	147	367117	11
2466	78.93954700625346	58.06435986159159	0.03796205520629883	145	367262	13
2467	78.74458815590924	59.44366197183092	0.029740108384026423	144	367406	4
2468	78.59206042381633	63.49181494661944	0.03168505065295161	147	367553	14
2469	78.33606289650125	52.9923076923076	0.04191516850092639	146	367699	8
2470	78.18484411150787	63.21418439716332	0.03561965786680883	147	367846	2
2471	78.08718434963808	68.41886792452858	0.030798112935033338	145	367991	3
2472	77.87926675450771	57.29542483660121	0.03717238656405745	145	368136	9
2473	77.61019050487309	50.97164179104469	0.03194825290000602	146	368282	6
2474	78.0803439189733	124.625531914894	0.10792780833639157	157	368439	1
2475	78.42530518566592	112.57647058823565	0.08619636297225952	160	368599	7
2476	78.9064205548619	126.53684210526353	0.08448282526342908	181	368780	10
2477	78.95038481906418	83.30284697508954	0.047256012155552106	198	368978	5
2478	78.83072483704454	66.98438661710065	0.03639616285051618	147	369125	4
2479	79.23972793350168	119.73103448275916	0.0940887493323226	181	369306	12
2480	79.13733065416666	69.00000000000026	0.04985669384831968	184	369490	11
2481	79.59952877619642	125.35714285714326	0.0816873462720849	174	369664	13
2482	80.04678348843446	124.32500000000041	0.11089105959291812	162	369826	14
2483	79.81218006032977	56.58644067796595	0.044326930210508146	145	369971	8
2484	79.63160878237456	61.755052264808405	0.0355587134490142	148	370119	3
2485	79.40524694291683	56.99542483660121	0.051721460110432396	148	370267	9
2486	80.04591608520927	143.47216117216163	0.07301737503571944	176	370443	2
2487	79.84831016667799	60.285324232081905	0.036829958156663546	147	370590	1
2488	79.59335165517516	54.35245901639335	0.03903312815560235	144	370734	10
2489	80.12679448270943	132.9376344086026	0.07742087772914341	175	370909	7
2490	80.5168082280232	119.12816901408496	0.11608820773185567	188	371097	6
2491	80.32065389144744	60.90137457044677	0.03911047439052634	146	371243	4
2492	79.75585475994036	23.840740740741268	0.0819800168099488	169	371412	5
2493	79.549551245898	59.12550335570457	0.038600529709907426	146	371558	11
2494	79.30106204258728	54.7006309148264	0.03405113742776113	146	371704	12
2495	79.16691222802221	65.88608058608088	0.03717644247290206	146	371850	14
2496	79.51043264822565	113.5189542483665	0.07417618600945723	171	372021	13
2497	79.30049498841005	58.51666666666653	0.037700422993906725	143	372164	8
2498	79.05427951221016	54.67894736842094	0.03223331157977764	143	372307	3
2499	79.81664434761015	155.2907630522095	0.06591515734016551	173	372480	9
2500	80.26139682305296	124.29189189189222	0.08718881334577287	175	372655	2
2501	80.03073710318844	57.195424836601205	0.04119240747739191	146	372801	10
2502	79.36279959517026	13.236986301370322	0.0698471520779401	169	372970	1
2503	79.23598641403336	66.68148148148177	0.035597768770594174	147	373117	7
2504	79.14833972818761	70.47131782945766	0.03412417003086635	147	373264	6
2505	79.00122323738056	64.4366906474823	0.029502248110836498	146	373410	11
2506	78.69739491305272	48.618390804597595	0.045053258435479526	145	373555	4
2507	78.54456280789383	63.41418439716334	0.03770254398214406	145	373700	12
2508	78.44330585906017	68.41886792452857	0.04266587619123788	145	373845	8
2509	78.19823105592128	53.93582554517124	0.06306078680630388	145	373990	13
2510	78.7958745957022	137.96258503401398	0.08975073565607486	184	374174	5
2511	78.61792959544964	61.00137457044677	0.04276489718206997	145	374319	3
2512	79.20004607414303	136.82957746478922	0.08758332994249132	180	374499	14
2513	79.58480179714718	117.67561837455862	0.06961250883160215	165	374664	9
2514	79.39225309890361	60.329931972789105	0.03432366583082411	144	374808	1
2515	79.72165314855974	112.33225806451652	0.09521378092018955	166	374974	10
2516	79.6397581604825	71.53215434083631	0.04420156064240829	184	375158	2
2517	79.60774153125864	76.43809523809568	0.040867912578072776	187	375345	7
2518	79.59140605142993	77.97419354838759	0.052393709274536786	187	375532	6
2519	79.76923404038558	97.37420494699676	0.06193074813255897	156	375688	12
2520	79.64035251079254	66.88108108108136	0.054848738595949	141	375829	13
2521	79.57710130356541	73.31523178807991	0.037524781696536995	193	376022	11
2522	79.35261600481546	57.12857142857131	0.03909443801557514	142	376164	8
2523	79.18400627128027	62.49164265129694	0.046521376509692784	181	376345	4
2524	79.03753311504228	64.53669064748229	0.04105093068089979	145	376490	3
2525	79.53195180382541	128.4794019933559	0.07090617309917104	176	376666	5
2526	79.40547615195815	66.88438661710066	0.03185136898143871	148	376814	1
2527	79.33345407017714	72.20326797385658	0.03757104277610779	192	377006	14
2528	79.90938923901894	136.92697095435733	0.08850366996996331	165	377171	7
2529	80.7760314061083	166.57360594795597	0.11254504323005676	192	377363	2
2530	80.48364845053779	51.53773584905651	0.05060960186852349	144	377507	13
2531	80.27505520927565	59.62432432432425	0.05042219488588098	146	377653	11
2532	80.90802296704204	143.57183098591602	0.0912445151740736	183	377836	6
2533	81.54984971411581	145.0906976744191	0.07907949794422496	176	378012	4
2534	81.87169904306161	113.73478260869598	0.11527985262583537	166	378178	3
2535	82.40982876795947	135.6846715328472	0.07048916952950614	175	378353	8
2536	82.11306285850337	52.73323782234943	0.03075658514144573	188	378541	12
2537	81.92964651563261	63.77142857142881	0.044198921748570034	147	378688	5
2538	81.867423221208	75.7073170731713	0.06586439015410094	309	378997	10
2539	81.7689111511581	72.01621621621653	0.034643640068813146	191	379188	1
2540	81.59644586636131	64.52238267148041	0.04601782077067607	148	379336	7
2541	81.373918027416	59.34366197183092	0.023096295060782597	145	379481	13
2542	81.14451218047518	58.43333333333323	0.03330479441462336	148	379629	6
2543	80.93074790973425	59.768085106382905	0.021758432257665345	146	379775	4
2544	80.8469344545413	72.54940239043856	0.03476383845011393	150	379925	3
2545	80.55919681731295	52.07317073170717	0.03910976128290163	149	380074	8
2546	80.35729316082814	60.36883116883103	0.017592799836310787	207	380281	2
2547	80.95781143443158	140.4091205211733	0.0845092753465263	191	380472	11
2548	81.13877569296862	99.05423728813591	0.10095469551797238	161	380633	5
2549	83.46875157240255	314.13636363636266	0.21373194335443288	494	381127	9
2550	83.23975222872154	60.56881720430106	0.08071819070267351	146	381273	10
2551	83.08673308481272	67.93783783783812	0.024927620935921716	198	381471	12
2552	82.81356374054178	55.76979865771798	0.059361719105341666	146	381617	1
2553	82.59344184884083	60.801374570446754	0.03966506322224935	147	381764	7
2554	84.04666666602121	227.91592356688005	0.16424888900563686	395	382159	14
2555	84.44883940456546	124.26394052044654	0.07430503213193995	169	382328	6
2556	84.162479215648	55.81282051282038	0.027419364615662457	146	382474	3
2557	83.89157797297958	57.07235494880536	0.031005731122247103	145	382619	8
2558	84.69116402475161	163.85018315018363	0.09136582414309184	192	382811	13
2559	85.12558571783744	128.13333333333392	0.07683363827792081	176	382987	4
2560	84.86676648037738	59.2436619718309	0.01847832496852091	146	383133	2
2561	85.29405245795772	127.59536423841115	0.06030164294772678	180	383313	11
2562	85.05600082226702	61.48888888888894	0.03990851221857844	148	383461	12
2563	85.52192229552584	131.6481481481486	0.1265550939048209	164	383625	1
2564	86.24201886204428	157.53157894736884	0.2495577049255371	200	383825	5
2565	86.83438655221171	145.47878787878824	0.08063492747400537	173	383998	10
2566	87.31465493158755	134.86122448979629	0.091690000249536	181	384179	9
2567	86.95416904293234	51.26606606606593	0.043393718953035315	147	384326	7
2568	86.68748059482382	60.285324232081905	0.058208257973599596	147	384473	14
2569	86.37201848728827	55.14126984126974	0.046310114533933876	146	384619	6
2570	86.14144014638701	63.314184397163324	0.05872827033474021	146	384765	3
2571	85.91516758889478	63.51418439716334	0.03765488995446099	144	384909	13
2572	85.57948650124112	52.3470588235293	0.04172747072420622	152	385061	2
2573	86.19582697457457	147.21353383458708	0.06827808085067497	181	385242	8
2574	87.08739399665762	175.35252918287978	0.16591120015888314	191	385433	4
2575	86.76230953037526	54.57894736842094	0.03683782617251078	144	385577	12
2576	86.50253967739232	60.785324232081926	0.050882896906893016	142	385719	1
2577	86.15816488302802	52.06506024096371	0.058137812512986206	141	385860	5
2578	85.81704380202109	52.04605678233428	0.06967857036184757	141	386001	10
2579	86.63430598811436	167.54326241134834	0.3178530538023399	203	386204	11
2580	86.40227585340328	63.43129251700702	0.03944475472378893	147	386351	9
2581	86.05363045335982	51.53773584905651	0.053125613265567355	144	386495	7
2582	85.74576856743087	55.26744186046498	0.05541730589336819	144	386639	14
2583	85.50218044697395	61.38695652173917	0.05058152708288741	146	386785	6
2584	85.1750851600761	52.79265175718837	0.040482547921194156	142	386927	3
2585	84.81186442895726	48.85301204819264	0.05333557662430343	143	387070	13
2586	84.58797655389847	62.423076923077076	0.04935075177086724	144	387214	2
2587	84.38732061507429	64.52238267148041	0.04025151278521564	148	387362	8
2588	84.13515472599671	59.17073170731694	0.03423508294194722	139	387501	12
2589	83.84084226668463	54.70390879478814	0.03894580462399651	136	387637	1
2590	84.02386627645022	102.14324324324353	0.09683319926261902	160	387797	4
2591	83.81701277269632	63.33851590106024	0.05041708646120725	143	387940	5
2592	83.58233706876116	60.34944237918214	0.016721363547894594	139	388079	10
2593	83.39951369807356	65.30000000000024	0.028612205426986902	146	388225	9
2594	83.23689132094947	67.13727598566335	0.05648068377846166	152	388377	7
2595	83.7217903815962	131.7267973856215	0.10593217385781778	185	388562	11
2596	83.41868702886381	53.411455108359014	0.05097248129648705	146	388708	14
2597	83.2105589821046	62.605882352941364	0.03278356091729526	145	388853	3
2598	83.00438321684497	62.5929824561405	0.043658000025255925	145	388998	13
2599	83.48822911851683	131.38897338403095	0.08259981586819604	168	389166	6
2600	83.21247503245986	55.91282051282038	0.03284858506301354	145	389311	2
2601	82.98164960186315	60.12993197278909	0.05271309369230923	146	389457	4
2602	82.73168120711034	57.98481012658214	0.07518237626471487	147	389604	12
2603	82.46575989343152	56.139549839228195	0.03727790898290174	145	389749	1
2604	83.41621426360918	177.51119691119763	0.11931953034870366	193	389942	8
2605	83.74561787020856	116.35657492354801	0.08901290472041178	181	390123	5
2606	83.60144244860427	69.3280757097795	0.04035623237569496	189	390312	10
2607	83.25679166048187	49.13636363636353	0.030775533782111272	144	390456	7
2608	83.08504727328882	66.08235294117677	0.037225152359527794	147	390603	11
2609	82.8612105462604	60.70137457044675	0.03487529625763764	148	390751	13
2610	82.75763112053635	72.50326797385661	0.03249632618414662	189	390940	9
2611	82.58105480933098	65.10000000000024	0.036611737431706606	148	391088	6
2612	82.32252997552338	56.72857142857132	0.035853150772721804	146	391234	2
2613	82.33533314551904	83.60284697508953	0.0410426995693109	195	391429	14
2614	82.23548152054849	72.35017064846458	0.04211806282779287	197	391626	3
2615	82.05560038955353	64.24736842105288	0.028976835616647382	146	391772	12
2616	82.43435803879454	119.93136531365364	0.11253311850807883	165	391937	4
2617	82.28380183382188	67.37873754152845	0.023669649053502967	189	392126	1
2618	82.12078734489543	65.98235294117677	0.04616054973086795	148	392274	10
2619	81.95349917947567	65.39197080291996	0.05189867921777674	148	392422	5
2620	82.29653890032459	116.25747126436819	0.12313053314698572	187	392609	8
2621	81.986234171982	51.26606606606593	0.034773015651573126	147	392756	11
2622	81.61296642485678	44.659459459459335	0.038691896970580224	147	392903	7
2623	81.96159433636579	116.4757575757579	0.08696436285972595	160	393063	13
2624	81.76762628032608	62.564788732394554	0.036149411588101775	148	393211	9
2625	81.46861668418948	51.86666666666655	0.02829938032189194	147	393358	14
2626	81.28470829512537	63.07777777777797	0.027036781180394837	146	393504	3
2627	81.04014692645983	56.82857142857132	0.0444165328453327	145	393649	12
2628	81.00913761405798	77.9392156862751	0.021638994216918946	200	393849	6
2629	80.99344769777142	79.44014598540193	0.03441275044491417	190	394039	2
2630	80.6924778225636	50.89646017699093	0.02046556183786103	198	394237	4
2631	81.21432897794793	132.87759336099631	0.09003005376676233	164	394401	10
2632	80.94500958753952	54.28238993710683	0.042324098380836284	148	394549	7
2633	81.10028042189668	96.47209302325606	0.09273826508294969	168	394717	8
2634	80.87117462764449	58.1897009966776	0.03843647080498773	148	394865	13
2635	81.0930021305148	103.05392491467622	0.07289036943868625	163	395028	11
2636	81.10190243411941	81.9830324909752	0.04505195115741931	190	395218	5
2637	81.06607765438254	77.51942446043238	0.028391142428179323	231	395449	1
2638	80.9909510143849	73.5534136546188	0.03202525288069329	147	395596	3
2639	81.57766895522144	139.66274509803964	0.09859139738027116	171	395767	12
2640	81.39681041513542	63.49181494661943	0.034224270152396895	147	395914	2
2641	81.39005264308739	80.72103321033285	0.0682111824883355	225	396139	9
2642	82.1343640125673	155.82118959107862	0.08962716447546128	188	396327	14
2643	81.9886870391083	67.56666666666706	0.03743799109207956	190	396517	6
2644	81.72047458732186	55.16744186046498	0.0420019347092201	145	396662	4
2645	81.47288221929881	56.96123778501615	0.033672064951021374	146	396808	10
2646	81.23622600436654	57.80726072607246	0.03989769163585845	147	396955	13
2647	80.9415163122987	51.76525679758297	0.04899173893340646	146	397101	7
2648	80.70541262458555	57.331147540983515	0.04899106706891741	147	397248	5
2649	80.50537224404415	60.70137457044675	0.03351629746926797	148	397396	1
2650	80.73766772795291	103.7349206349211	0.07603766804649717	168	397564	8
2651	80.45953220822965	52.924115755626914	0.041183307253081225	145	397709	3
2652	80.37996956588592	72.5032679738566	0.044949274214487224	189	397898	11
2653	80.16791061096781	59.17407407407399	0.04317928649283744	148	398046	9
2654	80.60915042377705	124.29189189189222	0.08422805786132813	175	398221	12
2655	81.18502993403204	138.1971014492757	0.0788840321132115	175	398396	2
2656	80.95265645588377	57.94768211920515	0.03708633538838979	148	398544	14
2657	80.89208907499841	74.89591836734725	0.038653856999165306	148	398692	4
2658	80.63253242265901	54.93642384105946	0.035248927412361936	145	398837	10
2659	80.98777096136078	116.1563862928354	0.05356574193232477	177	399014	6
2660	80.76322658508052	58.53333333333323	0.023950216721515268	147	399161	8
2661	80.61051402725892	65.49197080291995	0.044469645234192307	147	399308	3
2662	80.53898031555775	73.45714285714335	0.025640420963109468	193	399501	5
2663	80.30246893185506	56.88784194528855	0.03047693403143632	190	399691	13
2664	80.15768656335563	65.82423208191159	0.06728005163448374	194	399885	7
2665	80.76613736570626	141.00276679841934	0.10298209470861099	170	400055	11
2666	80.53761392308367	57.91379310344817	0.03187883893648783	144	400199	4
2667	80.27706168322389	54.482389937106824	0.04126699983257137	146	400345	14
2668	80.23469035967788	76.03992932862256	0.05484666740685178	228	400573	1
2669	80.92617557286943	149.3832116788327	0.10375123438627823	184	400757	12
2670	81.32999686212342	121.30830449827025	0.09264450073242188	170	400927	2
2671	81.18012727324903	66.34303797468377	0.03472178860714561	190	401117	9
2672	81.00424414998272	63.591814946619444	0.04812340540428684	146	401263	6
2673	80.82811985794909	63.39181494661944	0.025835789538718557	148	401411	8
2674	81.20822211801622	118.83834586466214	0.08804318963027583	164	401575	3
2675	80.89053931374568	49.439941690961966	0.031539080894156676	146	401721	5
2676	80.6053656279253	52.37317073170717	0.03126610141910919	146	401867	13
2677	80.50364530497937	70.43333333333395	0.03947909673055013	228	402095	10
2678	80.94739723367232	124.87883817427428	0.05864463829846116	161	402256	11
2679	80.97556428697663	83.76410256410307	0.04601970713406323	187	402443	7
2680	80.76205188735011	59.62432432432426	0.039297665635200395	146	402589	1
2681	81.21200279704804	125.75714285714326	0.08463810752419865	170	402759	4
2682	81.08044798646887	68.05652173913072	0.024220121667740194	188	402947	14
2683	81.59457899047516	132.4935483870972	0.08479610695896378	166	403113	6
2684	81.6113604732977	83.27272727272776	0.04745775051217861	189	403302	12
2685	81.51229898582856	71.70521172638475	0.04051436345601819	194	403496	2
2686	81.36126180455115	66.40858085808615	0.04153759615408942	193	403689	9
2687	81.19410201669432	64.6452830188682	0.0552099819841056	145	403834	13
2688	80.91458035136608	53.241935483870854	0.05010260807143317	144	403978	10
2689	81.68865226002956	158.32177121771272	0.11653529896455653	187	404165	8
2690	81.49469556199067	62.29298245614048	0.055081393267657305	148	404313	11
2691	82.18657236116005	150.68237547892755	0.07444189371687643	178	404491	3
2692	82.04803997088179	68.33333333333361	0.04440378662723823	149	404640	1
2693	81.85494473018358	62.738515901060204	0.04217941488995648	149	404789	7
2694	81.76148769212267	72.50924092409281	0.03742586964308613	198	404987	5
2695	81.53911605844469	59.52432432432425	0.04777450950778261	147	405134	4
2696	81.32557814018105	60.1853242320819	0.06491954906566723	148	405282	14
2697	81.18829239623243	67.59700374531863	0.04028473419397056	147	405429	12
2698	81.49254074640137	111.61312741312786	0.08502732416626754	157	405586	2
2699	82.01910668841833	134.14913494809727	0.06000934706793891	180	405766	6
2700	81.90033647095501	70.14208494208523	0.038663296472458614	147	405913	10
2701	82.15272747244265	107.13943661971867	0.056981241703033446	160	406073	13
2702	81.87920650686648	54.8006309148264	0.027418521354938375	145	406218	8
2703	81.6443114517646	58.389700996677604	0.028846286747553577	146	406364	3
2704	81.77397944835805	94.61111111111143	0.0649898168517322	164	406528	11
2705	81.59960656034929	64.33669064748229	0.027629242462365807	147	406675	7
2706	82.02465397300666	124.10434782608729	0.07584400623165376	171	406846	1
2707	81.74923133264767	54.482389937106824	0.030063002076867507	146	406992	4
2708	81.52698226256443	59.52432432432425	0.021598966754212672	147	407139	14
2709	81.35693626665358	64.52238267148041	0.022236645221710205	148	407287	12
2710	81.95181455741664	140.84476534296067	0.07619174232696022	179	407466	5
2711	81.74454208658295	61.2245674740485	0.020603875856141787	148	407614	6
2712	81.6039921881052	67.68955223880627	0.05245126377452503	143	407757	10
2713	81.35065025280132	56.26979865771798	0.048431998449014434	141	407898	13
2714	81.80995519808475	127.2811447811452	0.04914007515742861	174	408072	2
2715	81.56680989446991	57.49542483660121	0.046248125863241986	143	408215	8
2716	81.27369875755053	52.25569620253151	0.04427427602997908	141	408356	11
2717	80.96492932159745	50.396755162241746	0.025087590018908184	144	408500	3
2718	80.69450984204607	53.9229813664595	0.04057995922915585	143	408643	7
2719	82.26373083359103	237.61660899654112	0.25066059629630555	391	409034	9
2720	82.08262399120494	64.15304659498234	0.02813211205887468	146	409180	4
2721	81.95549240778143	69.36946564885524	0.03850683014968346	145	409325	14
2722	81.68321199350754	54.72745098039206	0.026840489843617314	138	409463	6
2723	81.54386309504898	67.74832214765127	0.022660370954533212	194	409657	1
2724	81.7838395584381	105.54150943396272	0.07997212690465591	170	409827	5
2725	81.74422338507594	77.82222222222276	0.03753360688995203	193	410020	12
2726	81.71005119341928	78.3270042194096	0.037828683853149414	144	410164	10
2727	81.47542750267712	58.24768211920515	0.03911297239106277	145	410309	2
2728	81.29734237263176	63.666914498141495	0.028001388469776074	143	410452	3
2729	81.88340265677061	139.90337078651726	0.07122988507926808	173	410625	8
2730	81.65127281026722	58.670418006430715	0.022403745547584866	184	410809	13
2731	81.45968990672594	62.492982456140496	0.03783217194962175	146	410955	9
2732	81.18991690702975	54.482389937106824	0.06233347278751739	146	411101	4
2733	81.10351069570594	72.54929577464841	0.03480942287142315	189	411290	11
2734	80.87737259871565	58.4897009966776	0.03365180245761214	145	411435	14
2735	80.67314488499844	60.454601226993816	0.02908087521791458	192	411627	7
2736	80.54438347360164	67.79700374531863	0.0378422605580297	145	411772	5
2737	80.3489533845701	61.00137457044677	0.03537950844600283	145	411917	12
2738	80.11243796075675	56.69741100323612	0.03812552822960748	144	412061	10
2739	80.62620285450558	131.4889273356405	0.07634532174398732	172	412233	6
2740	80.60316384754326	78.32230215827387	0.034401559574718785	187	412420	1
2741	80.35783019564501	56.06979865771798	0.03507047933298391	143	412563	8
2742	80.95934309890029	140.5091205211733	0.0890072270443565	190	412753	2
2743	80.70242408651595	55.267441860464984	0.026819217536184523	144	412897	11
2744	81.22523134748229	132.98315018315066	0.08031247791491057	171	413068	3
2745	80.91879802510539	50.58189910979217	0.03670156818546661	146	413214	4
2746	80.96153312177742	85.19230769230836	0.12385436466761998	224	413438	13
2747	81.51903543761848	136.7117647058828	0.06993658434260976	176	413614	7
2748	81.42057299843665	71.67279151943512	0.022325691299058904	201	413815	14
2749	82.17610585766391	156.97385892116242	0.059860700784727584	172	413987	5
2750	82.4753636670118	112.10188679245316	0.1565013435316382	161	414148	6
2751	82.94921277006772	129.8602739726032	0.0485018526198547	173	414321	12
2752	83.56836215180101	144.86415094339665	0.05884889371133264	173	414494	10
2753	83.44574213452329	71.30636042402901	0.03171133796374003	240	414734	9
2754	83.82074939719293	120.94646840148742	0.13715107079708214	165	414899	1
2755	83.58484122294888	60.2299319727891	0.05810239726099475	145	415044	11
2756	83.26564537869521	51.66525679758297	0.06588477180117652	147	415191	2
2757	83.11136168476489	67.83727598566335	0.13508450738314925	145	415336	4
2758	82.90889595524119	62.86478873239457	0.039302654924063846	145	415481	3
2759	82.7878169624662	70.80099667774128	0.048468315854985664	188	415669	8
2760	82.59360793782294	63.36691449814149	0.04098440849617736	146	415815	14
2761	82.30190167210931	53.4229813664595	0.04983008230054701	148	415963	7
2762	82.20144787277953	72.25652173913072	0.04483453541585844	146	416109	12
2763	82.1561753295356	77.67419354838758	0.04946403503417969	190	416299	13
2764	81.89374178136845	55.91282051282038	0.043086969441381	145	416444	6
2765	82.49864377961316	142.38394160583996	0.07174650476782361	181	416625	5
2766	82.37106830072115	69.74109589041132	0.056412955125172935	192	416817	10
2767	82.23372963136582	68.63720136518808	0.02675529718399048	200	417017	9
2768	82.12442681781079	71.30344827586264	0.05119194083499469	217	417234	1
2769	82.89737609801978	159.41935483871018	0.060111008542876	179	417413	4
2770	83.4296209750324	136.12186379928363	0.05608489393521954	179	417592	11
2771	83.96175783614824	136.64330708661458	0.07860584486098517	168	417760	3
2772	84.25210428656374	112.99640287769819	0.06489012881023128	164	417924	8
2773	84.14003778915264	73.04545454545521	0.06204706708961558	214	418138	2
2774	83.81933042037966	52.069300911853965	0.04647430757276055	147	418285	14
2775	83.6224704495092	64.1333333333337	0.030198803746887527	191	418476	13
2776	83.41389363233804	62.76478873239456	0.04173268683969158	146	418622	5
2777	83.08584284191132	50.60881458966545	0.023208588361740112	192	418814	7
2778	82.86080098153953	60.58165680473365	0.044523184498151146	192	419006	6
2779	82.62144800528118	58.925503355704556	0.03592023656174943	148	419154	9
2780	82.55514901818613	75.99154929577534	0.0660583750406901	225	419379	12
2781	82.48968843709517	76.00909090909119	0.03727121610899229	148	419527	4
2782	82.23896963491599	57.41780821917797	0.04358166456222534	144	419671	11
2783	82.06657993856683	65.00000000000024	0.03394841187752333	149	419820	3
2784	81.88562381660053	63.97096774193569	0.02889767319265038	198	420018	10
2785	81.66793959009632	60.11720116618066	0.034550037899532836	185	420203	8
2786	81.4109660765483	55.97058823529394	0.03210664730446011	204	420407	1
2787	81.25790831889701	66.10519031141908	0.038539083133190134	203	420610	2
2788	81.21849781808353	77.31685823754856	0.06952663370080896	222	420832	14
2789	81.66688426847413	126.05714285714336	0.06292381400833587	167	420999	7
2790	82.44568910999992	159.54736842105305	0.14516329394720998	193	421192	6
2791	82.44072497252311	81.94927536231933	0.04375996048917476	194	421386	12
2792	83.08882730134195	147.25095785440647	0.059833367665608726	174	421560	3
2793	82.93044073481319	67.25017064846477	0.03077009993214761	248	421808	13
2794	83.27696391367196	117.58275862069013	0.0692988293511527	168	421976	10
2795	83.1651402204812	72.094594594595	0.04381423337118966	224	422200	4
2796	83.15266528886464	81.91764705882436	0.049362391960330126	246	422446	9
2797	83.08353792926222	76.23992932862257	0.046827252987211784	226	422672	11
2798	83.53892643056662	128.622388059702	0.07396445387885683	168	422840	1
2799	83.35878256503396	65.52453987730084	0.03716420404838793	264	423104	5
2800	83.27169473938363	74.65000000000052	0.033960485458374025	190	423294	8
2801	83.10579260680461	66.68148148148175	0.0495406656849141	147	423441	7
2802	83.06574566974757	79.10109890109946	0.04434143105134141	197	423638	2
2803	83.69125322955175	145.6165016501656	0.11419965319065233	193	423831	14
2804	83.50479524271078	65.04545454545482	0.04009256760279337	144	423975	13
2805	83.32366699831287	65.39197080291996	0.03941550770321408	148	424123	4
2806	83.06138457669576	57.09542483660121	0.048534724177146445	147	424270	10
2807	83.09759426034057	86.68235294117702	0.04222664159005849	191	424461	3
2808	82.8860416754014	61.94233576642343	0.026340899402148104	146	424607	9
2809	82.71424508843462	65.70638297872365	0.03424816675136744	193	424800	12
2810	82.41188551216801	52.478287461773576	0.03034671472043407	147	424947	11
2811	82.18552936891074	59.77627118644059	0.029956856552435428	147	425094	5
2812	82.17078477632865	80.71107011070208	0.15552279057393548	262	425356	6
2813	81.84813575209476	49.90588235294107	0.048806664084090665	147	425503	8
2814	81.57785692621938	54.82025316455683	0.052439559884622795	147	425650	7
2815	81.51502430290314	75.29459459459505	0.03464239835739136	192	425842	1
2816	81.29461480061485	59.474074074074025	0.04821737552511281	145	425987	2
2817	81.10389942183947	62.223076923077045	0.02792261398001893	146	426133	13
2818	80.85731988708054	56.44594594594584	0.036811272303263344	144	426277	10
2819	81.35122816969121	130.2481481481486	0.05542918001667837	178	426455	4
2820	82.01909324648487	148.13773584905707	0.062224307756745416	178	426633	3
2821	82.01090231402003	81.20000000000047	0.033617231297620474	187	426820	9
2822	81.88888570012075	69.80924092409298	0.04792414347330729	225	427045	14
2823	82.33030453542723	126.03076923076969	0.06981906574734008	181	427226	12
2824	83.22382793635394	171.68264462809964	0.0742298866230282	183	427409	5
2825	82.99727782903342	60.56881720430106	0.03728152301213513	146	427555	8
2826	83.06938052244121	90.20754716981203	0.09566427838854394	229	427784	11
2827	83.3783011372795	113.96144200627009	0.07991740378466519	176	427960	1
2828	83.3505181259067	80.60000000000058	0.1086942346602524	193	428153	6
2829	83.34396209719002	82.69491525423777	0.10714350301752645	189	428342	2
2830	83.29944045729067	78.89179810725604	0.11575886543760909	188	428530	7
2831	83.03473176700348	56.82857142857128	0.0916048839174468	145	428675	13
2832	82.55332907474062	34.8944625407172	0.15477103977412968	182	428857	10
2833	82.23276333561563	50.49675516224175	0.029957087723525254	143	429000	3
2834	81.31468496041971	-9.575074183976	0.1260011835796077	164	429164	4
2835	81.06166631594373	56.01282051282038	0.028613845507303875	144	429308	12
2836	80.49447721462175	24.342756183745934	0.09465912089628332	170	429478	9
2837	80.29238568479636	60.285324232081905	0.03035435709012609	147	429625	5
2838	80.77308894659247	128.36271186440715	0.06394170750083261	173	429798	14
2839	80.55249598816101	58.71379310344816	0.03581104559056899	136	429934	1
2840	80.57283895280771	82.5867924528307	0.020949641863505047	192	430126	8
2841	80.84598647568839	107.88759124087629	0.12280473649872016	161	430287	11
2842	80.86704012444503	82.9513513513518	0.1137785781276682	183	430470	2
2843	80.81776594961568	75.93962264150994	0.10457020118588307	183	430653	7
2844	80.6071969857717	59.760869565217256	0.030369382837544315	184	430837	6
2845	80.61957797758646	81.84529616724791	0.173359316681068	191	431028	13
2846	80.41313544456385	59.97532467532459	0.0929339683219178	146	431174	3
2847	80.31215793627206	70.31538461538487	0.08168717505226672	142	431316	12
2848	80.08503949170557	57.60031347962368	0.07262913386027019	144	431460	4
2849	80.80289280049222	151.87037037037092	0.13814512543056323	184	431644	10
2850	80.59516319221518	60.029931972789086	0.03395253136044457	147	431791	9
2851	80.34602387700856	55.68123167155411	0.055168609096579356	146	431937	14
2852	80.87072153297532	132.8157894736846	0.11606137648872707	184	432121	5
2853	80.61221684929114	55.02025316455683	0.04110680284171269	145	432266	11
2854	80.30991367189615	50.38189910979217	0.05597047548036318	148	432414	8
2855	80.33970532016014	83.28907849829407	0.052844725157085215	190	432604	1
2856	80.17489035651077	63.85820895522416	0.05508764253722297	144	432748	7
2857	79.98315519865012	61.00137457044677	0.04817106312718885	145	432893	12
2858	79.98988722054679	80.65635738831668	0.03796861285255069	189	433082	2
2859	79.83535525481614	64.53669064748229	0.05295495986938477	145	433227	3
2860	79.71338631765259	67.6384615384618	0.036316506406094164	188	433415	13
2861	79.76624458046032	84.99921259842587	0.05829460665864764	212	433627	6
2862	79.5452316191918	57.66494845360814	0.039457235071394176	144	433771	9
2863	79.38369745246608	63.39181494661944	0.038352476583944785	148	433919	14
2864	79.94895636835238	135.90958904109638	0.09440817227021106	181	434100	4
2865	79.88750128742748	73.80344827586259	0.023531580964724224	192	434292	10
2866	79.66058052291922	57.195424836601205	0.044955560605819914	146	434438	11
2867	79.4719884633945	60.801374570446754	0.058791128145594174	147	434585	5
2868	79.29051425350103	61.324567474048514	0.03601146230892259	147	434732	1
2869	80.03222083257775	153.46117216117264	0.0899955072710591	186	434918	8
2870	79.78653556692713	55.463694267515805	0.02766562165885136	145	435063	2
2871	79.59367021125786	60.49999999999998	0.04708531830045912	144	435207	13
2872	79.3007010607677	50.296755162241745	0.02184524864986025	145	435352	6
2873	79.18158957254808	67.38955223880627	0.03476788246468322	146	435498	9
2874	79.11982630840156	73.00526315789513	0.03687367690236945	190	435688	12
2875	79.09125944463496	76.26313993174116	0.03244007130463918	192	435880	3
2876	79.85178634063448	155.14394904458672	0.3335366847711208	231	436111	7
2877	79.7023699265035	64.91014492753649	0.043618442249946855	147	436258	11
2878	79.76303536581524	85.76891385767843	0.03234905694660387	190	436448	14
2879	79.47978237064765	51.437735849056516	0.0550954950266871	145	436593	5
2880	79.42958186237743	74.45973154362467	0.026169833448744313	194	436787	4
2881	79.9634439384905	132.8157894736846	0.06883362583492113	184	436971	10
2882	79.80728318331613	64.34736842105289	0.0697589348102438	145	437116	8
2883	80.36826298306191	135.90526315789512	0.08381564130065261	186	437302	1
2884	80.18321671686766	61.86363636363642	0.04991973108715481	144	437446	2
2885	80.02009883541326	63.87142857142881	0.05453373634651916	146	437592	13
2886	79.86750895817025	64.76111111111138	0.046611849466959634	150	437742	6
2887	79.69548175591248	62.664788732394555	0.04645950291432491	147	437889	9
2888	79.63555782638424	73.70308880308912	0.04656139373779297	150	438039	12
2889	79.44721599382487	60.801374570446754	0.03169851238224782	147	438186	3
2890	79.23438743250253	58.16435986159159	0.03965667221281263	144	438330	7
2891	79.00211786158307	56.00743034055715	0.03367132224783992	151	438481	11
2892	78.81752134050149	60.54246575342466	0.03380931802347404	147	438628	5
2893	78.66301527207789	63.36691449814149	0.04432095566841021	146	438774	10
2894	79.16017913929068	128.3794019933559	0.08118707042629436	177	438951	14
2895	79.0149106812311	64.63333333333357	0.021701100052043957	186	439137	4
2896	78.97581751847474	75.10559440559491	0.033832862973213196	192	439329	8
2897	78.78748400082425	60.142465753424624	0.027112581871992704	151	439480	13
2898	79.30775356514815	130.81444043321335	0.0936996393036424	171	439651	2
2899	79.28619327087598	77.15172413793157	0.034376944902647345	193	439844	1
2900	79.98599800483389	149.26666666666713	0.06072753840099181	173	440017	12
2901	79.80202691367444	61.58888888888895	0.0456074046439865	147	440164	7
2902	79.75437506559034	75.03684210526369	0.04036173528554488	196	440360	6
2903	79.58222814033125	62.539682539682666	0.03676205783633132	199	440559	9
2904	80.37746763498971	159.10617760617825	0.07395407946213432	184	440743	3
2905	80.0643741180601	49.068115942028854	0.037914472083522846	146	440889	5
2906	79.88554118769031	62.18108108108115	0.024517117662632718	188	441077	11
2907	79.76416899728993	67.74832214765142	0.0376413409242925	194	441271	14
2908	79.67461821640794	70.80909090909144	0.0376105523109436	200	441471	10
2909	79.7313430767149	85.3471042471048	0.02969745118567284	188	441659	13
2910	79.57161173549999	63.75820895522414	0.046952280504950164	145	441804	7
2911	79.4920444854589	71.61488673139193	0.036740398911572006	189	441993	8
2912	79.5489001600073	85.17761194029909	0.022876955568790436	192	442185	2
2913	79.32069687269295	56.72857142857128	0.043469063223224795	146	442331	6
2914	79.69206952180042	116.45796178343993	0.07959984069646792	172	442503	1
2915	79.48740386013947	59.225503355704575	0.039428891806766904	145	442648	3
2916	79.34014093264919	64.76111111111138	0.038966795603434246	150	442798	5
2917	79.36397547837889	81.72359550561852	0.025447400740391233	193	442991	9
2918	79.34533572359511	77.50000000000071	0.0501161984034947	224	443215	12
2919	79.1309549736199	57.90726072607246	0.04091912099759873	146	443361	11
2920	79.12101050324878	78.13650793650865	0.06663547862659801	297	443658	4
2921	79.23302596212608	90.32255639097798	0.041791874875304516	186	443844	10
2922	78.86790278697347	42.720708446866354	0.047704584068722196	144	443988	13
2923	78.83704343123489	75.78196721311521	0.03336511552333832	192	444180	14
2924	78.73086167616782	68.21886792452858	0.03320173341400769	147	444327	6
2925	78.4350111599648	49.14581005586579	0.03681590398152669	150	444477	7
2926	78.23482771503181	58.416666666666536	0.03915316528744168	144	444621	1
2927	78.28884823220774	83.63687943262467	0.03913868409800904	191	444812	2
2928	78.29039072631664	78.44309764309814	0.0379005427135847	191	445003	8
2929	78.1093400613743	60.1853242320819	0.02568039539698008	148	445151	5
2930	77.98510746662136	65.68608058608086	0.04656121859679351	148	445299	12
2931	77.75789333463031	55.2636942675158	0.0472562718553608	147	445446	9
2932	77.8190286869983	83.87142857142908	0.04290100992942343	196	445642	3
2933	78.64959120911708	160.8752808988768	0.09169710443374958	188	445830	11
2934	78.59612808391115	73.30327868852501	0.029025202212126358	184	446014	4
2935	79.19678865181153	138.66218487395003	0.11324735173208271	167	446181	10
2936	79.11283073207082	70.80099667774111	0.03171417560983211	188	446369	13
2937	78.99124088628858	66.95384615384646	0.04886970719741901	191	446560	14
2938	80.03820098738585	183.68725099601642	0.13293916171359033	194	446754	7
2939	79.98307503287532	74.5256055363326	0.03322708606719971	188	446942	1
2940	80.45390625437756	127.066197183099	0.07133257111837697	172	447114	2
2941	80.32570532133018	67.63381294964059	0.04314757347106934	150	447264	9
2942	80.06627216748794	54.38238993710682	0.03640232929567091	147	447411	12
2943	80.42077432036503	115.51648745519755	0.07919352475334616	170	447581	8
2944	80.276951192546	66.03846153846176	0.04312978071324965	204	447785	6
2945	79.99064224844388	51.64605678233429	0.03165626525878906	145	447930	3
2946	79.76503545142761	57.42996254681688	0.07042727931853264	186	448116	5
2947	79.70901050407946	74.16254071661271	0.05379749524711382	202	448318	11
2948	80.0566751160198	114.4754716981137	0.0758348410470145	175	448493	4
2949	79.853871076724	59.77627118644059	0.05723924701716624	147	448640	13
2950	79.54441455773758	48.908219178082675	0.08363946278889973	189	448829	10
2951	79.30766271985252	55.869230769230676	0.04926269763224834	148	448977	14
2952	79.07698159104626	56.2395498392282	0.07363967100779216	144	449121	1
2953	78.90576229778388	61.95505226480842	0.07525855547761263	146	449267	2
2954	78.73057424002343	61.38695652173917	0.03746140819706329	146	449413	12
2955	78.44342978794577	50.01612903225793	0.037151853243509926	144	449557	9
2956	78.2355475405395	57.65520504731851	0.03987902563971442	148	449705	6
2957	78.54893332387536	109.57412587412624	0.10922165858892748	162	449867	8
2958	79.13979056103372	137.63465703971156	0.06126477377755302	175	450042	7
2959	78.93321693657354	58.482428115015836	0.05444842216952535	149	450191	3
2960	79.38529217461522	124.14074074074125	0.07444395007509173	165	450356	5
2961	79.07518176783913	48.37425149700588	0.032302525308397084	144	450500	11
2962	79.50931883904963	122.48888888888942	0.08180794394089401	163	450663	14
2963	79.24723799633814	53.3012345679011	0.04149210041966932	145	450808	12
2964	79.04731545560306	59.254983922829496	0.16453703788861837	146	450954	6
2965	79.39619012713399	113.93478260869597	0.068592699562631	164	451118	2
2966	79.30323819264005	70.10099667774125	0.044001188033666365	195	451313	13
2967	79.0208884454442	51.06826347305378	0.03432936246703271	147	451460	9
2968	79.94603696171178	171.5357400722026	0.1489415628655913	197	451657	10
2969	79.89503144159299	74.8454849498333	0.05941017681264622	187	451844	1
2970	79.72635024032691	63.026911314984815	0.05659229278564453	225	452069	4
2971	80.41275340459032	148.36666666666721	0.0713303220141065	182	452251	7
2972	81.02237055139548	141.37446808510703	0.0900252853309252	181	452432	3
2973	81.92841997363483	171.627312775331	0.07734918863759876	177	452609	5
2974	81.7299478544354	62.08120805369137	0.03225142478942871	150	452759	11
2975	81.55601528236586	64.33669064748229	0.04769204587352519	147	452906	10
2976	82.05434440289861	131.3889273356405	0.07276334376693461	173	453079	14
2977	81.8434216485248	60.96206896551728	0.04968487894212877	148	453227	9
2978	81.5786243747147	55.363694267515804	0.05794671463639769	146	453373	13
2979	82.27166188575684	150.88237547892754	0.09470198371193626	176	453549	2
2980	82.90268210900454	145.3736842105267	0.10122607381720292	190	453739	12
2981	82.80864110351735	73.4985815602842	0.029333981134558238	186	453925	6
2982	82.63508141003943	65.45267175572545	0.02612582951375883	146	454071	7
2983	82.87280077137764	106.40701754386005	0.09826288047743721	163	454234	1
2984	82.76321449594732	71.91417322834677	0.028931212751832726	146	454380	3
2985	82.46150886855973	52.59265175718837	0.014478603998819986	144	454524	5
2986	82.38594972393008	74.90559440559493	0.034150895384169114	194	454718	4
2987	82.97968281928338	141.75925925925978	0.05576681816714934	174	454892	11
2988	85.59367097402567	344.3784982935133	0.17157396393506516	446	455338	8
2989	85.33958750660622	60.1853242320819	0.048046940081828346	148	455486	13
2990	85.09481232119533	60.86206896551727	0.049694150886279626	149	455635	9
2991	84.83660493872412	59.27407407407401	0.06776498288524394	147	455782	10
2992	84.5192512350159	53.101234567901095	0.049149347811329125	147	455929	12
2993	84.15283934944635	47.878062678062584	0.048151541729362646	147	456076	6
2994	83.89809690912914	58.67859531772562	0.03213012540662611	148	456224	7
2995	83.68650109904844	62.738515901060204	0.03221851067255007	149	456373	1
2996	83.49100299453279	64.1366906474823	0.03175817720041979	149	456522	3
2997	83.40847391696842	75.23809523809557	0.030571590116874655	199	456721	14
2998	83.12380187621143	54.941269841269744	0.04217227085216625	148	456869	4
2999	83.4645920264634	117.20281690140882	0.08541593262643525	165	457034	5
3000	83.5727418051235	94.2795698924737	0.07348083751470973	239	457273	2
3001	83.40685825324327	66.98438661710065	0.03717792601812454	147	457420	13
3002	83.19421302837507	62.14233576642345	0.03892854187223646	144	457564	9
3003	82.91814629745235	55.587539936102104	0.040011242644427576	146	457710	8
3004	82.76293257641332	67.39677419354862	0.030291265370894452	196	457906	11
3005	82.45095385305882	51.56506024096372	0.036681096847743205	146	458052	10
3006	82.24525639506514	61.88120805369135	0.01796829386761314	152	458204	12
3007	81.95065045688136	52.78466257668702	0.036368820765247084	146	458350	7
3008	81.69027215744075	55.91282051282038	0.037639992812584185	145	458495	1
3009	81.45105364639265	57.76842105263147	0.04222617642632846	145	458640	3
3010	81.16246962750061	52.59265175718837	0.03863305515713162	144	458784	14
3011	80.84068308151463	48.983815028901596	0.04103212356567383	145	458929	5
3012	80.95164133006456	91.93650793650833	0.07394247234992261	159	459088	4
3013	80.83956081419981	69.74358974359001	0.02871845954626649	199	459287	6
3014	80.56998338787601	53.88181818181803	0.035515822155374875	142	459429	2
3015	80.33489593184741	57.06123778501615	0.029498731678929822	145	459574	13
3016	80.12698359224726	59.543661971830936	0.01282680784905707	143	459717	11
3017	80.4167137563248	109.10000000000032	0.06358659116527703	158	459875	8
3018	80.14246969568461	52.9923076923076	0.037880263916433676	146	460021	12
3019	80.04689515163297	70.5850152905202	0.03687811692555745	180	460201	9
3020	80.55790768159812	131.14814814814866	0.08750237797844339	169	460370	10
3021	80.28755841844674	53.522981366459504	0.03484045404966186	147	460517	7
3022	80.20524805165358	72.05652173913073	0.031086306314210634	148	460665	14
3023	80.08426324030998	68.1067669172935	0.04046580873686692	145	460810	5
3024	80.14110974648366	85.76891385767843	0.04738282153480931	190	461000	1
3025	80.16193460407501	82.22359550561849	0.031257941367778375	188	461188	3
3026	79.97556093277474	61.52456747404852	0.03420760713774582	145	461333	6
3027	80.41225602767236	123.64507042253561	0.07462355407357912	171	461504	4
3028	80.21772287136915	60.95894039735099	0.03728942050049636	151	461655	2
3029	79.96822006126011	55.267441860464984	0.04479498995674981	144	461799	13
3030	80.2145453794445	104.60075187969967	0.10561030950301732	156	461955	12
3031	80.00565495920709	59.325503355704576	0.05413483248816596	144	462099	7
3032	79.99220816571258	78.66097560975653	0.03661296722736764	188	462287	8
3033	79.77814815302096	58.586206896551566	0.03208146524177027	189	462476	11
3034	80.32180130046602	134.1434628975269	0.05014054249908965	177	462653	9
3035	80.17058328746135	65.20000000000024	0.038285917165328046	147	462800	5
3036	80.88758115829044	151.87037037037092	0.08934163010638693	184	462984	10
3037	81.1779646059668	109.92592592592639	0.05821034293504631	159	463143	6
3038	81.06353870140374	69.73537414966019	0.0303404664480558	186	463329	14
3039	80.83554691300562	58.264359861591586	0.04156329415061257	143	463472	2
3040	80.6326161014098	60.54246575342466	0.03870917664093225	147	463619	4
3041	80.53529990717311	70.90099667774113	0.02498239119422627	187	463806	3
3042	80.4895783074188	75.96313993174118	0.039458986429067755	195	464001	1
3043	80.44438093704302	75.96984126984162	0.030306809826901083	152	464153	13
3044	80.25055781732777	61.062068965517284	0.026545206705729168	147	464300	8
3045	80.1178961053255	66.98438661710065	0.037476922379059044	147	464447	11
3046	80.63307884639991	131.63617021276653	0.05833433949670126	172	464619	7
3047	80.60290242035202	77.61543624161125	0.028285230909075056	196	464815	12
3048	80.39872663846931	60.1853242320819	0.026635898126138223	148	464963	6
3049	80.23626983803445	64.15304659498234	0.03652120616338025	146	465109	14
3050	79.9691369533187	53.522981366459504	0.03715048030931122	147	465256	2
3051	79.94598833471488	77.65427509293733	0.03190727839394221	189	465445	10
3052	80.70237020220948	155.5841750841757	0.14710786170566204	194	465639	9
3053	80.4626322144731	56.72857142857128	0.029319521499006716	146	465785	4
3054	80.18824704988465	53.02411575562691	0.04112437036302355	144	465929	1
3055	80.12284046363017	73.64758842443757	0.042010375780937	195	466124	5
3056	79.88400755738614	56.2395498392282	0.03198812736405267	144	466268	3
3057	79.78747517411998	70.23076923076958	0.02579055765949229	189	466457	13
3058	79.56773835341325	57.81379310344817	0.03294607030934301	145	466602	11
3059	79.4358690879603	66.38081180811837	0.037553981858856826	147	466749	12
3060	79.22540740704747	58.389700996677604	0.03468846621578687	146	466895	6
3061	79.1960074255037	76.28540925266961	0.051883319912828164	197	467092	8
3062	79.78899160211974	138.49442508710845	0.08704964669196161	182	467274	7
3063	79.58986439796296	59.87627118644059	0.04385293019961004	146	467420	9
3064	79.32288883090641	52.8923076923076	0.038330081368790195	147	467567	10
3065	79.15904510160794	62.93851590106022	0.05009738766417211	147	467714	5
3066	79.58534353948076	121.78888888888945	0.09659007577335134	170	467884	4
3067	79.35546421411831	56.597411003236125	0.05108330167573074	145	468029	3
3068	79.21539442046198	65.34848484848511	0.036095643780895116	194	468223	14
3069	79.1249602214803	70.17197452229327	0.026227302652187447	189	468412	2
3070	78.90794138849625	57.42307692307671	0.028299668400558	194	468606	1
3071	78.69404005680308	57.51780821917797	0.0379786124596229	143	468749	11
3072	78.45973659891021	55.2636942675158	0.032849474018122875	147	468896	12
3073	78.22355193133382	54.84126984126974	0.04501379576305415	149	469045	6
3074	79.07842167517839	163.7105263157899	0.2271436990476122	204	469249	13
3075	78.96640911196991	67.877165354331	0.02711600024683946	147	469396	8
3076	78.81426187478279	63.751685393258676	0.011426731541350082	148	469544	9
3077	78.56794315540603	54.18238993710683	0.02524349833494865	149	469693	7
3078	78.33626372385197	55.3999999999999	0.03013391823604189	145	469838	4
3079	79.12620071208161	157.3299625468169	0.12932159054663875	186	470024	10
3080	78.82337979257409	48.844108761329196	0.04596642461316339	145	470169	2
3081	79.4003011101599	136.51551155115567	0.10931930541992188	185	470354	5
3082	79.36511777118946	75.88196721311519	0.03727891183024302	191	470545	3
3083	79.73931962862135	116.78530351437752	0.06649100022508919	173	470718	14
3084	80.1437675875698	120.18411552346606	0.08938083987264238	169	470887	11
3085	80.04865145510246	70.6321543408363	0.04441604218952396	193	471080	1
3086	80.0716179022239	82.34529616724781	0.040314402631534046	186	471266	12
3087	80.09800273330268	82.71010101010147	0.0684304918561663	182	471448	6
3088	79.95488186089923	65.78591549295805	0.02429781054818867	151	471599	7
3089	80.00204732800452	84.67142857142903	0.05399698906756462	188	471787	13
3090	79.89165023134785	68.9623376623379	0.06945426489717217	186	471973	8
3091	79.66168797740039	56.89542483660121	0.06568196955943267	149	472122	2
3092	79.65452723797726	78.94561403508823	0.04584213097890218	192	472314	9
3093	79.63761219067788	77.96302250803899	0.06234814291415007	184	472498	4
3094	80.32990273543778	148.8666666666672	0.10053685290665276	177	472675	3
3095	80.83449298143981	130.78892733564052	0.09873218642932742	179	472854	14
3096	80.57191913596276	54.57710843373481	0.21985668025604665	146	473000	11
3097	80.55564122574192	78.94412811387963	0.05263224388789205	206	473206	5
3098	80.33787076666177	58.778595317725625	0.04756971930160003	147	473353	1
3099	80.24495851266927	71.04664536741268	0.04895520692894816	247	473600	10
3100	80.02768841472206	58.517948717948585	0.07982953810533941	151	473751	7
3101	79.82926477289566	60.1853242320819	0.045069765400242164	148	473899	13
3102	79.5694721251667	53.84999999999988	0.06123565983127903	148	474047	6
3103	79.39618817832581	62.24107744107761	0.03610530120647506	151	474198	9
3104	79.41640811472438	81.41818181818239	0.10343617406384699	203	474401	12
3105	79.21349906713418	59.12550335570457	0.05611551624454864	146	474547	4
3106	79.66728299538175	124.5918918918922	0.0678371274194052	172	474719	2
3107	79.51114063137776	64.05304659498233	0.03424584135717275	147	474866	11
3108	79.30628425862102	59.02550335570456	0.03215883216079401	147	475013	1
3109	79.3050661365317	79.18447204968989	0.03786232964745883	232	475245	8
3110	79.23917763732855	72.71621621621652	0.024407936179119606	184	475429	14
3111	79.13057226872225	68.37864077669934	0.032243534370704936	189	475618	3
3112	79.29729133942345	95.80247933884351	0.022846084652525005	198	475816	5
3113	79.1802884634824	67.59700374531863	0.0505602959872914	147	475963	7
3114	78.91227538776478	52.37898089171963	0.05487774478064643	144	476107	13
3115	78.72600587620795	60.28532423208192	0.04993103961555325	147	476254	6
3116	79.39210945380951	145.33636363636415	0.06756867943229256	182	476436	10
3117	79.20361301680566	60.54246575342466	0.0415034261690516	147	476583	12
3118	78.92922945461343	51.76525679758297	0.038984184395777034	146	476729	4
3119	78.72872311324456	58.878595317725626	0.03378493165316647	146	476875	9
3120	78.47028250787898	52.88466257668702	0.0379178080065497	145	477020	11
3121	78.51112354244931	82.55438596491278	0.042487823526272596	191	477211	2
3122	78.32225555026805	59.62432432432426	0.03460898464673186	146	477357	8
3123	78.17117483873702	63.21418439716332	0.03637891237427588	147	477504	3
3124	77.99231633267047	60.28532423208192	0.03158367896566586	147	477651	14
3125	77.6070383306341	39.4645161290326	0.08363585318288495	186	477837	1
3126	77.35475775624495	52.37898089171963	0.03872189919153849	144	477981	5
3127	77.12248468848642	54.127450980392055	0.028368264436721802	144	478125	7
3128	76.89175984160156	54.049999999999876	0.03137567598525792	146	478271	13
3129	76.67997044831375	55.71282051282038	0.01845154470326949	147	478418	12
3130	76.98162893781056	106.84581939799382	0.0966326736268543	168	478586	10
3131	76.9222394397097	71.0426791277262	0.028649404644966125	192	478778	6
3132	76.96347725292506	81.04602076124615	0.025188763936360676	192	478970	4
3133	76.96738094193427	77.35384615384658	0.03452981602061878	187	479157	9
3134	76.79738798357874	59.96808510638292	0.0460932022995419	144	479301	2
3135	76.48513330145069	45.57191977077355	0.03175686803357355	145	479446	8
3136	76.37028196843619	65.00000000000023	0.03856063689161467	149	479595	14
3137	76.1874761587186	58.0897009966776	0.04052686371259241	149	479744	3
3138	76.0394709623488	61.38695652173917	0.03930466795620853	146	479890	1
3139	75.9624546311037	68.33783783783812	0.02859832822662039	194	480084	11
3140	75.80049363619453	59.76635514018688	0.18348935786509674	149	480233	7
3141	76.39920298554688	135.67142857142906	0.07247822472218717	178	480411	13
3142	76.07665265180448	44.14416961130783	0.06962620175403098	184	480595	5
3143	75.88217183957215	56.62857142857128	0.05122384570893787	147	480742	10
3144	76.48790567673198	136.45555555555612	0.10968597813656455	190	480932	12
3145	76.36339352643948	64.03669064748229	0.060695584615071616	150	481082	4
3146	76.19844044223892	59.86808510638291	0.03516989083125673	145	481227	2
3147	76.29123215721951	85.47761194029907	0.04282265113144325	189	481416	6
3148	76.16690192519955	63.85820895522416	0.045731796158684626	144	481560	1
3149	76.10745871239918	70.22258064516154	0.03549362897872925	200	481760	9
3150	76.75449013234234	140.81060070671418	0.09023700102916739	181	481941	14
3151	76.78595622002992	79.90109890109943	0.041910317839768826	189	482130	8
3152	76.79231967941236	77.42230215827392	0.03589749822811204	196	482326	11
3153	77.6742483344701	164.98518518518588	0.215513087030667	201	482527	3
3154	77.67624778660927	77.8741935483876	0.032912776825275825	188	482715	7
3155	77.58167829119931	68.21929824561455	0.023496804778108893	194	482909	13
3156	78.10952473852788	130.36632302405545	0.06945925365293647	173	483082	10
3157	77.9290634780707	60.06339869281044	0.04566369374593099	150	483232	12
3158	78.47396892172137	132.41960784313767	0.10603586832682292	165	483397	4
3159	78.47145145472638	78.22222222222274	0.046711084073182765	189	483586	2
3160	78.65316222753545	96.64252873563262	0.19743693005907667	182	483768	9
3161	78.62285362684283	75.62230215827401	0.05352739975831219	214	483982	1
3162	78.74576446339671	90.91393728223031	0.12878867878633388	170	484152	11
3163	78.63917988377821	68.08730650154827	0.030406268867286475	185	484337	8
3164	78.54146510357397	68.86770186335447	0.02712183156289345	242	484579	6
3165	78.52879601466842	77.27455621301806	0.2755467409343389	173	484752	3
3166	78.81405965594521	107.05516014234924	0.20117406735475035	174	484926	7
3167	79.24954154934561	122.36224899598454	0.1645067647017168	181	485107	10
3168	79.26450882041931	80.74626865671698	0.0700700462763034	199	485306	13
3169	79.99810334882854	152.62396166134258	0.15674774092857283	198	485504	12
3170	79.8882831545011	69.01608391608421	0.04574775373613512	148	485652	2
3171	80.61941609582675	153.0015772870669	0.2723839703728171	204	485856	4
3172	80.4488931677452	63.56712328767147	0.05489642414825641	151	486007	1
3173	80.32499044296429	68.05862068965547	0.10646750828991197	146	486153	11
3174	80.3471339811576	82.53934426229563	0.08542874988756682	190	486343	9
3175	80.17007341575679	62.64107744107764	0.0355954883860893	147	486490	3
3176	79.9171965809703	54.88238993710682	0.05639370394424653	142	486632	7
3177	80.04255093095007	92.45263157894767	0.06386538743972778	160	486792	6
3178	79.61028053715212	36.81551155115565	0.14886811261620025	183	486975	8
3179	82.36521518496411	355.1037453183509	0.2654266539943275	418	487393	14
3180	82.86575975442595	132.4196721311481	0.12179714473870283	183	487576	10
3181	82.6185862333148	58.14840764331198	0.04372062047322591	150	487726	4
3182	82.50654923829558	71.41488673139195	0.06601756530282385	191	487917	13
3183	82.93305517448405	125.15714285714327	0.07400354472073642	176	488093	2
3184	82.80695042919082	70.32258064516154	0.05449175235614106	199	488292	12
3185	82.57172303016208	59.284210526315675	0.06120843153733473	143	488435	1
3186	82.31429151414616	56.82857142857127	0.04929750047881028	145	488580	6
3187	82.03050685445642	53.93582554517124	0.05748736282874798	145	488725	7
3188	82.0061172788696	79.59154929577515	0.0403212239502599	189	488914	11
3189	81.71652947886196	53.04733727810636	0.05668326512279127	149	489063	3
3190	81.48100778268925	58.164359861591585	0.03958298100365533	144	489207	8
3191	81.24288191538866	57.66842105263147	0.035395596125354506	146	489353	14
3192	81.22789437737357	79.74412811387958	0.03951299792588359	198	489551	9
3193	83.42632703234591	301.0711598746067	0.19308404224674877	656	490207	5
3194	83.23828758873725	64.62238267148042	0.039893487683769796	147	490354	13
3195	83.19151446894745	78.56097560975653	0.024147664428388	189	490543	10
3196	82.98724721158192	62.76478873239456	0.041033483531377084	146	490689	1
3197	82.80706463493648	64.96898954703883	0.11976490892129502	197	490886	4
3198	83.63372868246468	165.4734693877557	0.07294960970378053	181	491067	12
3199	83.47128710116151	67.38957055214753	0.029351612795954166	184	491251	2
3200	83.29349393817908	65.69197080291998	0.056173857327165275	145	491396	7
3201	83.09470084276893	63.41418439716334	0.05368999612742457	145	491541	11
3202	82.87476758004571	61.10137457044677	0.047579298416773476	144	491685	14
3203	82.64578261610966	59.97627118644059	0.047018722008014546	145	491830	9
3204	82.23296424573087	41.363945578231665	0.08656439910063872	185	492015	6
3205	82.1461363097582	73.55017064846467	0.027166490297059757	185	492200	8
3206	81.95332283398457	62.86478873239457	0.038068883172396956	145	492345	13
3207	81.82767849453361	69.38888888888918	0.03473022549422746	194	492539	5
3208	81.58001408743844	57.06123778501615	0.028843846814385777	145	492684	10
3209	81.31662664497675	55.24126984126974	0.03586324165607321	145	492829	12
3210	82.03901763043538	153.55572519084032	0.08511329882711337	181	493010	1
3211	81.75515126365484	53.6523809523808	0.05476705719824551	147	493157	7
3212	81.42123132996565	48.36315789473724	0.08002243336943007	194	493351	4
3213	81.25038592314081	64.33669064748229	0.05898305672366603	147	493498	9
3214	81.0448820639094	60.699999999999996	0.06304560916524538	142	493640	6
3215	81.70809990993698	147.3666666666673	0.1671348214149475	192	493832	2
3216	81.7870999919187	89.60810810810865	0.030233720074529232	184	494016	14
3217	81.64919673393499	67.99677419354865	0.06245071009585732	190	494206	11
3218	82.93494899101809	210.2244224422453	0.1729397956600583	339	494545	3
3219	82.59796313747154	49.23636363636353	0.029322654217273206	143	494688	8
3220	82.37174621796122	59.976271186440606	0.05144829585634429	145	494833	5
3221	82.15248217193067	60.44534161490674	0.021513386528090674	202	495035	13
3222	81.93072006207576	59.97627118644059	0.04922315663304822	145	495180	12
3223	81.72342660715948	61.201374570446774	0.06461040790264423	143	495323	7
3224	81.49235900775456	58.61666666666653	0.05575562195039131	142	495465	9
3225	81.43334052716607	75.59051094890562	0.03617884715398153	192	495657	1
3226	81.34215966426729	72.3152542372888	0.1240602281358507	225	495882	10
3227	81.82942227815093	130.068421052632	0.09741605714310048	172	496054	4
3228	81.56846919249317	55.73411371237446	0.04526832368638781	144	496198	14
3229	82.05465774000487	130.18732394366242	0.07893024249510332	176	496374	6
3230	82.69444692902819	146.03357664233633	0.087768681141553	181	496555	2
3231	83.46460590801378	159.7103448275867	0.11234542651054187	195	496750	3
3232	83.21729318226697	58.733333333333235	0.0496938836985621	145	496895	13
3233	83.17630206862613	79.11818181818253	0.0818746954993864	226	497121	11
3234	83.17114282152477	82.66037735849127	0.038652678243978576	229	497350	8
3235	82.99259577687117	65.31643835616494	0.03186534654976118	202	497552	5
3236	82.81283702167481	65.01672025723504	0.18395057361796155	217	497769	12
3237	82.55299436574377	56.82857142857127	0.03800234301336881	145	497914	6
3238	82.44655533117724	71.9090909090914	0.07992917520028574	189	498103	7
3239	82.35145712480426	72.93673469387802	0.11228079491473258	188	498291	4
3240	82.3882387208036	86.02961672473909	0.1007930092189623	184	498475	14
3241	82.77191655768522	120.75602240896414	0.09591107567151387	192	498667	1
3242	82.68605148463506	74.18540925266973	0.07512391816585436	218	498885	10
3243	82.51320851364837	65.40175438596519	0.1260986328125	152	499037	13
3244	82.2991991721942	61.112274368231105	0.029919585136518087	146	499183	11
3245	82.18863397174951	71.2426791277262	0.0392270565032959	190	499373	2
3246	81.94143184255833	57.46842105263147	0.05454917856164881	148	499521	8
3247	81.73356804678083	61.15505226480838	0.04041631500442307	154	499675	5
3248	81.11036669467124	19.413432835821283	0.10432199659294256	179	499854	3
3249	81.21656172902324	91.72987012987078	0.1366521747710427	283	500137	9
3250	81.02064178647349	61.62456747404853	0.027252713839213055	144	500281	7
3251	80.79257329964324	58.21379310344816	0.027028141292274422	141	500422	6
3252	80.58732841771062	60.26808510638294	0.045417318952844496	141	500563	4
3253	80.42998559948333	64.85304659498233	0.039685444866152976	139	500702	1
3254	80.1823409159023	55.6655172413792	0.04824658596154415	132	500834	14
3255	81.14830182046877	176.77843137254942	0.13377949595451355	192	501026	12
3256	81.0146626684351	67.78438661710065	0.0351476120434219	139	501165	13
3257	81.08652550547313	88.20094637224011	0.16682428046117856	158	501323	10
3258	80.86134446094471	58.568421052631464	0.058054903127851276	137	501460	9
3259	80.89445828906254	84.17272727272776	0.03264001740349664	180	501640	11
3260	81.48457463807155	139.90609318996462	0.06754248559811694	177	501817	8
3261	81.4401098440718	77.03809523809569	0.06355934775336672	181	501998	2
3262	81.2617675691605	63.60588235294142	0.037640377327247905	135	502133	7
3263	81.11160890986233	66.24590163934468	0.02996399541380544	189	502322	5
3264	80.88267090295548	58.21780821917797	0.03230370142880608	136	502458	4
3265	80.8049967362988	73.11525423728878	0.03869937861570016	217	502675	3
3266	80.62617753816659	62.92307692307711	0.026363009171520204	139	502814	14
3267	81.33366275073674	151.3746987951814	0.09205973425576854	172	502986	6
3268	81.34478880979654	82.44626865671698	0.03594485482016763	182	503168	12
3269	81.32760179126379	79.62608695652222	0.02637773060666922	181	503349	13
3270	81.18506078912402	67.07350157728733	0.03393513626522488	180	503529	1
3271	80.88956083058342	51.63506493506479	0.05789111961017956	132	503661	11
3272	80.55670030999688	47.6035087719297	0.04923159884710381	137	503798	9
3273	80.31847444402067	56.734113712374445	0.044968007215813025	134	503932	2
3274	79.99767431496508	48.23846153846144	0.06618460741910068	132	504064	8
3275	80.5826634421226	138.4965870307173	0.11574004007422406	184	504248	10
3276	80.3962324911546	61.93956834532384	0.03119768919768157	135	504383	7
3277	80.17644824843484	58.41780821917797	0.053552179194208405	134	504517	5
3278	79.94202490307424	56.734113712374445	0.044707219992110976	134	504651	4
3279	79.73793798737682	59.53333333333325	0.03403065674496393	137	504788	14
3280	80.09434808118726	115.37894736842152	0.1243736077539669	161	504949	3
3281	79.9294634239048	63.60588235294142	0.04349981943766276	135	505084	12
3282	79.71434687185754	58.41780821917797	0.04668986619408451	134	505218	13
3283	79.48690138971615	56.96979865771797	0.041825098777884866	134	505352	1
3284	79.3731529983871	68.11206225680961	0.037080619953296805	135	505487	11
3285	79.89379280390811	131.4371335504892	0.08901371981928258	183	505670	6
3286	79.75130770605772	65.64528301886818	0.022623606081362123	135	505805	2
3287	79.44279462899715	48.89999999999986	0.02247858753910771	135	505940	10
3288	79.78033071148415	113.19640287769818	0.09007265538345148	162	506102	9
3289	79.60510316194507	62.25757575757588	0.02129595137354153	134	506236	5
3290	79.97833400952025	116.92818791946358	0.08781473581181017	172	506408	8
3291	79.73207525958898	55.35245901639335	0.03529018074718874	134	506542	14
3292	79.61259837316409	67.78438661710065	0.026492617970747912	139	506681	3
3293	80.180293938254	136.3821548821554	0.10475946509319803	184	506865	7
3294	80.16615766553812	78.7666666666671	0.039626917142546576	178	507043	4
3295	79.92649608888274	56.199999999999896	0.021653171873440707	137	507180	13
3296	79.79075784555117	66.35267175572547	0.02037757678623617	137	507317	11
3297	79.55571437859392	56.28641114982563	0.029678610034455034	133	507450	6
3298	79.264401137247	50.424390243902295	0.028927117806893807	135	507585	2
3299	79.82821866433608	135.6461538461543	0.07520521279856644	181	507766	12
3300	79.95619845852339	92.6261980830675	0.07885266549932132	159	507925	1
3301	79.76531732500197	60.86808510638298	0.025608827449657298	135	508060	9
3302	79.5707136217166	60.30494699646638	0.02195863101793372	138	508198	10
3303	79.49438148549945	71.93750000000028	0.027805585655377066	139	508337	7
3304	79.23978978332052	54.0352112676062	0.10879312463708826	185	508522	5
3305	78.98323851125417	53.584662576687016	0.031877358754475914	138	508660	4
3306	78.53714845742998	34.374233128834874	0.1508915750603927	190	508850	8
3307	78.84225725959404	109.0480286738355	0.08524043428385916	163	509013	3
3308	78.7468742126898	69.30395256917022	0.03440708973828484	136	509149	13
3309	78.52680096895519	56.73954983922819	0.03532468672278974	139	509288	11
3310	79.04620609842422	130.46731391585823	0.10033530355151234	183	509471	14
3311	78.90584748571585	65.01034482758648	0.06134788754960181	142	509613	6
3312	78.69607472514441	57.92857142857131	0.04675171624368696	134	509747	2
3313	78.49295985602917	58.38458781361994	0.0604889609596946	132	509879	12
3314	78.27337139459262	56.53411371237444	0.03188440028358908	136	510015	9
3315	78.75890062885387	126.8262948207176	0.0950047984267726	165	510180	10
3316	79.73931162256532	176.8000000000006	0.08418733287232084	191	510371	1
3317	79.526602716866	58.46842105263146	0.024743686551633087	138	510509	7
3318	79.38170359617216	65.03669064748227	0.024859144006456647	140	510649	5
3319	79.23360084592473	64.57142857142883	0.019182760938466024	139	510788	8
3320	79.01233554453619	57.107070707070605	0.020175741336963794	135	510923	11
3321	79.63223985707502	141.00276679841934	0.09658194149241728	170	511093	13
3322	80.30732922321016	147.14117647058876	0.08441028490171328	182	511275	3
3323	80.02992259764473	52.56666666666656	0.028683110645839147	140	511415	6
3324	79.8294766139891	59.98532423208189	0.031135142644246418	150	511565	12
3325	79.61334851451588	58.21666666666653	0.04048990223505725	146	511711	9
3326	80.0305253741983	121.33103448275895	0.0759369301073479	165	511876	2
3327	80.5852077365554	135.49876160990766	0.09525553385416667	192	512068	14
3328	80.41258642842062	63.323076923077146	0.019054976216068973	135	512203	10
3329	81.17127537895125	156.28148148148242	0.10455628505266046	251	512454	4
3330	81.04387512516175	68.43125000000026	0.0375351799858941	135	512589	7
3331	80.70833910947243	47.49027355623087	0.04536778276616877	132	512721	5
3332	80.5451738678439	64.39181494661946	0.036211314408675484	138	512859	8
3333	80.42150853693245	68.17864077669932	0.031120237879728146	191	513050	1
3334	80.74699974526942	112.97062937062974	0.07731941433771988	163	513213	11
3335	80.49759905474741	55.806930693069155	0.03110568558991845	134	513347	3
3336	80.14258128147013	44.99582172701939	0.029195735703653365	134	513481	6
3337	79.90615546865543	56.499999999999886	0.029026440720059977	134	513615	9
3338	79.67916462103958	57.207070707070606	0.027332261427124933	134	513749	2
3339	80.16944770792527	128.70747330960904	0.07711646989075063	171	513920	13
3340	80.07512672482193	70.73734939759066	0.028454164222434714	135	514055	10
3341	80.53294688614514	125.85714285714334	0.07812612296561518	169	514224	12
3342	80.22135993225375	49.37425149700588	0.023942308639412494	134	514358	14
3343	80.07262001714173	65.34736842105288	0.013625418698346173	135	514493	7
3344	79.85117953125604	57.92857142857131	0.011887982710083919	134	514627	5
3345	79.69444551372125	64.17777777777803	0.016946577142786096	135	514762	8
3346	79.46484219570779	56.734113712374445	0.00940687798742038	134	514896	1
3347	79.21847899711841	54.828522336769645	0.048199304635973945	138	515034	3
3348	78.97949673879279	55.320253164556824	0.06157106748768981	142	515176	11
3349	78.77235125594093	58.26494845360813	0.047935651696246605	138	515314	6
3350	78.52423939386696	53.96116504854357	0.06750370958726183	139	515453	2
3351	78.40781181474311	66.88148148148176	0.10306637862633014	145	515598	13
3352	79.20848369659569	158.4750000000007	0.22119093310925386	258	515856	4
3353	79.04545768315916	62.90588235294138	0.05332364162928622	142	515998	12
3354	78.82828882061328	57.32857142857127	0.026414644718170167	140	516138	14
3355	78.58068160808281	54.06756756756745	0.041485081857709744	134	516272	7
3356	79.09653802224253	130.16632302405546	0.06801592690604073	175	516447	9
3357	78.8675726420201	56.199999999999896	0.03621696903757805	137	516584	5
3358	79.52284136004435	144.39444444444513	0.08632935304692722	187	516771	10
3359	79.27702564485661	54.941269841269744	0.051801913493388405	148	516919	1
3360	79.16537601097615	68.11206225680961	0.04141546178747107	135	517054	3
3361	79.06705558419972	69.33333333333361	0.0441563764064432	139	517193	11
3362	79.45190164467192	117.55166163142042	0.07764696423473254	183	517376	8
3363	79.2687135890793	61.133096085409285	0.04358108661792896	135	517511	13
3364	79.05531216747423	57.92857142857131	0.038807178611186016	134	517645	2
3365	78.84604476008519	58.12857142857129	0.043360601771961556	132	517777	4
3366	78.64465691974506	58.70726072607245	0.01541132512299911	138	517915	12
3367	78.45747608481334	59.92657342657339	0.017653742832924004	134	518049	7
3368	78.27374342922836	60.08421052631574	0.021256628742924444	135	518184	9
3369	78.04529121830377	55.428522336769646	0.021739965135400944	132	518316	10
3370	78.8330800643625	156.8241758241763	0.09221280819524533	189	518505	14
3371	79.2728080872483	122.80588235294158	0.10526417550586518	168	518673	5
3372	79.1765819075165	69.65019011406874	0.0238252801003216	139	518812	1
3373	78.99881608844134	61.40000000000005	0.026363740143952548	135	518947	8
3374	79.43833442106343	122.95064935064994	0.1082602526298494	263	519210	6
3375	79.26519675159328	62.12456747404857	0.0293348161436671	139	519349	11
3376	79.0542683335654	58.172354948805356	0.022617197748440416	134	519483	13
3377	78.87973939593421	61.60137457044681	0.018169581461295808	139	519622	4
3378	78.77525450197487	68.43125000000026	0.029253867820457177	135	519757	12
3379	78.63601881088772	64.85168539325869	0.03290673067969997	137	519894	7
3380	78.52135093047116	67.16923076923102	0.02575682180899161	135	520029	10
3381	79.2877127636322	155.15753424657584	0.09031255466421854	194	520223	2
3382	79.30008563599588	80.52500000000046	0.04563455793592665	225	520448	3
3383	79.1695638670884	66.24790874524741	0.027363932574236836	135	520583	14
3384	79.58805708290669	121.01888544891689	0.07479734211177616	182	520765	9
3385	79.39301861734077	60.08421052631574	0.03067040620026765	135	520900	5
3386	79.17595283794702	57.68644067796594	0.031142142281603457	134	521034	1
3387	79.03471016350014	65.05168539325868	0.03726278587623879	135	521169	11
3388	78.75652435218771	51.21612903225795	0.033497008410367096	132	521301	8
3389	78.57572182053023	60.676271186440644	0.022256047829337742	138	521439	13
3390	78.4524436897774	66.24790874524741	0.024623835528338398	135	521574	4
3391	79.01653149777759	134.86122448979629	0.06869987361338915	181	521755	6
3392	78.81250411383431	58.61379310344817	0.03214915129390076	137	521892	10
3393	79.23647584688952	121.20967741935516	0.056339494113264416	174	522066	7
3394	78.98003760599251	53.592651757188364	0.028667973048651395	134	522200	2
3395	78.87611029494806	68.58730650154826	0.033667556444803876	180	522380	12
3396	78.68661492626431	59.92657342657339	0.030985686316419004	134	522514	3
3397	78.50048951774241	60.07407407407405	0.03240761997030794	139	522653	14
3398	78.4508539171708	73.53692946058119	0.020004749298095703	135	522788	1
3399	78.2697819977174	60.34366197183099	0.02324905042295103	135	522923	5
3400	78.2815277867628	79.44436090225618	0.017095196378100048	182	523105	9
3401	78.10047522075958	60.17627118644061	0.03649690934828111	143	523248	8
3402	77.91317778562515	59.37073170731694	0.03100816002727425	137	523385	4
3403	77.80818886491176	67.41428571428602	0.03089585671058068	182	523567	11
3404	78.38001952379116	134.99125475285226	0.094817834741929	170	523737	13
3405	78.71049614516225	111.42768166089999	0.10954780578613281	165	523902	6
3406	78.54994170635872	62.65505226480849	0.019552038727904394	139	524041	10
3407	78.3926730585259	62.823076923077124	0.02208383423941476	140	524181	12
3408	78.16711056635123	55.83642384105946	0.02147582874578588	136	524317	3
3409	78.0173472097652	63.190774907749294	0.03022562282186159	142	524459	7
3410	77.76984040433422	53.26666666666656	0.02454063946143129	133	524592	14
3411	77.60514200029087	61.30000000000003	0.02132634906207814	136	524728	1
3412	78.22197607647117	139.28854961832113	0.08215497669420745	171	524899	2
3413	77.99103082551036	55.127450980392055	0.01853006277511369	134	525033	5
3414	77.78134586936793	57.02253521126751	0.018157969740100373	133	525166	8
3415	77.58960501793496	58.607260726072454	0.023745764931328864	139	525305	4
3416	77.43383171143792	62.01227436823116	0.01772862803326906	137	525442	11
3417	77.95207018613242	129.2576791808879	0.05866199800337868	174	525616	9
3418	77.79618584790745	62.36363636363648	0.025574054649407915	139	525755	6
3419	77.59617823779439	57.79542483660121	0.03127163818904332	140	525895	10
3420	77.47344028213125	65.32238267148041	0.026735292162214007	140	526035	12
3421	77.16811551786415	46.94096385542155	0.05967584162047415	132	526167	3
3422	77.13148699426446	73.50526315789516	0.03782516170192409	185	526352	13
3423	76.9510691342886	59.08970099667761	0.045930190052059915	139	526491	7
3424	76.80978921217648	62.823076923077124	0.035760143824986046	140	526631	1
3425	76.57753794582159	53.584662576687016	0.024772222491278164	138	526769	5
3426	76.36080165431125	54.90390879478814	0.02690978726344322	134	526903	8
3427	76.0911974400495	49.40038022813749	0.04928401328997905	179	527082	14
3428	76.47885303321657	114.85675675675706	0.08422614279247466	168	527250	2
3429	76.30071398742048	58.66494845360813	0.03414325571771878	134	527384	4
3430	76.15372059325074	61.60137457044681	0.031251132059440336	139	527523	11
3431	75.94370797748216	55.152459016393344	0.036109612268560076	136	527659	9
3432	75.86122438607943	67.69534883720956	0.031839409295250386	136	527795	6
3433	75.74832642793292	64.57142857142883	0.026334892931601985	139	527934	10
3434	75.623772988215	63.29298245614055	0.033703399741131325	138	528072	7
3435	75.35565327075521	48.81180124223591	0.032554005131577	132	528204	3
3436	75.1536213282116	55.152459016393344	0.0353166005190681	136	528340	13
3437	75.47669585318451	107.4610738255038	0.06811825625867729	166	528506	12
3438	75.40970054819597	68.77716535433098	0.018013660458550938	138	528644	8
3439	75.34964306840571	69.40395256917022	0.02008312366626881	135	528779	2
3440	75.3579075804826	76.17609427609476	0.020435105429755317	180	528959	1
3441	75.20506924541853	60.07407407407405	0.018566817688427384	139	529098	4
3442	75.06031787269222	60.729931972789124	0.02057950666972569	140	529238	11
3443	74.86064620081461	55.09315068493139	0.018854065945273953	133	529371	9
3444	74.85987479035288	74.78350515463964	0.022137617931685633	179	529550	14
3445	74.59463099125482	48.33549488054669	0.10451550963063719	189	529739	5
3446	74.49060283080846	64.19181494661947	0.02380023172923497	140	529879	7
3447	74.32687488469216	58.11780821917797	0.027132559866800795	137	530016	13
3448	74.23970758512061	65.61014492753651	0.02301408222743443	140	530156	3
3449	74.21431050926941	71.70000000000033	0.02703584419502007	182	530338	6
3450	74.19244797971629	72.0280575539573	0.018216591202810908	178	530516	10
3451	74.02924704940719	57.87235494880535	0.03412145767768804	137	530653	12
3452	73.84223980228082	55.328522336769645	0.04022739525128128	133	530786	8
3453	73.7485316899723	64.47142857142882	0.04892324038914272	140	530926	2
3454	73.66352005728311	65.24736842105288	0.03368480415905223	136	531062	1
3455	73.53218417643816	60.52993197278911	0.04732846542143486	142	531204	4
3456	73.34779384152309	55.09315068493139	0.022960809836710307	133	531337	11
3457	73.28813071792267	67.38148148148176	0.012770949942725046	140	531477	14
3458	73.13756088615328	58.23114754098351	0.03026732845582824	138	531615	5
3459	73.82692353232531	142.07382550335623	0.07895838015924686	189	531804	9
3460	73.67572690426277	58.707260726072455	0.051175380098646965	138	531942	10
3461	73.56889945978155	62.99298245614053	0.052504640944460605	141	532083	12
3462	73.48357737165855	65.03669064748229	0.03697000912257603	140	532223	2
3463	73.36116625547622	61.242465753424696	0.04728495734078544	140	532363	1
3464	73.42016434901902	79.26097560975656	0.029335383530501483	182	532545	13
3465	73.33063185051024	64.46691449814152	0.03373688591851128	135	532680	11
3466	73.17393790985531	57.66123778501615	0.028727220974380165	139	532819	4
3467	73.51331193281861	107.111340206186	0.07467000556714606	165	532984	8
3468	73.38786174031969	60.968292682926766	0.02487165325290554	182	533166	3
3469	74.2177804651092	156.37973421926975	0.12711313792637416	196	533362	6
3470	74.16364292891448	68.80402684563809	0.13759343195620768	217	533579	7
3471	74.23165355844887	80.96470588235346	0.018606796369447814	182	533761	14
3472	74.0522124222254	56.2875399361021	0.016194600853130972	139	533900	9
3473	73.98747767341843	67.57873754152845	0.0324797579311432	187	534087	5
3474	73.82755714505025	57.9954248366012	0.02833072517229163	138	534225	2
3475	73.66823582196577	57.8954248366012	0.025772755094569364	139	534364	13
3476	73.56493862275671	63.33851590106027	0.057763299741945065	143	534507	1
3477	73.49076832398163	66.14790874524742	0.034565655624165255	136	534643	4
3478	73.35156795781498	59.57073170731696	0.042761113908555776	135	534778	3
3479	73.17512158516752	55.70693069306916	0.037771585252549915	135	534913	8
3480	73.56142165136713	111.80512820512865	0.08202078298557024	163	535076	12
3481	73.32233755533538	49.65301204819263	0.045417093347620084	135	535211	11
3482	73.12619110285895	53.70769230769218	0.024738237592909072	135	535346	6
3483	73.83077232908526	143.5843137254906	0.07901147652787772	171	535517	7
3484	73.54668494477745	45.42203389830495	0.0404605519944343	138	535655	14
3485	74.10370797387219	129.2489878542515	0.06209766574022246	164	535819	5
3486	73.98129158378865	61.86206896551734	0.023582003957076037	139	535958	1
3487	73.92104388534207	67.9565217391307	0.0408808188463645	189	536147	9
3488	73.77761939966591	59.578595317725664	0.015569983626441132	139	536286	13
3489	73.56963301458644	52.97898089171963	0.024813888729482456	138	536424	2
3490	73.41611476663235	58.21780821917797	0.026900883983163273	136	536560	11
3491	73.28169435970676	59.974074074074046	0.012074615274156843	140	536700	3
3492	73.1251631303954	57.62857142857131	0.02187836431238773	137	536837	4
3493	73.38728136210517	99.33698630137096	0.10138728486598508	307	537144	10
3494	73.26683320601838	61.34246575342471	0.015414795429586507	139	537283	8
3495	73.80446384303036	127.02989690721697	0.07216756288395372	172	537455	12
3496	74.15689949133841	109.0480286738355	0.09178078540263732	163	537618	6
3497	73.99528474479104	57.9954248366012	0.02771554131438767	138	537756	14
3498	74.36080956057337	110.54776632302449	0.08450556090383819	165	537921	7
3499	74.18927217203834	57.207070707070606	0.05185338276535718	134	538055	9
3500	74.03402893485404	58.66494845360813	0.060486857570819	134	538189	13
3501	73.78743116047555	49.374251497005865	0.043302923885744006	134	538323	1
3502	73.66617753852597	61.66206896551732	0.08893847634606328	141	538464	11
3503	73.4763339449589	54.68181818181803	0.05496113335908349	134	538598	4
3504	74.16508361666173	142.3513011152421	0.11416187505612428	174	538772	5
3505	73.95950970357204	53.60769230769218	0.04911601192810956	136	538908	3
3506	73.80955820515224	58.96435986159158	0.05279114667107077	136	539044	8
3507	73.64014004245556	56.86774193548375	0.05122283526829311	140	539184	10
3508	74.5106104369028	160.68717948717995	0.183872630889403	187	539371	2
3509	74.42250433253376	65.70000000000026	0.02264164367192228	142	539513	6
3510	74.35717481159648	67.88955223880627	0.03997254878916639	141	539654	7
3511	74.17127748208516	55.76744186046498	0.025324586484072018	139	539793	14
3512	74.09804792874081	66.84832214765123	0.010414396013532366	203	539996	12
3513	73.89342570490511	53.635825545171244	0.09266275972933383	148	540144	1
3514	73.73262937889054	57.81379310344817	0.07687905410240436	145	540289	11
3515	73.59872774263587	60.342465753424655	0.08559048415830471	149	540438	4
3516	74.35920985296463	149.64693877551073	0.10431482575156471	176	540614	9
3517	74.24739553221276	63.17777777777797	0.07366050194049703	145	540759	10
3518	74.14063586260492	63.57142857142879	0.07669135868149315	149	540908	5
3519	73.97630211123959	57.707260726072455	0.0799305890057538	148	541056	8
3520	73.73078299256622	49.4243902439023	0.08033189444706358	145	541201	3
3521	73.60836405152943	61.48888888888894	0.07529863795718632	148	541349	2
3522	73.97488604481697	110.26056338028206	0.0883754230127102	164	541513	6
3523	73.95251813674976	71.7380952380958	0.061449491060697116	234	541747	13
3524	73.82500670108674	61.20137457044679	0.04895614744066359	143	541890	7
3525	73.7750899674092	68.83333333333361	0.05968095196617974	144	542034	12
3526	73.66094913062818	62.361006289308314	0.05019200280540348	193	542227	14
3527	73.52438910928656	60.00494699646636	0.05255544270184023	141	542368	10
3528	73.52163924209808	73.24940239043853	0.06339093188305835	143	542511	3
3529	73.37431985964388	58.7897009966776	0.06395875903922067	142	542653	8
3530	74.15488435335513	151.43076923076958	0.08665127403992044	177	542830	1
3531	73.92901814455212	51.56826347305377	0.053600452315639445	142	542972	5
3532	74.47210964249591	128.23816793893175	0.1249747933027987	167	543139	9
3533	75.22852939114138	150.11408450704283	0.07585122737478703	188	543327	4
3534	75.07648734047321	60.02432432432428	0.037742379685522805	142	543469	2
3535	74.88539688567312	55.96744186046498	0.04043327456843244	137	543606	6
3536	74.69506438920902	55.85214723926371	0.05674078039927025	146	543752	13
3537	75.27987314381318	133.1759398496246	0.09106805589463976	171	543923	12
3538	76.06063166428345	153.35572519084033	0.0780292000275492	183	544106	7
3539	75.8510946545713	55.10693069306917	0.03376581313762259	141	544247	14
3540	75.74203653821426	64.94528301886818	0.05617831458508129	142	544389	8
3541	75.68477001898597	70.0153846153849	0.03793316545157597	145	544534	10
3542	75.52435893851441	59.64366197183094	0.04503747778879085	142	544676	1
3543	75.35225328016375	58.31379310344817	0.04049234049660819	140	544816	5
3544	76.61188622439393	201.31554770318127	0.16964595722702314	318	545134	11
3545	76.36044999688052	51.468263473053774	0.045494106266048405	143	545277	3
3546	76.1425006693255	54.56551724137917	0.04674242259739162	143	545420	9
3547	75.99719840631455	61.61227436823114	0.03820370613260472	141	545561	4
3548	75.69044676123445	45.32203389830495	0.020000516081885467	139	545700	2
3549	75.59713999477154	66.35977011494279	0.017161055973597936	140	545840	6
3550	75.52323626399676	68.2067669172935	0.032710287306043834	144	545984	12
3551	75.3030162470358	53.50123456790109	0.023073469842230524	143	546127	7
3552	75.37343904623792	82.34529616724782	0.03468098435350644	186	546313	13
3553	75.19901613118537	57.93114754098352	0.054134619151446836	141	546454	14
3554	75.00209527680421	55.506930693069165	0.01856859234997826	137	546591	5
3555	74.89005725918976	63.79829351535863	0.03845820035019966	146	546737	8
3556	74.69903208595889	55.7875399361021	0.032409876585006714	144	546881	10
3557	74.52071918445414	56.86774193548376	0.0374471698488508	140	547021	11
3558	74.3328762310202	55.73642384105946	0.14192124526866162	137	547158	4
3559	74.28324212519854	69.36946564885524	0.026279176514724206	145	547303	3
3560	74.12125558208275	58.08458781361994	0.03473055804217303	135	547438	2
3561	74.41779216715541	103.7749140893475	0.07263642985646318	164	547602	9
3562	74.87950313437275	120.58888888888929	0.07732502968756708	182	547784	1
3563	75.47965581544733	134.89477124183065	0.10141316280570081	186	547970	6
3564	75.47629675729287	75.14375000000031	0.05463102092481639	146	548116	7
3565	75.9077004563866	118.6166666666672	0.09630509336551506	167	548283	12
3566	75.85764203918335	70.90185873605976	0.06592672939958244	145	548428	13
3567	75.69433135305725	59.52657342657336	0.03358115666154502	138	548566	14
3568	75.58790187351877	65.05138339920975	0.04324703765430039	139	548705	5
3569	75.38409216171428	55.20693069306916	0.027478763035365512	140	548845	10
3570	75.19953695438285	56.92857142857132	0.040318846702575684	144	548989	8
3571	75.77454158483901	132.70000000000044	0.07752230555512184	172	549161	11
3572	75.56999870063619	55.320253164556824	0.04323023809513576	142	549303	2
3573	75.90053600176542	108.62372881355967	0.10944430414074195	167	549470	4
3574	75.93496161817875	79.34309764309812	0.05422156721681029	182	549652	3
3575	76.43268892507388	125.70769230769264	0.0875745253129439	165	549817	1
3576	76.40751435370393	73.91523178807994	0.0357287299824271	187	550004	9
3577	76.80239640861048	115.89571984435841	0.08029994496538595	163	550167	6
3578	76.68359627123917	64.92238267148042	0.036204795042673744	144	550311	14
3579	76.56698413524158	65.02238267148041	0.0452341933350463	143	550454	5
3580	77.32220318277805	152.08888888888941	0.0889780649881877	167	550621	12
3581	77.0736741600688	52.469300911853956	0.041959482473093314	143	550764	13
3582	76.83801434154505	53.50769230769218	0.028461750406418403	137	550901	8
3583	77.1829110147386	111.3276816609	0.073784460504371	166	551067	7
3584	77.65233190459122	124.12500000000043	0.08308080347572885	164	551231	10
3585	77.49767815076271	62.18695652173924	0.02127850573995839	138	551369	11
3586	77.25136803592174	52.86666666666657	0.024249492770563947	137	551506	3
3587	77.00752102222918	52.86666666666657	0.023696835023643326	137	551643	1
3588	77.6289458120069	139.15000000000046	0.09376250435324276	170	551813	2
3589	78.1717119094424	131.90555555555613	0.07868484541170859	173	551986	4
3590	77.99104426031263	60.10494699646636	0.019141747270311628	140	552126	6
3591	78.38941739979907	117.8283582089557	0.0617376653159537	164	552290	9
3592	78.21921139784409	61.368817204301116	0.021868018136508224	138	552428	5
3593	78.06244264152988	62.5423357664235	0.028484446661812917	140	552568	13
3594	77.89283196081905	61.10137457044677	0.03621735175450643	144	552712	12
3595	78.17267986498707	105.87762237762276	0.0490157953122767	164	552876	14
3596	78.04405451561257	65.3101449275365	0.04050748998468572	143	553019	10
3597	78.69261397045645	142.9000000000005	0.08640975952148437	170	553189	7
3598	78.70550601257007	79.98181818181867	0.02104906087422239	181	553370	8
3599	78.46627485181544	54.78238993710682	0.04247289270787806	143	553513	3
3600	78.27439805647454	59.278595317725646	0.04536382245345855	142	553655	1
3601	78.95639959562305	146.47455197132666	0.09263802616974044	183	553838	11
3602	78.69968222543369	53.28466257668702	0.02804918830276381	141	553979	2
3603	78.51373487314402	60.10494699646636	0.01392087255205427	140	554119	6
3604	78.40959752441258	68.10000000000028	0.02551983551657879	193	554312	4
3605	78.22474479241168	59.92432432432428	0.022525820698771442	143	554455	5
3606	78.0392380852283	59.67407407407403	0.027414206858281488	143	554598	13
3607	77.91230024983058	65.34545454545481	0.028541030613243156	141	554739	12
3608	77.80463447447092	67.14572271386454	0.04026529437205831	183	554922	9
3609	77.60727234025252	58.06842105263147	0.038651033186576735	142	555064	7
3610	77.46911776631619	63.79181494661946	0.03334381845262316	144	555208	8
3611	78.0858531620796	139.1426573426578	0.07746867185139525	181	555389	14
3612	78.11699463045882	81.20000000000053	0.047578954441662144	187	555576	10
3613	77.93006792739747	59.424324324324246	0.043464570432095916	148	555724	3
3614	77.79234933767574	64.15820895522415	0.03528338628457793	141	555865	2
3615	77.59756377533347	58.31379310344816	0.02888342993600028	140	556005	6
3616	77.54564025484399	72.40521172638474	0.02952852096149628	187	556192	11
3617	77.39935458400286	62.91707317073182	0.0497657597991469	193	556385	1
3618	77.25850288213447	63.31418439716335	0.03883121438222389	146	556531	5
3619	77.19657183255188	71.0653979238757	0.028377680068320418	188	556719	4
3620	77.04149500311526	61.688888888888954	0.04605938637093322	146	556865	7
3621	77.7710617380658	149.99816849816898	0.09210817710213039	184	557049	12
3622	77.77657334290735	78.32222222222278	0.028258052278072276	188	557237	13
3623	77.56778171951063	56.89741100323612	0.06196856162917446	142	557379	8
3624	77.54270121775178	75.05973154362466	0.055016964039904005	188	557567	9
3625	77.4034160495459	63.614184397163356	0.050043939710497025	143	557710	10
3626	78.24361593160363	161.42340425531958	0.0783300566118817	172	557882	14
3627	78.05396572546485	59.278595317725646	0.048714043388903984	142	558024	3
3628	77.79911907732874	52.56930091185396	0.041330565868968695	142	558166	6
3629	78.50697578299558	148.5847896440136	0.1445732797895159	196	558362	2
3630	78.7649597164408	104.30536912751721	0.08448609491673911	164	558526	11
3631	79.18588906664482	120.85789473684243	0.07164731691049975	172	558698	1
3632	79.01658069862646	62.25505226480847	0.03396697811313443	143	558841	12
3633	79.05614216436747	82.9727272727278	0.03651761511961619	192	559033	5
3634	78.89622863004774	63.06478873239459	0.027920621258395534	143	559176	8
3635	79.4926046337101	138.533828996283	0.0668614741734096	175	559351	4
3636	79.3881804885137	69.05019011406871	0.06250014469541353	145	559496	9
3637	79.25615948948938	66.18608058608088	0.07184158005080857	143	559639	10
3638	79.26161887361548	79.80209790209837	0.03142633173200819	180	559819	13
3639	79.21290232645637	74.38996415770659	0.035135414511124716	187	560006	7
3640	79.66653800907416	124.57647058823574	0.0834414106426817	165	560171	14
3641	79.44587576377965	57.600313479623686	0.0982653299967448	144	560315	3
3642	79.39488987435891	74.34728682170572	0.08282305918583253	147	560462	6
3643	79.08957160624594	48.86306306306293	0.03990265325451574	141	560603	11
3644	78.87832537471955	57.96494845360813	0.044536039338889694	141	560744	2
3645	78.6979667785066	60.842465753424676	0.02852132585313585	144	560888	12
3646	78.38602219844083	47.5035087719297	0.022916230602540832	138	561026	8
3647	78.80196389338933	119.98019169329126	0.06325919090667902	173	561199	1
3648	78.60565157152861	59.17073170731694	0.023506354942596216	139	561338	4
3649	78.50792838914666	68.83333333333363	0.03910541534423828	144	561482	7
3650	78.54808506031138	82.52359550561849	0.02221031446714659	185	561667	5
3651	78.68686619053895	92.4261980830675	0.06259160604536163	161	561828	9
3652	78.46797163866593	56.79741100323612	0.03614562708181101	143	561971	14
3653	78.15926945036915	47.597752808988666	0.028499041888730745	141	562112	3
3654	78.15230815518288	77.46313993174107	0.01824753416909112	180	562292	13
3655	78.14830231501037	77.75172413793156	0.02673300319814427	187	562479	10
3656	77.9571526251936	59.03333333333323	0.02445459030043911	142	562621	6
3657	77.78758109894166	61.000000000000014	0.017604762701679478	139	562760	2
3658	78.50127671652368	149.15714285714344	0.08672170741583711	186	562946	11
3659	78.29221819772445	57.595424836601204	0.033375995259889414	142	563088	12
3660	78.15187810529945	64.25820895522416	0.03166983127593994	140	563228	7
3661	78.50265562054275	113.22962962963013	0.0997175790049547	163	563391	1
3662	78.84721636592464	112.95873015873065	0.07614005797090587	171	563562	8
3663	78.567899001027	50.91547987616087	0.03047142710004534	140	563702	5
3664	78.41360517002734	63.13851590106024	0.06164901996481008	145	563847	3
3665	78.35550179806563	72.60326797385663	0.03055237201934165	188	564035	4
3666	78.1511055102437	57.91587301587292	0.07781959533691406	150	564185	13
3667	78.03441798455302	66.48235294117676	0.06695784722174798	143	564328	6
3668	78.66798289561659	141.39090909090947	0.05951057780872692	176	564504	9
3669	78.56109044207571	67.97873754152847	0.018383436515683034	183	564687	14
3670	79.0027969437983	122.73174061433498	0.06388231467085274	171	564858	10
3671	79.41697410256545	120.42051282051324	0.050302703945622966	173	565031	2
3672	80.02006942178076	139.726506024097	0.07503632704416911	168	565199	12
3673	79.87586872756296	65.60000000000025	0.028487552296031605	143	565342	7
3674	79.8533093530021	77.61993127147815	0.04295990402634079	185	565527	11
3675	80.28419857022905	122.94223107569769	0.05935930042732053	164	565691	1
3676	80.1768474270176	69.54908424908456	0.022844859998520105	146	565837	8
3677	79.95525703493921	58.017808219177965	0.03153647892717002	138	565975	3
3678	79.73199017887553	57.62857142857131	0.027552641221206552	137	566112	13
3679	79.59719699464404	66.25267175572546	0.025444310644398564	138	566250	6
3680	79.35074961486153	54.95245901639335	0.024623238522073498	138	566388	9
3681	79.54578449159426	98.85423728813592	0.05611389253768453	163	566551	5
3682	79.39769355315315	64.73669064748229	0.023816355458506338	143	566694	14
3683	79.78485193115297	118.11353135313581	0.07301429280063562	171	566865	4
3684	79.58624665508468	59.92432432432427	0.018308014302820592	143	567008	10
3685	79.38812492927458	59.77407407407403	0.02319445576466305	142	567150	12
3686	79.43488470562286	84.0641025641031	0.02542762911838034	184	567334	2
3687	79.20187699569038	56.13411371237446	0.029072999954223633	140	567474	11
3688	78.95968212510454	54.982389937106824	0.03731472610581851	141	567615	13
3689	78.74839677926332	57.83114754098351	0.029238841903041785	142	567757	6
3690	78.81162709718497	85.07142857142904	0.038424771765004036	184	567941	1
3691	79.30884415954645	128.5333333333339	0.07101427122604015	172	568113	3
3692	79.55865226967512	104.28965517241423	0.07560005656049296	163	568276	9
3693	79.33893826822482	57.58725212464568	0.03963544013652396	188	568464	7
3694	79.3022531108947	75.67042253521183	0.03200414884893388	193	568657	8
3695	79.00267166739904	49.344108761329196	0.03978430884225028	140	568797	14
3696	78.72895216075639	51.63072100313467	0.04867097841086963	141	568938	4
3697	79.35957173005792	141.79090909090945	0.06451961051586062	172	569110	5
3698	80.0750890869623	150.91130742049512	0.10706172450896233	186	569296	10
3699	79.78549299485428	51.115479876160876	0.02834688235020292	138	569434	12
3700	79.50284367238237	51.52056074766345	0.02567324085512023	138	569572	2
3701	79.28376948402456	57.59542483660121	0.03944623302405988	142	569714	13
3702	79.88278272086134	139.1850931677024	0.13352417072076447	191	569905	11
3703	79.71088471821413	62.69298245614051	0.039844923549228244	144	570049	3
3704	79.45659405285016	54.28181818181803	0.022554017495417942	138	570187	9
3705	79.17437876167232	51.23506493506479	0.027609493802575505	136	570323	8
3706	79.96534085640853	158.27058823529453	0.07285649210049962	181	570504	6
3707	79.73597316213016	57.02857142857131	0.038035292725463014	143	570647	14
3708	79.5811955200611	64.25820895522416	0.020090789454323906	140	570787	5
3709	79.95518204394796	116.97984790874573	0.06971312165260315	160	570947	7
3710	79.498148742027	34.25185185185239	0.07856679504567926	176	571123	1
3711	79.49897292262293	79.58056680162011	0.07818996145370159	188	571311	4
3712	79.32285275861409	61.88695652173921	0.04793386256441157	141	571452	10
3713	79.04238613578985	51.27619047619033	0.03591621682998982	141	571593	12
3714	78.82193638446432	56.99741100323612	0.019854721448100205	141	571734	13
3715	78.57253057994171	53.88135593220383	0.08762703945762233	190	571924	2
3716	78.44090672341765	65.41014492753649	0.02200457579653028	142	572066	11
3717	78.20550396533174	54.900630914826394	0.038737065262264676	144	572210	3
3718	78.08546646953808	66.20175438596519	0.052337302101982966	144	572354	8
3719	77.99902786323686	69.44160583941634	0.03888229529062907	144	572498	5
3720	77.83628325934498	61.724567474048534	0.044614315032958984	143	572641	6
3721	77.66934508428578	61.142465753424695	0.04042344735869279	141	572782	1
3722	77.42549825920979	53.28466257668702	0.04090205321075223	141	572923	7
3723	78.03658156658052	138.533828996283	0.04591835021972656	175	573098	9
3724	78.35047501017398	109.42592592592642	0.07961297616726015	164	573262	14
3725	78.16322529362928	59.625503355704595	0.02700725514838036	141	573403	4
3726	78.12753467493424	74.59416342412483	0.031159262399415712	148	573551	12
3727	78.04718267313264	70.09233449477411	0.018445831887862262	204	573755	10
3728	77.90585269037294	63.914184397163375	0.031904779161725724	140	573895	2
3729	77.75672398803061	62.99298245614053	0.029806749195071824	141	574036	13
3730	77.57299885341347	59.38421052631569	0.03817080108212753	142	574178	8
3731	77.39802211163257	60.07532467532461	0.10929971892258217	145	574323	3
3732	77.19899613888225	57.49542483660121	0.044089243962214544	143	574466	6
3733	77.06214802146506	63.514184397163355	0.04200116131040785	144	574610	5
3734	76.927509476404	63.59829351535861	0.04851490742451436	148	574758	1
3735	76.68390104830662	52.56666666666656	0.06034411021641323	140	574898	7
3736	76.63580713586278	71.87450980392185	0.026013456024490036	143	575041	14
3737	76.6162156150268	74.67665505226532	0.04542743603800245	193	575234	11
3738	76.3374259517132	48.73724928366753	0.030511160971413195	142	575376	9
3739	76.83281591983834	125.87642276422804	0.11658145459883053	163	575539	4
3740	76.61755706757064	55.30693069306916	0.0679990919373876	139	575678	12
3741	76.39319967871312	54.18181818181804	0.02556125723200736	139	575817	13
3742	76.10591474074951	47.66470588235284	0.03146054404122489	140	575957	10
3743	75.99731013879656	65.24545454545482	0.03451541443945656	142	576099	8
3744	75.80209142337351	56.4754385964911	0.02680087966077468	136	576235	6
3745	76.07348151237602	102.9411003236251	0.07927068264898426	167	576402	2
3746	75.8562712874162	54.35245901639334	0.05039083957672119	144	576546	3
3747	75.72413193220628	62.6423357664235	0.028961799127592457	139	576685	1
3748	75.47924126223486	51.23506493506479	0.03341127844417796	136	576821	5
3749	75.24582620810308	52.13773584905651	0.03560416594795559	138	576959	14
3750	75.0662323528017	57.28644067796595	0.035596125367758934	138	577097	11
3751	75.0169435232496	70.13734939759064	0.04444690122672006	141	577238	9
3752	74.84595217020888	57.917808219177964	0.027706911237977392	139	577377	4
3753	75.33000142043662	123.2508771929829	0.08595493541044348	170	577547	7
3754	75.59914208419835	102.2440677966105	0.08566972229378356	163	577710	12
3755	75.31439556131555	47.12448979591824	0.031777354649135045	140	577850	13
3756	75.2174474098982	65.6195804195807	0.03897046069709622	147	577997	10
3757	75.03234364286993	56.70707070707062	0.021926766676868468	139	578136	6
3758	74.96033270644124	67.83125000000028	0.03897058202865276	141	578277	3
3759	74.78334175722699	57.26123778501615	0.036130124872381035	143	578420	1
3760	75.18236976287571	114.6861423220978	0.06480212884446594	163	578583	2
3761	74.96655841092597	53.601234567901095	0.03584472226424956	142	578725	14
3762	74.86899427609207	65.2101449275365	0.03177789847056071	144	578869	11
3763	74.91835518078878	79.80508474576315	0.058000652686409325	184	579053	8
3764	75.30985362131806	114.0681992337168	0.07352464687750206	161	579214	7
3765	75.47447445269381	91.77193675889379	0.046047870149003696	188	579402	9
3766	76.35571562365983	163.59859154929643	0.1436093222234667	194	579596	5
3767	76.35055469383833	75.83962264150989	0.059834200402964714	184	579780	4
3768	76.22143430591055	63.438515901060256	0.0421080018433047	142	579922	13
3769	76.09399774062923	63.477777777778	0.03570309491224692	142	580064	10
3770	76.10334347750866	77.02857142857195	0.03580707836645255	193	580257	12
3771	75.94155328597681	59.92432432432428	0.051119937763347494	143	580400	3
3772	75.84494587119823	66.28081180811836	0.05058800851976549	148	580548	1
3773	75.71663825645788	63.01418439716332	0.05555648931720913	149	580697	2
3774	75.59705396344555	63.75820895522414	0.0633838258940598	145	580842	11
3775	75.7720834238111	93.10000000000053	0.05918979137501818	188	581030	6
3776	75.5836483038587	56.928571428571274	0.059751563602023654	144	581174	7
3777	76.06526252504545	123.7450704225356	0.11104104659136604	170	581344	8
3778	76.00418045194223	69.95705521472424	0.057148459096434255	189	581533	14
3779	75.76583165654135	52.169300911853966	0.06388059380936296	146	581679	9
3780	75.65827478925131	65.01014492753649	0.05056055604595028	146	581825	13
3781	75.6408443592396	73.91523178807991	0.04093474882809236	187	582012	5
3782	76.3269846521093	144.25487364620977	0.10910485199143215	181	582193	4
3783	76.77276060711493	120.90458015267217	0.08498631454095608	164	582357	12
3784	76.63841816005439	63.338515901060255	0.038297209706339805	143	582500	2
3785	76.46236731178718	59.03333333333323	0.042891945637447734	142	582642	11
3786	76.92378658345459	122.60429447852815	0.11364825912143874	184	582826	10
3787	76.7390255388121	58.44768211920515	0.053347664279537604	143	582969	6
3788	77.59965890547123	162.802362204725	0.07451341440389445	182	583151	3
3789	77.55916402290116	73.55017064846469	0.03348869633030247	185	583336	1
3790	77.92625437500932	114.26819923371679	0.07266739179503243	159	583495	8
3791	78.65399183125923	150.7000000000005	0.08302349822465764	172	583667	14
3792	78.68289319408542	81.5441281138795	0.028597712516784668	180	583847	9
3793	78.45142850055515	55.53642384105946	0.022239396898008936	139	583986	4
3794	78.40014677368913	73.32325581395393	0.04266674664555764	196	584182	7
3795	78.1907576838024	57.461237785016145	0.05305741357465162	141	584323	12
3796	78.03617663757663	62.7326530612246	0.025661460896755788	188	584511	13
3797	77.95570376008976	69.98888888888918	0.025436259330587185	188	584699	5
3798	77.79969724513695	62.35505226480847	0.03520851739695374	142	584841	10
3799	77.55354689845245	53.18466257668702	0.039195712183562804	142	584983	2
3800	77.48016527562177	70.21538461538489	0.03222623571649298	143	585126	6
3801	77.35873711684145	65.3373493975906	0.03134318003578791	189	585315	11
3802	77.20996182620995	62.48120805369142	0.034920908000371224	146	585461	8
3803	77.12642742533914	68.85652173913071	0.017443748315175374	180	585641	3
3804	77.56889162790695	121.37284768211975	0.05747894807295366	176	585817	1
3805	77.38391002870105	59.070731707316924	0.016979924270084927	140	585957	9
3806	77.2088241751673	59.87532467532458	0.02292267643675512	147	586104	4
3807	77.26018889508809	82.34529616724785	0.028692342901742586	186	586290	14
3808	77.47124564067536	98.36586345381582	0.028706497616238065	180	586470	7
3809	77.21918575224443	52.265256797582964	0.041445042224640544	141	586611	12
3810	77.06261458437716	61.56206896551732	0.0330824784829583	142	586753	2
3811	77.05935552714098	76.7367088607599	0.038015149574912054	181	586934	13
3812	77.71588494921586	142.71229773462846	0.11696784370823911	190	587124	5
3813	78.30745023765475	136.87241379310396	0.07260749628255656	182	587306	10
3814	78.3072338667661	78.28581314878939	0.023612816269333297	185	587491	6
3815	78.14305041698732	61.88888888888897	0.05181690719392565	144	587635	3
3816	78.56508176020701	120.34618473895637	0.11078249297527053	161	587796	4
3817	78.51952335184586	74.00924092409285	0.030947852004421215	183	587979	8
3818	78.60832024431166	87.39921259842575	0.02852684386233066	188	588167	9
3819	78.42653636159642	60.429931972789106	0.04209955255468409	143	588310	14
3820	78.44730859196542	80.50375939849691	0.032541751861572266	209	588519	11
3821	78.49957048837793	83.673498233216	0.038151542133188505	187	588706	1
3822	78.35424601637085	63.967123287671505	0.03927500069546862	147	588853	12
3823	78.24054742237814	66.98438661710065	0.043666573608813646	147	589000	2
3824	78.33541301042543	87.72710622710676	0.043036318343618644	184	589184	7
3825	78.05561695397556	50.355807365438956	0.038995029164009355	147	589331	5
3826	77.82288468380688	54.78238993710683	0.04157455150897686	143	589474	3
3827	77.81175154653977	76.7095709570962	0.05201748439243862	189	589663	13
3828	77.78311790204212	74.9483870967746	0.057061056188634926	185	589848	6
3829	77.73937913226263	73.40924092409283	0.05865386175730872	189	590037	10
3830	77.58479742147692	62.2812080536914	0.057498770791131096	148	590185	4
3831	77.30634886417177	49.73994169096197	0.053087017752907494	143	590328	9
3832	77.80254832373721	126.9262948207176	0.08155875089691907	164	590492	8
3833	77.61370232767933	58.91794871794858	0.04387015388125465	147	590639	14
3834	77.41741340566837	57.98481012658214	0.03621569133940197	147	590786	1
3835	78.13707138840002	149.3832116788327	0.08123050047003705	184	590970	11
3836	77.99237190739272	63.66712328767149	0.04061814626057943	150	591120	7
3837	78.64893507970456	143.64868913857717	0.07907723002351089	173	591293	2
3838	78.47889914505659	61.64534161490687	0.029441740638331364	190	591483	12
3839	78.20487205836793	51.076190476190334	0.03715576158536898	143	591626	3
3840	78.13704914423587	71.42258064516157	0.04478529666332488	188	591814	5
3841	77.92968178758976	57.40031347962368	0.05600663407208168	146	591960	8
3842	77.90333091565981	75.29459459459508	0.048613170782725014	192	592152	13
3843	78.63841081405037	151.41132075471748	0.0822963349806155	183	592335	6
3844	78.59066162654479	73.86349206349253	0.03400357125213792	181	592516	10
3845	78.45877826609329	65.40232558139559	0.027300758564725837	188	592704	4
3846	78.404692189917	73.05017064846471	0.027643492347315737	190	592894	9
3847	78.4392294974085	81.85842293906857	0.02731130952420442	184	593078	1
3848	78.48573501265341	83.08978102189833	0.047693061828613284	190	593268	14
3849	78.37777336804835	67.68957055214754	0.019263450612020755	181	593449	11
3850	79.01389886017432	141.99032258064554	0.08099378645420074	192	593641	7
3851	79.02691055650409	80.3150684931512	0.03951928981397518	189	593830	2
3852	78.85530811760572	61.866666666666774	0.06450150937450175	147	593977	3
3853	78.73962810144513	67.28730650154826	0.04905951702532991	193	594170	12
3854	78.55833018108642	60.60983606557379	0.05530731694227984	147	594317	5
3855	78.38886648060446	61.61196013289042	0.03800735992639243	147	594464	6
3856	78.33002993306226	72.50521172638476	0.029924920810166226	186	594650	8
3857	78.85382857366098	130.70989399293325	0.05230724811553955	176	594826	9
3858	78.66775046491551	60.24601769911493	0.03781529905882524	193	595019	13
3859	79.3260174047108	144.49444444444512	0.09727239096036522	186	595205	10
3860	79.48655088145735	95.37936507936573	0.043165440462073504	196	595401	1
3861	79.91564676260417	122.3961389961395	0.08266539140181108	165	595566	11
3862	79.95638107996106	83.98907849829402	0.046323015390198084	183	595749	14
3863	79.89004982730098	73.32325581395392	0.04371132169451032	196	595945	4
3864	79.71238009825875	62.12307692307704	0.03224980101293447	147	596092	12
3865	79.5140095440294	59.87532467532458	0.03045896932381351	147	596239	3
3866	80.17985043718228	146.09809885931617	0.053572379095705946	173	596412	2
3867	80.17066168890803	79.26097560975647	0.05442287633707235	182	596594	7
3868	80.56695507201896	119.80000000000044	0.08359903134174229	161	596755	5
3869	80.35622100516973	59.493548387096695	0.034137079160507414	146	596901	6
3870	80.7750580046042	122.23992094861693	0.05551995038986206	160	597061	8
3871	80.52518282391918	55.78753993610211	0.03475668364100986	144	597205	13
3872	81.13094257869157	141.10115830115885	0.07711068649738155	171	597376	9
3873	81.41917105904184	109.95379061371875	0.06425092264187117	163	597539	14
3874	81.61346871015355	100.84893617021326	0.02681538298889831	182	597721	1
3875	82.00442589584354	120.70918727915229	0.07125409070183249	170	597891	4
3876	82.09586648536995	91.14848484848532	0.045948351583173196	186	598077	11
3877	82.044130842099	76.92230215827396	0.02216151697718682	201	598278	10
3878	82.131439533678	90.77500000000053	0.0321849436373324	185	598463	2
3879	81.90846170792051	59.83365695792874	0.056651569234913796	145	598608	7
3880	82.5023770908413	141.3000000000005	0.1155384022702453	186	598794	12
3881	82.5157614831982	83.84081632653103	0.0477553836548526	181	598975	3
3882	82.93574578255765	124.51419141914243	0.05655327284267183	173	599148	6
3883	82.78771323447936	68.13249097472954	0.04691400399079194	148	599296	8
3884	82.67166891947203	71.18328173374644	0.03995114661551811	185	599481	5
3885	82.47388205483871	62.892982456140516	0.044730361078826476	142	599623	13
3886	82.36680488842566	71.76616541353413	0.02534431953952737	146	599769	14
3887	82.13997894480457	59.68421052631571	0.02868140515663641	139	599908	11
3888	82.78380052940233	146.52213740458072	0.05748600006103516	175	600083	1
3889	82.46816813158493	51.220560747663455	0.03299343501422422	141	600224	10
3890	82.35757735936	71.40909090909115	0.042465740872412616	194	600418	9
3891	82.25365732347132	71.9655737704921	0.02629092080252511	140	600558	2
3892	82.04180892227961	61.0688172043011	0.04264784535617693	141	600699	12
3893	82.95416634326091	173.2775510204086	0.25153843949480753	205	600904	4
3894	82.7816246798283	65.70000000000024	0.04716342603656608	142	601046	3
3895	82.55599410078246	60.218566775244255	0.040758851456315554	146	601192	7
3896	82.95811643402213	122.76822742474975	0.06648561629382047	176	601368	6
3897	82.75471708786372	62.618181818182336	0.0953996976216634	192	601560	8
3898	82.74936416158941	82.21942446043214	0.02864321936731753	184	601744	13
3899	82.46637051997352	54.449999999999875	0.0521283552680217	142	601886	11
3900	82.46041822416976	81.87114093959784	0.03118331419592873	187	602073	5
3901	82.28328772613858	64.74736842105288	0.037555109524557775	141	602214	1
3902	82.20793073312157	74.74758842443761	0.03481068818465523	184	602398	14
3903	82.5974004453982	121.15490196078473	0.06294863820075988	160	602558	9
3904	82.4639283420849	69.25019011406872	0.017904263276320238	143	602701	12
3905	82.0915093976471	45.22203389830495	0.027206552028656007	140	602841	2
3906	82.00196165060942	73.13673469387803	0.025387423012846258	186	603027	10
3907	82.31565195776744	113.37099236641262	0.0583672435737095	163	603190	4
3908	82.62861067982546	113.6115241635692	0.06472842286272747	164	603354	7
3909	83.297535099343	149.52105263157938	0.08446906982584203	188	603542	3
3910	83.04524395887587	58.068421052631464	0.04517045491178271	142	603684	6
3911	82.93693325157058	72.21417322834675	0.036421469041517565	143	603827	8
3912	83.65895898078327	155.13950617283996	0.08570024642077359	176	604003	13
3913	84.1951319809035	137.2762589928062	0.08260030140077447	173	604176	11
3914	84.75021436895963	139.70337078651727	0.08965650285993304	175	604351	5
3915	84.45934916794519	55.66369426751581	0.0535364617834558	143	604494	14
3916	84.21494134401819	60.01856677524424	0.06524968147277832	148	604642	1
3917	84.04460674539283	67.18148148148175	0.03675602523373886	142	604784	12
3918	83.82504956682779	62.08888888888899	0.030288535104670996	142	604926	9
3919	83.5931300320136	60.63309608540925	0.03489134652273995	140	605066	4
3920	83.90154655778042	114.43478260869598	0.073859322745845	159	605225	2
3921	84.65289052280761	159.03594306049885	0.09934625219791493	188	605413	10
3922	84.66709746663614	86.07358490566082	0.048473981293764984	176	605589	7
3923	84.46752794124514	64.71014492753648	0.04376113814795577	149	605738	8
3924	84.74635104370971	112.3498381877028	0.08358242932487936	170	605908	3
3925	84.55574833913342	65.68608058608086	0.053387277835124244	148	606056	13
3926	84.94361841757954	123.34275618374599	0.0755750134004561	179	606235	6
3927	84.6776590545958	58.347682119205146	0.06554761197831896	144	606379	11
3928	84.40416817833555	57.32857142857131	0.043578965323311944	140	606519	14
3929	84.27215762495688	71.20311284046723	0.041257521489283425	143	606662	9
3930	83.99972176299302	57.028571428571276	0.05441190146066092	143	606805	5
3931	83.71292707700866	55.320253164556824	0.03022973638185313	142	606947	12
3932	83.41883689418644	54.303908794788136	0.015163981914520263	140	607087	2
3933	83.21157834980598	62.69298245614053	0.03402927186754015	144	607231	4
3934	83.11893845055229	73.9475884244376	0.027806301911671955	192	607423	1
3935	82.8104016340226	52.265256797582964	0.04139745658171092	141	607564	7
3936	83.26688265169597	128.4585034013609	0.06931654612223308	177	607741	10
3937	83.09307463103981	65.8860805860809	0.025975955675726067	146	607887	8
3938	82.84421649199014	58.207260726072455	0.034585539277616914	143	608030	14
3939	82.78697363978502	77.11993127147818	0.03177294229206286	190	608220	3
3940	82.4847969125057	52.56930091185396	0.04041642202457912	142	608362	12
3941	82.28787876794205	62.792982456140514	0.04078007411289882	143	608505	5
3942	82.59943281608354	113.44328358208995	0.06571531295776367	178	608683	6
3943	82.46318143463117	68.97429467084675	0.04945823343042384	187	608870	13
3944	82.36518376662632	72.66341463414659	0.04768313443596988	187	609057	11
3945	82.18424160637942	64.27096774193572	0.03094924780038687	195	609252	9
3946	82.17354987524713	81.11506849315116	0.025066797245931888	181	609433	2
3947	82.28740988211264	93.55955056179828	0.04145316261658694	187	609620	1
3948	82.05979081684856	59.52550335570459	0.028781759906822527	142	609762	8
3949	82.40260619281293	116.34132841328463	0.06380665593030976	164	609926	10
3950	82.32548793230325	74.69078014184485	0.024608516693115236	245	610171	4
3951	82.95524372913681	145.30106761565895	0.0670880541775396	183	610354	12
3952	83.57905492820909	145.33636363636415	0.06043433619069529	182	610536	6
3953	83.76329422967326	102.00298507462735	0.04845355149638446	173	610709	9
3954	83.65809248003708	73.24311926605537	0.03373391991076262	184	610893	13
3955	84.17570752065458	135.41959654178746	0.1402318015027402	201	611094	3
3956	83.99481125130885	66.08608058608088	0.03789495759540134	144	611238	1
3957	83.83849870730889	68.36355685131223	0.04565676638954564	190	611428	11
3958	83.63865218177426	63.853846153846575	0.06994752196578292	222	611650	5
3959	83.49339859047012	69.11329305135979	0.03454731858294943	184	611834	2
3960	83.27086028801867	61.239568345323804	0.03257188326875928	142	611976	10
3961	84.55157314107718	211.34214559387104	0.26433398875784364	376	612352	7
3962	84.40691455252356	70.08571428571479	0.05442066592071693	191	612543	8
3963	84.89267690882983	132.98315018315066	0.12058824684187683	171	612714	4
3964	84.66516091415231	62.141077441077606	0.050937687095842864	152	612866	9
3965	84.8380093050108	101.95000000000039	0.07152571078546033	167	613033	6
3966	84.52519637613979	53.55671641791036	0.07054485321044922	150	613183	13
3967	84.53720247689452	85.72580645161325	0.05084118897887482	174	613357	12
3968	84.36320321198221	67.13727598566336	0.07036756841759932	152	613509	11
3969	84.69286114268766	117.32899628252831	0.06976987675922673	164	613673	3
3970	86.73448271713438	288.85501858736	0.1926429766743735	419	614092	14
3971	86.63968064089241	77.25427509293735	0.04915305616942094	193	614285	1
3972	86.41989494559459	64.66111111111138	0.051973560787984076	151	614436	2
3973	86.62746522690789	107.17692307692339	0.1091478082198131	158	614594	10
3974	86.32388856121598	56.269798657717985	0.035400390625	141	614735	7
3975	86.41489473489236	95.42450592885426	0.046043386009975255	191	614926	5
3976	86.13264279751021	58.1897009966776	0.05675598737355825	148	615074	4
3977	86.99503006248118	172.37136929460652	0.07965696894604227	184	615258	8
3978	86.70236547614208	57.72857142857129	0.04346975508858176	136	615394	13
3979	86.48595293249177	65.06111111111137	0.05038805721568412	147	615541	6
3980	86.16961799333079	54.85245901639335	0.02997377450517613	139	615680	11
3981	85.90716505664072	59.92432432432428	0.03671588764324055	143	615823	12
3982	86.44515433797396	139.70609318996463	0.05279623063582948	179	616002	9
3983	86.03367329606914	45.29705014749249	0.02481293327668134	136	616138	1
3984	85.95053587582323	77.71993127147815	0.029683532922164253	184	616322	3
3985	85.59917866521316	50.81481481481468	0.025109452309368327	139	616461	10
3986	86.15538977711176	141.22028985507282	0.06151638768654502	181	616642	14
3987	85.96164399742183	66.78081180811837	0.05215598819972752	143	616785	5
3988	85.89163731354517	78.96097560975656	0.02338063265826251	185	616970	2
3989	85.64734163006489	61.462068965517304	0.0393911975247043	143	617113	8
3990	85.58359794349397	79.27297297297342	0.026250690542241578	186	617299	7
3991	85.48447438235968	75.67124183006581	0.02616203960619475	190	617489	4
3992	85.31896297186942	68.93333333333361	0.04727975805322607	143	617632	12
3993	85.19478921516661	72.9015873015876	0.05112051797079873	143	617775	9
3994	85.72539687857049	138.25555555555607	0.07241343897442486	172	617947	11
3995	85.66257388621578	79.44309764309811	0.035328738597216525	181	618128	13
3996	85.64468312968577	83.87349823321598	0.041557641931482266	185	618313	6
3997	85.33059455384063	54.23582554517124	0.047427791944691836	142	618455	1
3998	85.10171196596646	62.4423357664235	0.03131821476821358	141	618596	10
3999	84.88783669027843	63.71418439716336	0.02386372190126231	142	618738	2
4000	84.58878222274672	54.982389937106824	0.026905722651921267	141	618879	8
4001	84.4936553432802	75.0760942760948	0.03819140089744048	191	619070	3
4002	84.371668475382	72.29496855345946	0.028271340309305393	188	619258	14
4003	84.9980813587345	147.0129568106318	0.106482616223787	190	619448	5
4004	84.68651989998585	53.84193548387085	0.03769793717757515	138	619586	12
4005	84.70432136765265	86.46666666666715	0.032880325209010734	176	619762	7
4006	84.48892604130008	63.16478873239459	0.03982601031451158	142	619904	11
4007	84.40579772364802	76.17609427609474	0.032766387197706436	180	620084	4
4008	84.443285200957	88.1545454545459	0.023147113101426944	172	620256	13
4009	85.08020729775289	148.1354948805467	0.0912713602969521	190	620446	9
4010	84.87962905149017	65.02238267148043	0.022272716869007458	143	620589	2
4011	84.75198162828919	72.11488673139198	0.01898738223573436	184	620773	6
4012	84.64049459889154	73.60327868852495	0.028422553236313288	181	620954	1
4013	84.57018536247358	77.60957095709617	0.03388594786326091	180	621134	10
4014	84.86259875048454	113.81152416356919	0.10273537812409578	162	621296	8
4015	84.56704206991039	55.30693069306916	0.034784063160848276	139	621435	7
4016	84.97894307778272	125.75714285714326	0.110968017578125	170	621605	5
4017	84.886857872357	75.77042253521182	0.02995037039120992	192	621797	3
4018	84.78924534899676	75.12560553633263	0.05067924352792593	182	621979	14
4019	84.58871980198163	64.73669064748229	0.04326425565706266	143	622122	11
4020	84.5953153625825	85.24827586206946	0.028099523723454766	181	622303	12
4021	84.66147111984776	91.21089108910937	0.030039031397212635	176	622479	4
4022	85.28426817335516	146.94117647058877	0.0718345953070599	184	622663	13
4023	85.64437824752713	121.29527559055161	0.05071362053475729	164	622827	10
4024	85.5691574866346	78.1223021582739	0.04001886630184436	189	623016	2
4025	85.67688226864558	96.34163568773288	0.16017733228967546	188	623204	6
4026	85.63311344595913	81.30000000000048	0.030625151049706242	186	623390	9
4027	85.59224251911199	81.54602076124615	0.05192100810494652	187	623577	1
4028	85.4216534272542	68.53333333333362	0.055472231235633905	147	623724	3
4029	85.28386368425892	71.64267912772623	0.05199456983996976	186	623910	8
4030	85.0046374252665	57.36123778501615	0.07043855962618975	142	624052	12
4031	85.05265796551197	89.80669144981461	0.037545971364282366	179	624231	7
4032	85.52379330756503	132.16619217081902	0.07835241251213607	172	624403	11
4033	85.54316143509544	87.46060606060654	0.040901534621779985	185	624588	14
4034	85.46333957684206	77.56097560975664	0.038167728251548266	199	624787	5
4035	85.90128297288253	129.2576791808879	0.06952844268974216	174	624961	4
4036	85.78330103118459	74.10308880308912	0.07043299609667635	146	625107	10
4037	85.54105742484626	61.55894039735103	0.05338409686910695	145	625252	9
4038	85.43257277652373	74.69259259259289	0.03405805652061205	178	625430	13
4039	85.86952920643483	129.12821576763528	0.06434391140937805	160	625590	1
4040	85.64861169214826	63.777777777778006	0.03346573877677643	139	625729	3
4041	85.5198941702681	72.7768595041325	0.029918361910813148	139	625868	8
4042	85.51786069619132	85.31654676259043	0.041856218267370154	189	626057	6
4043	85.46608138251563	80.33992932862236	0.03400862410261824	185	626242	2
4044	85.15377882414218	54.23582554517124	0.04569464670100682	142	626384	7
4045	84.86224103590077	55.99999999999989	0.035654877587188064	139	626523	5
4046	85.351703132584	133.8084507042258	0.053548949105398994	175	626698	14
4047	85.15311227575482	65.49261744966465	0.017341831342770102	183	626881	12
4048	85.50954889493276	120.7967741935488	0.08104432659384644	162	627043	4
4049	85.52611500294161	87.1661596958183	0.038656757188879926	230	627273	11
4050	85.2539264601729	58.30726072607246	0.04313745632977553	142	627415	13
4051	85.01440094127564	61.30137457044679	0.04008701821448098	142	627557	1
4052	84.68692359852955	52.26666666666655	0.03937196064662266	143	627700	9
4053	84.44535368227214	60.52993197278911	0.033809829765642195	142	627842	3
4054	84.14972404482049	54.88238993710682	0.0341945231800348	142	627984	8
4055	84.18205033378405	87.38235294117699	0.017810103685959526	184	628168	10
4056	83.90157096756995	56.13411371237445	0.02667982578277588	140	628308	2
4057	83.70322440287566	64.06691449814153	0.020658278636795153	139	628447	7
4058	83.58523242730328	71.90402684563807	0.027742270500429215	186	628633	6
4059	83.34881672274855	59.943661971830956	0.021819241612935237	139	628772	12
4060	83.0946400309309	57.93114754098351	0.03470191211565166	141	628913	14
4061	83.40778453971251	114.40909090909138	0.05941234565362698	164	629077	4
4062	83.19993746354615	62.62307692307709	0.05113957297634071	142	629219	11
4063	82.94255046676085	57.461237785016145	0.04401827196702889	141	629360	1
4064	82.62201253605774	50.888757396449556	0.04924602711454351	141	629501	9
4065	82.3955331514379	59.974074074074046	0.03336184024810791	140	629641	3
4066	82.07252049508276	50.094267515923455	0.041879897647433814	135	629776	10
4067	82.94632509145643	169.452980132451	0.21550569322374133	225	630001	5
4068	82.94086184054186	82.40000000000045	0.03234880719866071	175	630176	13
4069	82.63176043216778	52.030721003134666	0.02508309983859097	137	630313	2
4070	82.56500126940455	75.95584415584447	0.018612828702557812	181	630494	8
4071	83.04486849808983	130.55172413793147	0.04656668429104787	159	630653	7
4072	82.81510066417276	60.068085106382924	0.043964759453193294	143	630796	6
4073	82.80914390213535	82.21942446043214	0.027930915355682373	184	630980	14
4074	82.72850731261234	74.7454849498333	0.040527904287297675	188	631168	12
4075	82.47750795377193	57.62857142857131	0.021828825456382584	137	631305	13
4076	82.47373287423423	82.10000000000052	0.023027495052037616	178	631483	11
4077	82.78036540850559	113.13698630137033	0.075432890265651	169	631652	1
4078	82.65745064330942	70.48888888888919	0.026825805830825222	183	631835	4
4079	82.3150215374698	48.41454005934706	0.02885845951412035	138	631973	10
4080	81.97251838091863	48.06470588235283	0.041869619313408345	136	632109	5
4081	82.39836462568088	124.55714285714342	0.06883011807452191	182	632291	9
4082	83.36411380385157	178.97328244274888	0.10357161649723642	194	632485	3
4083	83.09818644673177	56.771378091872634	0.023520006649736046	138	632623	7
4084	82.81772917242839	55.05245901639335	0.032908422233414475	137	632760	6
4085	83.28894532332706	129.93934426229586	0.09131987006575973	216	632976	2
4086	83.27764009948446	82.15842293906857	0.02467481339175398	181	633157	8
4087	83.07209446772039	62.72307692307711	0.05784319478569301	141	633298	12
4088	83.85608780875747	161.47142857142907	0.07907552158131319	170	633468	14
4089	83.63807745331798	62.05505226480844	0.05666831444049704	145	633613	1
4090	83.40499599851269	60.329931972789105	0.04256947504149543	144	633757	4
4091	83.1655467711283	59.46007326007319	0.020884774897220362	137	633894	9
4092	83.20996197479512	87.60706713780961	0.042979751128316576	183	634077	13
4093	83.52147677510987	114.36144200627007	0.06909395927606626	172	634249	11
4094	83.26594621788509	57.96842105263147	0.04446384790060404	143	634392	6
4095	83.15854099299438	72.52542372881402	0.039445369962661986	189	634581	10
4096	83.60137021721077	127.4414634146346	0.08499993161952242	188	634769	5
4097	83.54255582775345	77.71993127147816	0.03458752062009728	184	634953	3
4098	83.47184268777657	76.4712418300658	0.0423175057212075	182	635135	7
4099	83.17739877070272	54.02745098039206	0.055471735987169986	145	635280	8
4100	83.18883511509902	84.32103321033266	0.052331848750038754	189	635469	2
4101	82.99947722989785	64.25304659498234	0.04250720451618063	145	635614	12
4102	83.08096730608372	91.14848484848532	0.0450223030582551	186	635800	14
4103	82.84792034488729	59.77627118644059	0.06968638361716757	147	635947	9
4104	82.72191193181642	70.24707903780119	0.03946209706758198	190	636137	4
4105	82.604616157446	70.99233449477396	0.040800295120630506	195	636332	1
4106	82.44537811395271	66.68081180811836	0.037364704741372004	144	636476	6
4107	82.34864585180054	72.77215189873455	0.06358670431470113	189	636665	13
4108	82.36608722833408	84.09278350515517	0.05377439468625992	189	636854	11
4109	82.1392684613139	59.68421052631571	0.029010721247830835	139	636993	7
4110	82.05753331094733	73.96575342465802	0.039847635704538094	184	637177	10
4111	81.77119913539413	53.42411575562691	0.039540096691676546	140	637317	2
4112	82.2457728583259	129.22857142857185	0.07073882030464752	171	637488	8
4113	82.26144189030603	83.81267605633849	0.029927662440708706	182	637670	5
4114	82.26092848150398	82.21010101010151	0.030088814822110264	187	637857	3
4115	82.72899335399231	129.0674157303375	0.07566342551327317	169	638026	12
4116	82.81435977784069	91.26563573883213	0.03548172468780189	186	638212	14
4117	83.06411781940655	107.79016393442669	0.0889362061095095	167	638379	4
4118	82.93183038270908	69.83537414966021	0.028004587018812026	185	638564	9
4119	82.92996504055446	82.74529616724783	0.0365428164765075	182	638746	6
4120	82.70185105790137	60.118566775244254	0.05929955333268561	147	638893	13
4121	82.56883254732236	69.40000000000026	0.026661862267388238	180	639073	1
4122	82.95674123677452	121.35970149253781	0.08638414130153427	166	639239	7
4123	82.75782171173071	63.06478873239459	0.04586487883454436	143	639382	8
4124	82.82527598558814	89.50324909747339	0.056022746040221845	187	639569	11
4125	82.61957374838033	62.25505226480847	0.04549235230559236	143	639712	3
4126	82.97440270225457	118.10246913580283	0.05726245858452537	176	639888	2
4127	82.61669376295131	47.2035087719297	0.04091406883077418	141	640029	12
4128	82.58692828517583	79.64014598540197	0.03262309571529957	188	640217	5
4129	82.49839036327083	73.73313609467493	0.04500387897010611	238	640455	10
4130	82.19796342166343	52.45569620253151	0.024879572202833437	139	640594	14
4131	81.86572630241686	48.97425149700587	0.031950708748637764	138	640732	4
4132	81.63120697042717	58.413793103448164	0.01619655965901107	139	640871	13
4133	81.37153184339806	55.6636942675158	0.039346114738837826	143	641014	1
4134	81.36872432638253	81.09078014184449	0.021132565335015566	181	641195	6
4135	81.18039586174466	62.53587786259556	0.0191773950618549	137	641332	2
4136	81.71183110578502	134.32392026578123	0.09315129984980045	184	641516	7
4137	81.69773377374815	80.30209790209832	0.03597687040056501	175	641691	3
4138	82.27791485185226	139.71584158415897	0.10332879712504725	186	641877	11
4139	82.2255166557147	77.03809523809569	0.025148151987823993	181	642058	12
4140	82.09230101484926	68.90395256917023	0.02519489015851702	140	642198	10
4141	81.871621247944	60.02432432432428	0.034001427637019625	142	642340	14
4142	81.91124771459229	85.83426791277313	0.11815998358127874	231	642571	8
4143	81.78748817862285	69.53529411764737	0.026304575704759168	186	642757	5
4144	81.5228158284822	55.320253164556824	0.03406280195209342	142	642899	13
4145	82.77242100353072	206.48333333333494	0.1671801827170632	330	643229	9
4146	82.50333373617057	55.863694267515804	0.04492294365632619	141	643370	6
4147	83.04971757672298	137.14171779141157	0.11352066198984782	192	643562	4
4148	83.46594921451508	124.67288135593259	0.058726690032265404	176	643738	1
4149	83.15698273148847	52.56930091185396	0.040228185519366196	142	643880	2
4150	82.84910591329214	52.369300911853955	0.05084280172983805	144	644024	7
4151	82.63062859986368	61.00137457044677	0.045350640395592	145	644169	12
4152	83.17304645179608	136.87241379310396	0.09810206654307606	182	644351	3
4153	83.10402021263025	76.27042253521178	0.05171387208336815	187	644538	11
4154	82.82618254214951	55.320253164556824	0.037869265381719024	142	644680	5
4155	83.16567071672802	116.77500000000043	0.0597803715297154	175	644855	10
4156	83.15201400956073	81.80000000000045	0.026222397609310256	181	645036	14
4157	82.95255269299454	63.2058823529414	0.04429478954068191	139	645175	9
4158	82.91263692216216	78.96097560975656	0.02900834470181852	185	645360	8
4159	82.61875171049681	53.52411575562691	0.03208586466398171	139	645499	4
4160	82.41898755105608	62.6423357664235	0.025233008021073377	139	645638	1
4161	82.19899880868999	60.42011331444749	0.021875840552309726	188	645826	13
4162	82.7040088206031	132.70000000000044	0.06754935619442962	172	645998	6
4163	82.48639338993131	60.94246575342468	0.027334916841733704	143	646141	7
4164	82.56649666914676	90.49672131147587	0.05600583553314209	176	646317	2
4165	82.25603730993193	51.52056074766345	0.02285424868265788	138	646455	12
4166	82.09400365438987	66.05267175572546	0.022848851340157645	140	646595	11
4167	81.83645911623825	56.33954983922819	0.03260462100689228	143	646738	3
4168	81.67509452507586	65.70000000000024	0.0314660240227068	142	646880	14
4169	81.44241618708583	58.40726072607246	0.03848747158726902	141	647021	9
4170	81.38138825163007	75.33962264150989	0.036327155178816864	189	647210	5
4171	82.15393379971876	158.63594306049887	0.07107076545556386	192	647402	10
4172	82.0278853042124	69.54908424908456	0.033663263059642214	146	647548	1
4173	81.98614491270874	77.85384615384659	0.035885404754470995	182	647730	8
4174	82.06631595455639	90.00324909747337	0.03143697780567211	182	647912	4
4175	82.47333506925833	122.76822742474975	0.0581720308824019	176	648088	13
4176	82.242387671743	59.37859531772565	0.05368859717186461	141	648229	2
4177	82.71506347348216	129.50996784565956	0.06999949158215132	183	648412	6
4178	82.54883254677654	66.09197080291997	0.045074868709483046	141	648553	11
4179	82.53172170475248	80.83774834437133	0.026567205138828442	184	648737	7
4180	82.57735553665601	87.09510489510534	0.02555193604722535	177	648914	12
4181	82.69798665055015	94.64046692607056	0.016567601683390075	181	649095	3
4182	83.05564314768102	118.4636363636368	0.05498684658093399	178	649273	14
4183	82.92833261784357	70.32459016393473	0.030270803040562413	181	649454	9
4184	82.98206976948083	88.30204778157044	0.03174636555814195	174	649628	10
4185	83.10305608932988	95.08070175438638	0.041254983310811004	171	649799	8
4186	83.04040648081754	76.83809523809572	0.02434438955588419	183	649982	5
4187	83.67934667830444	146.93442622950872	0.1113677165917391	169	650151	13
4188	83.62255321152139	78.00000000000067	0.04014153676490261	219	650370	4
4189	83.69488865501594	90.85609756097614	0.04640915038737845	188	650558	6
4190	83.80521963194701	94.72798634812335	0.05303559678324153	178	650736	11
4191	84.49057229392714	152.3404858299601	0.07690654017708519	176	650912	7
4192	84.48279333155125	83.7126760563385	0.03409915673928183	183	651095	12
4193	84.44500243527278	80.7037037037045	0.06942643244714196	229	651324	2
4194	84.1983056576733	59.775324675324576	0.06746253451785526	148	651472	3
4195	84.07587332573425	71.95507246376845	0.05178681920083721	178	651650	14
4196	83.88556742266559	65.04528301886819	0.09583869555317764	141	651791	8
4197	83.81817820211306	77.14664536741259	0.048933065065773586	186	651977	9
4198	84.2502953891641	127.02989690721697	0.10173916262249615	172	652149	5
4199	85.49393278614966	208.61403508772048	0.29235023147045436	369	652518	1
4200	85.22106606554888	58.207260726072455	0.03598317566451493	143	652661	11
4201	85.31367495376558	94.48195488721859	0.04690891307788891	182	652843	13
4202	85.19698501273858	73.64468085106454	0.0901446602561257	220	653063	10
4203	85.54187817630982	119.6863013698635	0.09014019855233125	172	653235	4
4204	85.30869016377748	62.223076923077045	0.05566270384069991	146	653381	2
4205	85.23388897642542	77.8285714285719	0.028811104233200487	185	653566	6
4206	85.75836558481615	137.68154981549867	0.12041161781133608	172	653738	12
4207	85.73290868953137	83.21267605633854	0.07307898744623711	188	653926	7
4208	85.71797686291004	84.23972602739775	0.083646095317343	184	654110	3
4209	85.54013522377734	67.93381294964058	0.06096311166983883	147	654257	14
4210	85.22342456223025	53.869069069068935	0.07808759828276982	151	654408	8
4211	84.95667439304107	58.548407643311975	0.03871390917529798	146	654554	1
4212	85.2805899642232	117.34823151125438	0.05574804002588445	176	654730	9
4213	84.96170714150404	53.3923076923076	0.06418451121155645	142	654872	13
4214	84.8386147849179	72.65247148289004	0.04739769786393561	147	655019	4
4215	84.86792094476102	87.76923076923119	0.04117904428663201	179	655198	5
4216	84.91806723866912	89.88255033557091	0.032789915457539176	174	655372	11
4217	85.44338177395016	137.44952076677382	0.09792722400866057	190	655562	10
4218	85.1921336239631	60.31856677524426	0.06816391780458647	145	655707	3
4219	85.05006943058062	70.98571428571458	0.04522440983698918	182	655889	2
4220	84.94366551046836	74.40967741935513	0.052950462824861766	142	656031	14
4221	85.42022885536369	132.60000000000045	0.050192154900876085	173	656204	12
4222	85.21155703275987	64.55304659498233	0.03345142619710573	142	656346	8
4223	85.00566232132797	64.62208588957084	0.03045010434988454	181	656527	7
4224	84.96903222141219	81.34265232974982	0.06684482574462891	225	656752	6
4225	84.68168303632181	56.23411371237445	0.021614150177660607	139	656891	13
4226	84.38469010532965	54.982389937106824	0.03591716035883477	141	657032	9
4227	84.48895431538747	94.81111111111142	0.06784481472439235	162	657194	1
4228	84.93373892953699	128.9674157303375	0.07287199917961569	170	657364	5
4229	84.86703176532201	78.26302250803901	0.04358952084957565	181	657545	4
4230	84.57703586627345	55.86744186046498	0.024580962416054546	138	657683	10
4231	84.22479562809264	49.35301204819263	0.02874608661817468	138	657821	3
4232	84.24939512943882	86.6847457627123	0.029831302621976925	183	658004	11
4233	84.23644503779357	82.9543859649128	0.03902514605598654	187	658191	14
4234	84.21108058741564	81.70000000000046	0.03484289986746652	182	658373	2
4235	84.09160912580379	72.2639344262298	0.051005706358491706	178	658551	12
4236	84.18280414565686	93.21111111111165	0.037395308526714195	178	658729	7
4237	84.14037066202343	79.93945578231339	0.03921503661781229	186	658915	6
4238	83.90606531605893	60.7098360655738	0.051700216450103344	146	659061	13
4239	84.22179413658256	115.47894736842152	0.07466404438018799	160	659221	9
4240	84.23786697535859	85.82907801418527	0.027028650045394897	240	659461	8
4241	84.16186925798596	76.6380952380957	0.03690903122360642	185	659646	1
4242	84.4092505654061	108.90000000000035	0.06312251091003418	160	659806	5
4243	84.61512247256343	104.9964412811392	0.0775754136859246	159	659965	10
4244	84.30546382944017	53.64925816023726	0.0405683813423946	145	660110	11
4245	84.44330392798787	98.08947368421097	0.0444163517518477	176	660286	4
4246	84.65473584047649	105.5864951768492	0.0705672177401456	165	660451	3
4247	85.01915622400722	121.09677419354878	0.05230961205824366	159	660610	12
4248	84.9299936472744	76.10289855072509	0.020229638947380914	180	660790	2
4249	85.17959410920804	109.89003984063795	0.04326408386230469	175	660965	7
4250	84.99930350619425	67.15053380782946	0.05327431469747465	146	661111	13
4251	85.71493116078749	156.56206896551774	0.11051005125045776	192	661303	14
4252	85.43505228943118	57.727044025157134	0.03941763516130119	145	661448	6
4253	85.17744250727762	59.67407407407403	0.0336728062663045	143	661591	9
4254	84.98558779023404	65.99197080291997	0.03845892489795953	142	661733	5
4255	84.75562080122059	61.98888888888897	0.034542513894034434	143	661876	10
4256	84.56698430123758	65.89197080291997	0.05374913782506556	143	662019	11
4257	84.47654701636475	75.52325581395385	0.024982586674306584	174	662193	1
4258	84.35894370836327	72.71621621621667	0.03345312502073205	184	662377	8
4259	84.12736801698411	61.201374570446774	0.05485373943835705	143	662520	4
4260	83.90234001155474	61.62456747404853	0.043985479407840304	144	662664	3
4261	83.64996021005511	58.66435986159159	0.020895889337114292	139	662803	12
4262	83.31763238709567	50.41717791411033	0.025524418988673806	139	662942	14
4263	83.13292974743524	64.84736842105288	0.020895634378705705	140	663082	6
4264	83.50162514131891	120.00246913580293	0.04106384629656555	157	663239	7
4265	84.25061237422628	158.40034843205623	0.09083105127016704	192	663431	2
4266	84.24899703546696	84.08907849829403	0.026943177967281132	182	663613	13
4267	83.96618148371692	55.96744186046498	0.03235701052811894	137	663750	5
4268	84.53340202182093	140.6882352941181	0.06511525060400108	173	663923	9
4269	84.24085747528694	55.278947368420944	0.030170277087357793	137	664060	10
4270	84.04169890053409	64.32500000000026	0.0236319903909725	137	664197	1
4271	83.76462304865248	56.33411371237445	0.022346316904261494	138	664335	11
4272	83.48234105657654	55.53642384105946	0.02085308205309532	139	664474	8
4273	83.13451764601078	48.69999999999986	0.02780931013343978	137	664611	3
4274	83.14312162209305	83.99491525423768	0.032008100639690056	176	664787	4
4275	82.98129324275155	66.96028368794354	0.03371250547211746	145	664932	12
4276	82.80558175959939	65.41014492753649	0.021670412009870504	142	665074	14
4277	82.52580045180731	54.82745098039206	0.023462857643183132	137	665211	7
4278	82.2761548251394	57.56123778501615	0.023104473522731237	140	665351	2
4279	82.02410705780673	57.07137809187263	0.03271488613552517	135	665486	9
4280	81.94670103877506	74.28350515463961	0.025255944417870563	184	665670	6
4281	81.73408727070813	60.68532423208194	0.05493024679330679	143	665813	10
4282	81.45375874368007	53.701234567901096	0.04311042136334358	141	665954	11
4283	81.18057941169498	54.13582554517124	0.037577258957015885	143	666097	8
4284	82.0105673918971	164.17937743190703	0.0937738521124727	186	666283	5
4285	81.91647175142295	72.60100334448194	0.026568597013300114	176	666459	1
4286	82.9492725511501	185.19655172413843	0.13544259247956453	216	666675	13
4287	83.30471202902844	118.4932203389834	0.06888992085176356	170	666845	3
4288	83.29911787041063	82.74529616724783	0.028893688222864172	182	667027	4
4289	83.75471172572013	128.85850340136088	0.0638981526986712	173	667200	14
4290	83.52988540618372	61.27207977207979	0.04867873502814252	184	667384	12
4291	83.57841633935594	88.38297872340478	0.02531115569215913	179	667563	7
4292	83.32470478322311	58.207260726072455	0.03630805515742802	143	667706	9
4293	83.44221829877117	95.07605633802861	0.04721170152936663	175	667881	2
4294	83.30249077227201	69.46946564885525	0.020956956677966647	144	668025	10
4295	83.18150559964863	71.20397350993406	0.029374035682467464	181	668206	6
4296	83.11839476900427	76.87042253521174	0.032938346019765946	181	668387	11
4297	83.13492510702851	84.77142857142906	0.04035739337696748	187	668574	8
4298	83.01061559105756	70.7039735099342	0.046693904425508234	186	668760	5
4299	82.92776549051031	74.72560553633265	0.05428676707770235	186	668946	1
4300	82.97331762283926	87.48297872340481	0.06207465618214709	188	669134	13
4301	82.84800529603173	70.44208494208524	0.05910364124510023	144	669278	14
4302	82.76455972583004	74.50344827586252	0.04621811944085198	185	669463	3
4303	83.23244559710322	129.55314685314727	0.06779913569605628	172	669635	4
4304	82.96299768434207	56.28765432098751	0.05349295106652665	146	669781	9
4305	82.81589711926335	68.25294117647086	0.02692786625453404	140	669921	2
4306	82.7679374607855	78.01993127147813	0.039936126266395186	181	670102	12
4307	82.78746841828098	84.72103321033265	0.031428700524407466	185	670287	7
4308	82.49483489165443	53.52411575562691	0.04877102803840912	139	670426	6
4309	82.7205559642255	105.06694214876083	0.030485439807810683	188	670614	10
4310	82.46042111165396	56.70707070707061	0.04638848544882356	139	670753	11
4311	82.24324155807167	60.74246575342466	0.04694784098658068	145	670898	8
4312	82.02614010334504	60.533096085409234	0.029632000212973738	141	671039	1
4313	81.74011985986786	53.42411575562691	0.030253890582493375	140	671179	13
4314	82.50082070208552	157.8102040816332	0.054592452265999535	176	671355	5
4315	82.26659844824192	59.07859531772563	0.04460108280181885	144	671499	14
4316	82.01100317083021	56.70707070707062	0.025796403130181403	139	671638	9
4317	81.9325506733685	74.16575342465798	0.04535631557087322	182	671820	3
4318	81.72934791031712	61.61227436823113	0.05880890163124031	141	671961	12
4319	81.46384390489816	55.17894736842094	0.036205319390780685	138	672099	7
4320	81.20787988445383	55.86744186046498	0.038158237070277115	138	672237	6
4321	81.84300675936817	144.72056737588719	0.07512857614319181	183	672420	4
4322	81.87229097748877	84.77142857142907	0.02274117495286911	187	672607	2
4323	81.57187527774524	51.83072100313466	0.024978328951828773	139	672746	10
4324	81.35399863023093	59.78421052631571	0.01860755595608034	138	672884	11
4325	81.11963672612039	57.917808219177964	0.022217529283153067	139	673023	13
4326	81.27547852679812	96.7038167938936	0.02323276713743048	177	673200	8
4327	81.38262484043125	91.99010989011039	0.026122449489122027	178	673378	1
4328	81.14575284039294	57.695424836601205	0.030769611926788978	141	673519	9
4329	80.91101886147706	57.672354948805356	0.027574271606884415	139	673658	12
4330	80.94464365519445	84.27349823321597	0.022059422171576904	181	673839	14
4331	80.74562187617676	61.04246575342469	0.03955466982344506	142	673981	3
4332	81.59169946524418	165.35338078291883	0.08115936298759616	196	674177	5
4333	81.37452321133247	59.874074074074045	0.0190835861449546	141	674318	7
4334	81.15211131255249	59.13333333333323	0.019163512169046604	141	674459	6
4335	81.2797237734342	93.91335740072245	0.0279475670287063	179	674638	4
4336	81.68578784956847	121.88613138686172	0.08677069726818336	167	674805	10
4337	81.63138451652733	76.24545454545502	0.04148265555664733	182	674987	2
4338	82.25551236747515	144.04416961130784	0.06006787134253461	184	675171	11
4339	82.28659826944143	85.36410256410295	0.05153393327144154	171	675342	13
4340	82.40386586075424	94.01335740072244	0.04842197225334939	178	675520	8
4341	82.60082720214669	102.10000000000049	0.03549397393558802	178	675698	1
4342	83.06015226345856	128.5333333333339	0.11666856810104015	172	675870	9
4343	83.18268772712536	95.31369863013745	0.03967507048086687	176	676046	3
4344	83.08158236884145	73.07215189873457	0.03391513260461951	186	676232	14
4345	82.78488109623663	53.411455108359014	0.07759002790059129	146	676378	4
4346	82.74605825930024	78.90259740259779	0.05584832378055738	184	676562	6
4347	82.51987123293824	60.12735562310018	0.08914219064915434	188	676750	5
4348	82.2079797306402	51.33072100313466	0.06832227441999647	144	676894	2
4349	82.04376073919461	65.78608058608089	0.050874106738032124	147	677041	11
4350	81.89119574326763	66.78726114649706	0.18020320313139113	191	677232	7
4351	81.79237469492587	72.00909090909126	0.06042854329372974	188	677420	10
4352	81.63337065600581	65.89197080291997	0.03217385698865344	143	677563	8
4353	81.61449308979664	79.7456140350882	0.02969410626784615	184	677747	13
4354	81.34394201555396	54.559385665528914	0.04068331157459932	136	677883	9
4355	81.11714619401434	58.66435986159159	0.05157004157416255	139	678022	14
4356	80.90281683733735	59.68421052631571	0.04618134944559001	139	678161	2
4357	81.65535018315957	156.15615141955902	0.1863983565685796	204	678365	1
4358	82.0478885541195	120.90918727915228	0.13158834548223586	168	678533	3
4359	81.779478975509	55.20693069306916	0.051715394428798134	140	678673	5
4360	82.28059327666301	131.8909090909096	0.07269244723849827	171	678844	4
4361	82.28377335788241	82.59860139860189	0.04088115182152406	187	679031	6
4362	82.96032493728069	149.93893129771052	0.05445493133374433	179	679210	11
4363	83.59305745433124	146.23357664233632	0.06767903226713895	179	679389	7
4364	84.6388639040094	188.17370242214662	0.23152202501558602	401	679790	12
4365	84.97885872361591	118.63834586466216	0.09210382024925876	166	679956	10
4366	84.6985295958392	56.94594594594583	0.04011605969435877	139	680095	8
4367	85.09418370508529	124.26394052044654	0.08181383482803255	169	680264	13
4368	84.83849690159148	59.52550335570459	0.02959173498019366	142	680406	1
4369	84.68038607587776	69.02741433021839	0.041091428935857106	181	680587	9
4370	84.45981298434975	62.62307692307709	0.01502627218273324	142	680729	5
4371	84.43440909911057	81.91942446043215	0.024591282727246616	187	680916	14
4372	84.1567424274743	56.667741935483754	0.027651105128543477	142	681058	3
4373	84.12896382307534	81.37888198757805	0.03776467179452907	179	681237	2
4374	83.90756307373348	61.98888888888897	0.04314302897953487	143	681380	7
4375	83.85322937848002	78.4741935483875	0.02768481432736575	182	681562	4
4376	84.41653492253307	140.1837837837842	0.09566605026657517	185	681747	11
4377	84.45444024468584	88.20706713780959	0.032289082047629494	177	681924	8
4378	84.31098495114988	70.10891089108951	0.03709198936583504	189	682113	6
4379	84.21947241707461	75.15973154362466	0.02685603228482333	187	682300	12
4380	84.10891183924532	73.16341463414662	0.022149342757004958	182	682482	10
4381	84.38399635429339	111.61736334405178	0.09849109311075606	169	682651	13
4382	84.13859301046877	59.843661971830954	0.03275984355381557	140	682791	14
4383	84.20003258371979	90.2825503355709	0.0371029348934398	170	682961	1
4384	84.85662007150266	149.85878136200768	0.08533881934913429	185	683146	5
4385	85.3477162911698	133.96624203821708	0.10502137529089096	188	683334	9
4386	85.95472366434058	146.0484536082479	0.0928416353590945	188	683522	3
4387	85.74617642769716	65.10000000000024	0.06352168160515863	148	683670	4
4388	85.60074579182486	71.20311284046721	0.051191980188543144	143	683813	11
4389	85.60366974184885	85.89314079422431	0.03920062468013662	187	684000	7
4390	85.58529971109704	83.76666666666729	0.05848873307552244	203	684203	2
4391	85.62371553119037	89.42688172043056	0.02678200403849284	180	684383	8
4392	85.65277047209841	88.52920962199359	0.03053563933132747	179	684562	6
4393	85.76381087368972	96.75681063122957	0.1204768471095873	161	684723	10
4394	86.4937576706132	158.75849056603826	0.09247210734599345	185	684908	12
4395	86.30366396007808	67.48438661710065	0.07214266817334672	142	685050	1
4396	86.22014456185661	77.95172413793155	0.03732443113584776	185	685235	13
4397	86.18094311623805	82.30000000000041	0.03394725105979226	176	685411	14
4398	85.93475437473084	61.56206896551732	0.053151738475745836	142	685553	4
4399	85.64010481756071	56.46979865771797	0.04980514375425929	139	685692	3
4400	85.27370953307386	49.00057636887595	0.04719121972997706	143	685835	9
4401	84.99458481559329	57.36123778501615	0.04040180125706632	142	685977	7
4402	85.38821039600877	124.35714285714334	0.09413904729096786	184	686161	5
4403	85.7237117506953	118.93834586466214	0.07447105243893488	163	686324	11
4404	85.38914129985501	52.26666666666655	0.05135914995953753	143	686467	6
4405	85.85415897776556	131.8909090909096	0.0785781403034054	171	686638	10
4406	86.28420562328203	128.85882352941232	0.0750290781094883	181	686819	2
4407	86.24282625361639	82.14626865671697	0.03925175022434544	185	687004	8
4408	86.23088074970092	85.04827586206947	0.026236945814122267	183	687187	12
4409	86.89759855817348	152.9026615969588	0.06760772157110562	181	687368	13
4410	86.93973148348283	91.11089108910936	0.0375263488898843	177	687545	1
4411	87.23997932993834	116.96451612903266	0.06772955656051635	160	687705	14
4412	87.45785768233432	109.0278145695369	0.06975830672029963	167	687872	4
4413	87.296749895889	71.34707903780112	0.012487247669497015	179	688051	3
4414	86.93454430169201	51.076190476190334	0.035710414806445996	143	688194	5
4415	86.90430713892987	83.91082802547812	0.03199568007911384	179	688373	7
4416	87.12480252907903	108.95384615384664	0.07032708954392818	171	688544	11
4417	86.92336931860305	66.98148148148177	0.053315420945485435	144	688688	2
4418	86.78099375690492	72.6858131487897	0.07721824962568481	241	688929	9
4419	86.71877891136042	80.5595092024544	0.032444637843540736	175	689104	6
4420	86.64999041553304	79.83992932862239	0.030863591244346216	190	689294	10
4421	86.69589687180174	91.24063604240324	0.03192247663225446	182	689476	8
4422	87.03275919585938	120.38212927756705	0.06846274399175876	164	689640	12
4423	86.73294250732758	57.051090342679025	0.04410283976587756	145	689785	14
4424	86.77709793073915	91.14848484848532	0.029563342371294574	186	689971	13
4425	86.45482695143176	54.549999999999876	0.031800980263567986	141	690112	3
4426	86.2193930514189	62.91143695014676	0.025297462004017456	191	690303	1
4427	86.10312504683064	74.5925925925929	0.02873671920605878	179	690482	4
4428	85.79329632800791	55.12025316455682	0.0389991733762953	144	690626	7
4429	85.46628988229972	53.09265175718837	0.02469412371409025	139	690765	11
4430	85.26563984521306	65.4012861736337	0.023390132419312197	181	690946	5
4431	84.94940280159965	53.64193548387085	0.0301931585584368	140	691086	2
4432	84.76176957944446	66.18608058608088	0.038784794040493197	143	691229	8
4433	85.19043908088186	127.62871972318376	0.055900600823489105	176	691405	9
4434	85.12220135673971	78.36666666666711	0.02897717140533112	182	691587	6
4435	84.9340359469459	66.30566037735876	0.023366858508135822	185	691772	10
4436	84.84364153342239	75.89459459459505	0.027483919615386633	186	691958	12
4437	84.75902479021931	76.38196721311526	0.030027240835210328	186	692144	14
4438	84.78577257048615	87.43380281690189	0.02270585265607465	181	692325	13
4439	84.6709148447813	73.3000000000003	0.0798534501528909	141	692466	11
4440	84.72416221807262	89.9956521739135	0.029320273348080215	186	692652	3
4441	85.2021746151845	132.52540192926085	0.07254842809728675	185	692837	4
4442	85.24542168623697	89.52688172043055	0.019798808923646726	179	693016	7
4443	84.99727542785212	60.430795847751284	0.08395731021196415	195	693211	1
4444	84.86367767357359	71.63750000000029	0.06050906382815938	142	693353	8
4445	84.7859450064269	77.09041095890461	0.04243156616700524	187	693540	5
4446	84.52841888969597	59.03333333333323	0.04077851940208758	142	693682	9
4447	84.63588647384867	95.27517730496508	0.040460107076233924	181	693863	2
4448	84.42343535818767	63.39077490774928	0.026100260870797292	140	694003	10
4449	84.6618025083652	108.26015037594028	0.06471377573195536	157	694160	6
4450	84.36825379021224	55.30693069306916	0.028616459249592514	139	694299	12
4451	84.1027493345019	57.81780821917796	0.026138976642063685	140	694439	14
4452	83.8102464313208	54.85245901639335	0.027867493869589387	139	694578	3
4453	84.20037038210194	122.8226415094343	0.07791299305990071	167	694745	13
4454	83.93905088880723	58.06842105263147	0.03696952403431207	142	694887	4
4455	83.6974011206599	59.77407407407404	0.03234483826328331	142	695029	7
4456	84.37255476902777	151.21276595744752	0.08150298002535704	189	695218	11
4457	84.09450664069233	56.56774193548375	0.053376758015239154	143	695361	1
4458	83.86818226394057	61.462068965517304	0.0358011038986953	143	695504	2
4459	83.66055926483058	63.1058823529414	0.052033458437238424	140	695644	10
4460	83.71106437328929	88.71107011070164	0.035347846838144154	182	695826	9
4461	83.75756938791939	88.36156583629946	0.03403745974347891	183	696009	8
4462	83.68143256551356	76.14388714733582	0.030166524179865806	178	696187	5
4463	84.3349399181801	149.0321678321683	0.08140998473141921	187	696374	6
4464	84.91598212738991	142.4391608391613	0.08977704491120218	183	696557	12
4465	85.18921303459284	112.2390728476826	0.0698271081561134	168	696725	14
4466	85.28272557350762	94.54046692607055	0.06437083653041295	182	696907	3
4467	85.84510121632327	141.5202898550728	0.08511957961521792	178	697085	13
4468	85.91430656154836	92.76563573883205	0.10182493332533808	171	697256	4
4469	85.92743195230872	87.2268456375843	0.11512115615570617	167	697423	11
4470	86.04805236962775	97.98947368421098	0.05265695496467547	177	697600	7
4471	86.14493548229511	95.73636363636406	0.039051736338754715	178	697778	1
4472	85.83455543440284	55.10693069306917	0.04917771765526305	141	697919	9
4473	85.539907866636	56.36979865771798	0.03348613466535296	140	698059	5
4474	85.36699200944615	68.24832214765149	0.04879259180139612	189	698248	2
4475	85.47870057540747	96.53784860557826	0.03365908981000305	189	698437	10
4476	86.16101737588177	153.7103806228378	0.11216444770495097	192	698629	8
4477	85.85041351127121	55.1006309148264	0.056473920043085664	142	698771	12
4478	85.87001498671957	87.81056105610604	0.04260918245477192	177	698948	6
4479	86.06665381990322	105.53389830508507	0.09679701270126714	164	699112	14
4480	85.77696139173656	57.097411003236125	0.025997001784188407	140	699252	1
4481	85.43984238022882	52.06506024096371	0.04272575581327398	141	699393	7
4482	85.64804546018594	106.26015037594037	0.04896004994710287	177	699570	13
4483	85.5388210609474	74.72560553633267	0.029108490995181504	186	699756	3
4484	85.67298096749273	98.95481171548165	0.028335731991088194	181	699937	11
4485	85.5462008433524	72.99496855345956	0.022429597970530474	181	700118	4
4486	85.65626997045001	96.553113553114	0.04820130139412965	169	700287	9
4487	85.68772774856122	88.80204778157041	0.035352664586355	169	700456	5
4488	85.17679509648278	34.59446254071722	0.07644564138876425	185	700641	2
4489	84.8301139622382	50.508681672025624	0.02902352200807446	137	700778	12
4490	84.54481282261582	56.30000000000061	0.10202079405759108	187	700965	10
4491	84.44615726404912	74.67925696594459	0.039276771123896645	181	701146	8
4492	84.5851159812637	98.34202898550762	0.04009313310895647	175	701321	6
4493	84.62609460868511	88.68297872340476	0.03698276118798689	176	701497	14
4494	84.37667576786141	59.68421052631571	0.05201856695490775	139	701636	11
4495	84.34749875377256	81.45897435897477	0.03461808033203811	178	701814	1
4496	84.2370564459734	73.30326797385669	0.032285395248160174	181	701995	7
4497	84.17497159579939	78.0285714285719	0.04023328895777301	183	702178	13
4498	84.22165045126998	88.84285714285761	0.019922003641233338	182	702360	3
4499	83.86548690625884	48.605295950155664	0.03812631088144639	136	702496	2
4500	83.89012820444364	86.32961672473911	0.02021730538889848	181	702677	9
4501	83.63939358906588	58.81666666666653	0.041344094276428225	140	702817	10
4502	83.13815146835674	33.51518151815236	0.10084415915233841	183	703000	5
4503	82.91206927340106	60.52993197278911	0.031547506090620875	142	703142	8
4504	83.61730069334311	153.43521126760623	0.11659179486726459	190	703332	12
4505	83.66275926535705	88.16315789473718	0.029660603579352882	170	703502	6
4506	83.8672528848247	104.1121212121216	0.02599968068739947	170	703672	14
4507	83.68759789983609	65.90175438596519	0.061672937302362354	147	703819	7
4508	83.7073885875044	85.66666666666718	0.019491703613944675	184	704003	11
4509	83.50729763678294	63.69829351535863	0.05641625852000957	147	704150	3
4510	83.58693989220319	91.4715231788084	0.0246985591737564	177	704327	1
4511	83.70483105666145	95.37605633802859	0.051388319148573766	172	704499	13
4512	83.47363598841565	60.58532423208192	0.02321513659424252	144	704643	10
4513	83.67302084065271	103.41212121212162	0.031432219144314696	177	704820	2
4514	84.14377711873269	130.748648648649	0.06540047184804852	178	704998	9
4515	84.14188320719448	83.95438596491273	0.024337711980787373	177	705175	5
4516	84.06817679342319	76.77124183006579	0.03240940957096036	179	705354	8
4517	84.03464571042048	80.7150684931512	0.02848663330078125	185	705539	12
4518	87.42709443403915	423.27951807228686	0.17856468282720095	465	706004	4
4519	87.83472419891862	128.19007092198638	0.06401468578137849	171	706175	14
4520	87.65841669202878	70.20397350993419	0.042770425686661485	191	706366	6
4521	87.60383252510849	82.20000000000041	0.024748408861752957	177	706543	7
4522	87.52352628708482	79.57320872274182	0.042701148422512075	169	706712	11
4523	87.7070602549832	105.87692307692345	0.03593560547856559	171	706883	13
4524	87.70462123138074	87.46315789473721	0.03314419924202612	177	707060	3
4525	87.375398918438	54.78238993710683	0.053357531140734264	143	707203	10
4526	87.36557633719586	86.39314079422428	0.025207705550141388	182	707385	1
4527	87.46274635779604	97.08257839721296	0.03515976198603598	178	707563	9
4528	88.09276637623246	150.4647482014394	0.07567837689373945	185	707748	2
4529	88.15097228647737	93.91335740072245	0.03104836980723802	179	707927	5
4530	87.76230071390161	49.2838150289016	0.03999420286903919	142	708069	4
4531	87.42079225784617	53.61145510835901	0.05752942297193739	144	708213	12
4532	88.08969544637883	154.31111111111184	0.07886123657226562	192	708405	8
4533	88.25402071413725	104.52222222222275	0.03242067044431513	176	708581	14
4534	87.94720405648394	57.57235494880536	0.04298082079206194	140	708721	7
4535	87.60684656700269	53.911455108359014	0.04432612615274199	141	708862	11
4536	87.92632712094051	119.55490196078483	0.059910107742656364	176	709038	6
4537	87.70792465559191	66.08608058608088	0.044633567333221436	144	709182	3
4538	87.8140800660757	98.3234657039715	0.044592031958507514	171	709353	1
4539	87.91991109640087	98.397183098592	0.04069480249437235	177	709530	13
4540	87.43692605271515	39.62140672782948	0.13565525566179729	194	709724	10
4541	87.52530856523765	96.27517730496503	0.053347035458213406	171	709895	9
4542	87.26594436847417	61.58888888888894	0.06706660783209768	147	710042	4
4543	87.11780963961833	72.45247148289003	0.08503419120839778	149	710191	5
4544	86.79524587769315	54.861433447099614	0.09793923298517863	192	710383	2
4545	86.85874169477829	93.14482758620734	0.03808444285253335	171	710554	12
4546	86.49930907659211	50.91547987616087	0.048725530079432894	140	710694	11
4547	86.26396387315013	62.964788732394574	0.034600913524627686	144	710838	6
4548	85.99411018759588	59.278595317725646	0.04947286928203744	142	710980	3
4549	86.10501523956607	97.08461538461583	0.0343978824196281	182	711162	14
4550	86.06330956877576	81.93444816053565	0.025723032612618203	183	711345	8
4551	85.87879434381044	67.61178707224403	0.09275285445432611	187	711532	7
4552	86.1982899824619	117.8283582089557	0.11364786799361067	164	711696	13
4553	86.68955619295757	135.324911032029	0.0706452564759688	176	711872	1
4554	86.42695995075587	60.429931972789106	0.025605806937584512	143	712015	9
4555	86.12936777060314	56.667741935483754	0.031124316470723758	142	712157	10
4556	86.0209295842266	75.28554913294832	0.05654753857885885	171	712328	4
4557	86.10552730592819	94.48070175438642	0.04153894165814933	177	712505	5
4558	86.44852121319678	120.40491803278738	0.0855491327684979	172	712677	12
4559	86.40003600106482	81.6000000000005	0.05567701787896495	183	712860	2
4560	86.34903564105417	81.30000000000052	0.042171268052952265	186	713046	11
4561	86.38846136855972	90.29160839160883	0.03712204827202691	180	713226	6
4562	86.49443389773127	96.98571428571468	0.048230004865069724	172	713398	14
4563	86.41223149423783	78.27419354838752	0.03241216877232427	184	713582	3
4564	86.1448499200362	59.67407407407403	0.03780831823815833	143	713725	1
4565	86.02505895508241	74.16575342465796	0.027767026817405616	182	713907	7
4566	86.01458448493457	84.9776119402991	0.043315400782319685	194	714101	8
4567	86.26855628714407	111.41176470588285	0.053203380307671744	179	714280	13
4568	86.24980963102503	84.39389067524158	0.07049659542415453	184	714464	10
4569	86.22320231969772	83.58907849829404	0.032676773275283566	187	714651	4
4570	86.23906354408916	87.80932475884282	0.06698194964901431	182	714833	5
4571	86.3500892655256	97.34163568773282	0.0652259440904253	178	715011	2
4572	86.09191933372443	60.53309608540925	0.14284880617831616	141	715152	3
4573	85.8327628522516	60.17627118644061	0.09130403211900404	143	715295	1
4574	85.73681617611004	76.23809523809578	0.08083319285559276	189	715484	11
4575	85.61144801434894	73.20000000000029	0.046402212599633445	142	715626	13
4576	85.65876490675447	90.34313725490242	0.0629343876893493	174	715800	14
4577	85.80107199452902	99.8894736842109	0.08163086975677104	158	715958	8
4578	85.44522256490632	50.21612903225793	0.04999713830544915	142	716100	7
4579	85.22964340427274	63.887306501548366	0.03479086039875047	227	716327	12
4580	85.01313178035659	63.57848101265841	0.035769557440152734	186	716513	6
4581	84.73186486933267	56.88644067796594	0.012734596158417178	142	716655	10
4582	85.15620819247033	127.166197183099	0.0767152183934262	171	716826	4
4583	86.27564611054565	197.1000000000014	0.18929847357586654	403	717229	9
4584	86.33800076055131	92.51111111111163	0.0682976078342747	185	717414	2
4585	86.01744465231687	54.28238993710683	0.1004634225690687	148	717562	3
4586	85.91717431538274	75.99041095890466	0.03015129253117725	198	717760	5
4587	85.58169558134746	52.36930091185396	0.05907726287841797	144	717904	13
4588	85.40920353528128	68.33249097472952	0.04888002839806962	146	718050	14
4589	85.17500038881737	61.98888888888897	0.05134410458011227	143	718193	8
4590	84.91317739222846	58.992700729926874	0.054055265385469946	139	718332	12
4591	84.69127638753696	62.72307692307711	0.05515091131764946	141	718473	6
4592	84.67081658533407	82.64529616724778	0.03100006697607822	183	718656	11
4593	84.64862193299425	82.45135135135179	0.04667259784454995	188	718844	1
4594	84.74894273120816	94.6807017543864	0.040951682499476845	175	719019	7
4595	85.2406987912607	133.92454873646247	0.0752165751023726	176	719195	10
4596	85.0648212151128	67.65294117647088	0.03703564160490689	146	719341	4
4597	84.82118674866614	60.70137457044675	0.04439562075846904	148	719489	9
4598	84.5027577557972	52.978287461773576	0.050482890975307414	142	719631	2
4599	84.34079784741216	68.3067669172935	0.04195626799043242	143	719774	14
4600	84.18457854818332	68.71886792452858	0.0402577561391911	142	719916	12
4601	83.82303453784941	48.03017751479276	0.03513646125793457	140	720056	13
4602	83.54514532959466	56.034113712374456	0.0483083927885015	141	720197	6
4603	83.35806078277353	64.83669064748229	0.022457683590096488	142	720339	11
4604	83.79892461939025	127.44444444444497	0.09345930991088144	169	720508	5
4605	83.59985352266254	63.89181494661946	0.015894776457673187	143	720651	1
4606	83.63248656638329	86.86315789473734	0.033921241760253906	183	720834	3
4607	83.2971393365022	50.09776357827464	0.03028615199736435	137	720971	7
4608	83.26254542658089	79.83774834437139	0.05669419298466948	194	721165	8
4609	83.09772809039626	66.78081180811836	0.04158626236282029	143	721308	10
4610	83.38851551537465	112.17647058823567	0.060827464592166064	164	721472	4
4611	83.14496369355423	59.03333333333323	0.040512709550454586	142	721614	9
4612	82.93606457926677	62.25505226480847	0.03704111726133973	143	721757	2
4613	82.74837516635083	64.1671232876715	0.050662524124671676	145	721902	14
4614	82.56156055966873	64.06691449814153	0.033665094444220015	139	722041	5
4615	82.28914748571762	55.320253164556824	0.03935216849958393	142	722183	11
4616	82.33660128773342	87.03452768729684	0.05077635335643389	171	722354	13
4617	82.01543710971848	50.22018348623841	0.03070654285897454	139	722493	3
4618	82.00187601079254	80.65932721712579	0.05429189804701777	171	722664	12
4619	82.02825069330757	84.6393442622955	0.062454280063245424	169	722833	6
4620	82.04915000455631	84.11818181818228	0.03469162095676769	176	723009	1
4621	81.81999183784409	59.13333333333323	0.05391942017467309	141	723150	8
4622	81.56042886214081	55.863694267515804	0.04365447565173426	141	723291	10
4623	81.5216827050073	77.68581314878944	0.047807154231046506	191	723482	7
4624	81.22684323644778	52.03773584905651	0.05272346606357492	139	723621	9
4625	81.00105162527535	58.64768211920515	0.03005320298756268	141	723762	2
4626	81.68725163533838	149.62105263157937	0.07500549561199657	187	723949	4
4627	81.43935322901736	56.89741100323612	0.016963258595533773	142	724091	13
4628	81.9547911985587	132.98315018315066	0.0699540969224004	171	724262	5
4629	81.86149752386125	72.62542372881403	0.03421211749949354	188	724450	14
4630	81.81408186133741	77.1199312714782	0.03511916210776881	190	724640	11
4631	81.80725100582367	81.13099630996363	0.04976701736450195	184	724824	12
4632	81.88926804800424	90.00895522388113	0.03448374100152959	181	725005	1
4633	82.07104883691196	100.06734693877601	0.035863983762133254	182	725187	6
4634	81.99759440390616	74.72560553633265	0.07508518875286144	186	725373	8
4635	82.02332074994345	84.57022900763431	0.035036907539711344	222	725595	3
4636	81.85441089573743	65.13233532934156	0.12469837229738953	186	725781	10
4637	81.86727495004537	83.14081632653108	0.03286138493964012	188	725969	7
4638	82.09497624634645	104.63740458015309	0.06519101680010214	174	726143	9
4639	81.86020597106247	58.61794871794858	0.05777922948201497	150	726293	2
4640	81.9385224781271	89.69185667752487	0.06117728605108746	177	726470	4
4641	82.06688902639547	94.7751773049651	0.05992634578417706	186	726656	13
4642	81.89544396284631	64.92238267148042	0.03911806477440728	144	726800	1
4643	81.7730634877149	69.65739644970442	0.05280868128726357	190	726990	5
4644	82.23562005006958	128.02871972318374	0.09215553971224053	172	727162	6
4645	82.07118355759809	65.79197080291998	0.03814584016799927	144	727306	3
4646	82.23325286680326	98.27811447811483	0.06151982419979498	161	727467	8
4647	82.02710961258317	61.618927444795005	0.035752378661057044	203	727670	11
4648	82.29766816945418	109.08296529968499	0.08193279715145335	170	727840	7
4649	82.42076695945777	94.60754716981175	0.049754096366263725	185	728025	10
4650	82.94129842029797	134.4739130434786	0.06891535087065263	176	728201	9
4651	82.84711799423454	73.52325581395391	0.04392471018525743	194	728395	2
4652	83.1473481129935	112.8701298701302	0.0848960650743112	169	728564	4
4653	82.98368274994475	66.78081180811836	0.08452672891683512	143	728707	5
4654	82.73253013297162	57.86842105263147	0.08320518334706624	144	728851	1
4655	82.70879798753543	80.35931558935414	0.05377567332723866	184	729035	13
4656	82.3302202715897	44.85102639296176	0.04201188052657747	137	729172	3
4657	83.54356671752247	203.6648648648664	0.13332465216723835	361	729533	14
4658	83.2658054689519	55.767441860464984	0.031950882012895546	139	729672	8
4659	83.02798951952553	59.48421052631569	0.034739217014177474	141	729813	11
4660	84.6552224448431	245.75128205128314	0.21956097091759108	362	730175	12
4661	84.49385889963996	68.51886792452858	0.03695920772022671	144	730319	7
4662	84.36706917795748	71.81488673139197	0.0486465800892223	187	730506	6
4663	84.71840565463668	119.50071684587853	0.0791668259953878	166	730672	10
4664	84.4874672728308	61.62456747404853	0.03878602385520935	144	730816	9
4665	84.20259260010249	55.9999999999999	0.02444622671003822	139	730955	5
4666	83.93143108088113	57.086440677965946	0.028466629981994628	140	731095	1
4667	83.90168034395548	80.95635738831665	0.044567518336798555	186	731281	2
4668	83.69372236404534	63.105882352941386	0.03515580381665911	140	731421	13
4669	83.58383725766875	72.70521172638475	0.03185153007507324	184	731605	4
4670	83.3103400222158	56.23411371237446	0.03178495640377346	139	731744	3
4671	83.05988610652972	58.26494845360813	0.02545762753141099	138	731882	11
4672	82.96792216609934	73.8634920634924	0.028502648706594226	181	732063	14
4673	82.92298487992223	78.4741935483875	0.02888660640506954	182	732245	8
4674	82.73073796627658	63.69829351535863	0.036349984253344896	147	732392	9
4675	82.78076861478283	87.73380281690187	0.02417783254987738	178	732570	7
4676	83.02435529483218	107.13943661971867	0.06072549819946289	160	732730	10
4677	82.9293443000234	73.52325581395394	0.023788321878492218	194	732924	12
4678	82.82368577765808	72.36349206349237	0.030982224308714574	196	733120	6
4679	82.61799944252958	62.25505226480847	0.0200624065799313	143	733263	2
4680	82.45134616566153	65.95267175572546	0.022142635169604147	141	733404	4
4681	82.17819694241551	55.13642384105946	0.033446345295939414	143	733547	5
4682	82.13281119940646	77.6396226415098	0.04185596144342997	166	733713	3
4683	82.13819449680838	82.67114093959778	0.023258744671358078	179	733892	13
4684	82.06829642280805	75.14838709677461	0.025710126741336343	183	734075	1
4685	81.88653160804616	63.891814946619476	0.033229291022240696	143	734218	8
4686	81.81596479942839	74.82985074626913	0.1238678793112437	192	734410	11
4687	82.12831806656327	113.0512915129156	0.0593221127986908	160	734570	14
4688	81.95625871261244	64.92238267148042	0.03623984919653998	144	734714	10
4689	82.09442840895088	95.77322834645722	0.04457098538758325	183	734897	9
4690	82.32929057647428	105.58064516129065	0.06241051826251329	169	735066	7
4691	82.27571008901019	76.9712418300658	0.026853539849405236	177	735243	12
4692	82.0262387024058	57.328571428571315	0.034943124226161415	140	735383	4
4693	82.01565405624554	80.96777408637915	0.04064483283668436	186	735569	6
4694	82.77333084901643	157.78333333333407	0.0855746865272522	192	735761	2
4695	82.74959754052627	80.40000000000053	0.02556156745323768	195	735956	5
4696	83.16194567158487	123.98441064638834	0.08820384956267943	166	736122	1
4697	83.18399288153569	85.36666666666721	0.02772935061531271	187	736309	3
4698	83.00834875691613	65.6195804195807	0.03779185548120616	147	736456	8
4699	82.83236671862232	65.41014492753649	0.03433829965725751	142	736598	14
4700	82.69953389392694	69.54908424908456	0.04003114896277859	146	736744	10
4701	83.50009995849645	162.75614035087762	0.07751698396643814	196	736940	13
4702	83.37872007692391	71.36211180124255	0.025134632664342082	186	737126	11
4703	83.13282988612146	58.7897009966776	0.03855120967811262	142	737268	7
4704	82.899242328001	59.77407407407404	0.04789153622909331	142	737410	6
4705	82.72507080024337	65.48208955223909	0.02209786574045817	180	737590	9
4706	82.32133622127319	42.351612903225686	0.03187792301177979	140	737730	4
4707	82.7979938268024	129.9870967741939	0.10099570477595095	183	737913	12
4708	82.606155732506	63.614184397163356	0.04380707640747924	143	738056	3
4709	82.95592176138784	117.58275862069013	0.08031191144670759	168	738224	2
4710	82.76707682948825	64.07142857142883	0.043595082230038114	144	738368	8
4711	82.53219201437062	59.278595317725646	0.0407932912799674	142	738510	13
4712	82.62887009422693	92.20000000000041	0.046137761261503575	177	738687	1
4713	82.62277563788898	82.01942446043215	0.020239176288727793	186	738873	5
4714	82.72465899262122	92.81111111111166	0.02285083309634701	182	739055	14
4715	82.48623668384515	58.88242811501583	0.03153469809170427	145	739200	11
4716	82.5843743170067	92.30000000000038	0.03579854965209961	176	739376	10
4717	82.74488541254632	98.63548387096826	0.0295523077577025	182	739558	7
4718	82.94324774723205	102.58111888111925	0.07462296662507234	162	739720	4
4719	83.14219483180352	102.83795620437999	0.04213550022670201	175	739895	9
4720	83.09750212536275	78.67292418772612	0.02537079418406767	187	740082	6
4721	83.24949893509505	98.29718309859199	0.04562026998969946	178	740260	12
4722	83.06437085221893	64.73669064748229	0.04084513737605168	143	740403	8
4723	82.78940156230139	55.56744186046498	0.0448535181951861	141	740544	1
4724	82.66366139283222	70.21538461538489	0.03341292668055821	143	740687	5
4725	83.3406722609183	150.3647482014394	0.07264560268771264	186	740873	2
4726	83.87868271622322	137.14171779141157	0.0698869526386261	192	741065	3
4727	83.88628933168394	84.6393442622955	0.03268035064787554	169	741234	13
4728	84.1254264383671	107.80000000000045	0.03076071488229852	171	741405	11
4729	84.13265493260411	84.84827586206947	0.03614862287366712	185	741590	14
4730	83.86728263164409	57.59542483660121	0.04007775346997758	142	741732	4
4731	84.24233828214885	121.37284768211975	0.06063633615320379	176	741908	10
4732	84.07629951471198	67.63846153846181	0.03668311555334862	188	742096	7
4733	84.2247789438073	98.92424242424288	0.02661659924880318	184	742280	9
4734	83.96560376162994	58.30726072607246	0.048111640231710086	142	742422	8
4735	84.53816994623587	141.22222222222288	0.09233828212903894	184	742606	6
4736	84.2917956268473	59.90073800738002	0.05928777611773947	138	742744	1
4737	83.9842783439795	53.54006734006725	0.030536307035571468	137	742881	5
4738	84.92972967818677	178.5294117647066	0.13513719376607156	199	743080	12
4739	84.62225056322309	54.18181818181804	0.02776653989613485	139	743219	3
4740	84.36720754477035	59.1179487179486	0.04747149039959085	145	743364	13
4741	84.1749900147772	65.14545454545483	0.028076885463474515	143	743507	11
4742	84.03939800936627	70.61578947368449	0.03257560203088581	181	743688	2
4743	83.74352861943653	54.45245901639335	0.06707389538104717	143	743831	14
4744	83.47970571109234	57.36123778501615	0.0639790414084851	142	743973	10
4745	83.88285089224857	123.79422382671515	0.08754177206366726	169	744142	4
4746	83.71786624949709	67.38438661710065	0.02607621846499143	143	744285	7
4747	83.73172462403916	85.10370370370426	0.02742003363531989	185	744470	9
4748	83.82900288341675	93.45955056179828	0.02511548235061321	188	744658	8
4749	83.8178138646836	82.71010101010148	0.0396314086494865	182	744840	6
4750	83.79763572603676	81.8000000000005	0.028106499772045494	181	745021	1
4751	83.86215353220051	90.24941634241299	0.077635621511808	186	745207	12
4752	83.88887727375148	86.53452768729686	0.032483071088790894	176	745383	5
4753	84.17136389533573	112.1375394321771	0.09147890548259892	171	745554	3
4754	84.63023849167651	130.0588235294122	0.09492570549778684	169	745723	13
4755	84.35668610675974	57.27499999999987	0.0440713619363719	145	745868	14
4756	84.2780666141132	76.49473684210572	0.02428328737299493	188	746056	11
4757	84.28434823170909	84.9062283737029	0.019257866321726047	188	746244	2
4758	84.30977320576784	86.82684563758431	0.04391302421079044	171	746415	10
4759	84.26428522980773	79.76097560975649	0.028639742210086454	177	746592	4
4760	83.92370120103905	50.20588235294107	0.050798773765563965	144	746736	7
4761	84.11946418902866	103.50000000000034	0.10085173351008718	164	746900	6
4762	84.51466552029275	123.63959731543673	0.08708632269570994	172	747072	9
4763	84.60611437070781	93.65955056179826	0.05165791255171581	186	747258	8
4764	84.36035254672863	60.029931972789086	0.03959898397225101	147	747405	13
4765	84.43819729712342	92.14482758620738	0.03453018125249536	181	747586	1
4766	84.80741233907757	121.35970149253781	0.07008149824946759	166	747752	5
4767	85.0927080787005	113.33698630137032	0.06030861060776396	167	747919	3
4768	84.98126817740068	73.94871794871838	0.04379223011158131	189	748108	12
4769	84.69891495508612	56.745945945945834	0.062396854373580175	141	748249	10
4770	84.57749102292657	72.55652173913072	0.04088629875983392	143	748392	7
4771	84.77748191195381	104.57657992565103	0.04661245346069336	180	748572	11
4772	84.42500496517471	49.529787234042416	0.053986321032886773	142	748714	4
4773	84.41688167608635	83.61267605633851	0.03200929061226223	184	748898	14
4774	85.28810980589037	171.5396946564893	0.09463828802108765	192	749090	2
4775	84.93743054269386	50.22018348623841	0.03240245366268021	139	749229	6
4776	85.35617062841084	126.81143911439167	0.06721242455875172	170	749399	8
4777	85.07522129997689	57.26123778501615	0.04357337951660156	143	749542	5
4778	85.34484448129889	112.03753943217711	0.05275849408881609	172	749714	9
4779	85.08983265620422	59.843661971830954	0.03330392156328474	140	749854	12
4780	85.15034069006622	91.14063604240324	0.029710769653320312	183	750037	13
4781	85.12378172761001	82.49444444444494	0.02786684826592714	181	750218	1
4782	84.82106850049784	54.85245901639335	0.029570915716157543	139	750357	14
4783	84.74848804057325	77.56302250803904	0.03405302128893264	188	750545	3
4784	84.80514253298982	90.41393728223036	0.039532467978341236	175	750720	10
4785	84.74631332988214	78.92222222222271	0.020976505436740078	182	750902	7
4786	84.79067569993903	89.18255033557095	0.042252206012030336	181	751083	11
4787	84.79872998190068	85.59610389610428	0.04573393392038869	182	751265	4
4788	84.52746623156972	57.672354948805356	0.060387878966846054	139	751404	8
4789	84.30238362223416	62.019205298013816	0.19560103155487213	201	751605	2
4790	84.19408130499916	73.4721518987346	0.018308271418560992	182	751787	6
4791	83.86782312667971	51.56826347305377	0.04440592040478344	142	751929	13
4792	84.41878125904928	138.96363636363685	0.07629645904364614	173	752102	12
4793	84.4047876910631	83.01942446043208	0.024891755797646263	176	752278	5
4794	84.43684542471352	87.61056105610606	0.03217808227965285	179	752457	9
4795	84.4114769704664	81.90000000000047	0.02630411254035102	180	752637	1
4796	84.15754168794122	59.0179487179486	0.058572599332626554	146	752783	3
4797	84.16036353133579	84.43972602739775	0.024019993268526517	182	752965	14
4798	84.28362840813315	96.48685121107306	0.037925511598587036	176	753141	10
4799	84.73499358925329	129.420146520147	0.0819340425379136	170	753311	7
4800	85.46574569417709	157.8102040816332	0.06151914596557617	176	753487	4
4801	85.40224259965143	79.1154362416112	0.04015771855306889	181	753668	11
4802	85.07068074147826	52.246056782334286	0.05377605493120152	139	753807	2
4803	84.80411186509795	58.413793103448164	0.06326191030817924	139	753946	6
4804	84.78184273341766	82.57719869706888	0.03671454341033769	183	754129	8
4805	84.5578363866204	62.3812080536914	0.05966755484237152	147	754276	5
4806	84.69703916753534	98.47811447811482	0.06579385313597864	159	754435	12
4807	84.40227130750554	55.22025316455682	0.056030353466113965	143	754578	9
4808	84.5480599151852	98.98113207547213	0.0297502245982932	179	754757	13
4809	84.19157931603335	48.899999999999885	0.03188371658325195	135	754892	3
4810	83.89718811303695	54.752459016393345	0.026194344248090473	140	755032	14
4811	83.81670010287432	75.84838709677449	0.04219914295456626	176	755208	1
4812	83.48461991856583	50.608681672025625	0.024613135001238656	136	755344	7
4813	83.77628663450932	112.65129151291562	0.06237755752191311	164	755508	4
4814	83.73891592502699	80.03921568627499	0.031985232283949186	179	755687	10
4815	83.51492244922996	61.339568345323805	0.029524799779797276	141	755828	2
4816	83.25895130692943	57.917808219177964	0.028602979166044606	139	755967	6
4817	83.64901325965819	122.2651465798051	0.05524508158365885	177	756144	11
4818	83.47734665647337	66.48235294117676	0.023699823792997773	143	756287	12
4819	83.28428747562292	64.17142857142882	0.021669044361247884	143	756430	5
4820	83.67430174372384	122.28571428571468	0.08051498683952016	169	756599	13
4821	84.23350609470766	139.5947368421057	0.07264861431750623	182	756781	8
4822	84.03853794023541	64.73669064748229	0.027972268057869863	143	756924	14
4823	84.03752135515931	83.93687943262468	0.041944376965786546	188	757112	9
4824	84.0102731257347	81.31269841269881	0.04820792815264534	170	757282	3
4825	83.68093229923926	51.076190476190334	0.032356789062073184	143	757425	7
4826	83.92002493703119	107.59019607843186	0.03582247723354382	178	757603	1
4827	83.69707036240136	61.62456747404853	0.03232820828755697	144	757747	10
4828	83.53352823020592	67.34285714285741	0.03382042476109096	147	757894	2
4829	83.41041875435548	71.22258064516159	0.027780783803839432	190	758084	4
4830	83.55116072065807	97.48461538461581	0.04262600587994865	178	758262	6
4831	82.95969974636289	24.40506329113967	0.05857876141866048	180	758442	11
4832	83.05025291954773	92.01501706484687	0.04167836172538891	171	758613	5
4833	83.14442932011814	92.46789297658916	0.03510495250144701	178	758791	12
4834	83.37650626243818	106.35212355212406	0.03141024795889157	171	758962	14
4835	83.48962231869493	94.68811188811227	0.030414486489100764	171	759133	8
4836	83.26415075304223	60.94246575342468	0.05345064443308157	143	759276	7
4837	83.12466714024865	69.31578947368459	0.030035906231280454	194	759470	13
4838	83.25335150332893	95.99310344827634	0.036340306707694704	177	759647	3
4839	83.38356976134529	96.27517730496503	0.03801065857647455	171	759818	1
4840	84.02551144889085	147.57773851590147	0.09065432133881943	184	760002	10
4841	84.9382750609937	175.30187265917658	0.11486071632021949	231	760233	9
4842	85.63848466707168	154.95923566879043	0.15410530507861087	201	760434	2
4843	86.17904718882201	139.6947368421057	0.08194615696016597	181	760615	6
4844	85.85017979385685	53.292307692307595	0.033401856055626504	143	760758	12
4845	85.94195785939951	95.02798634812335	0.0645860127040318	175	760933	5
4846	85.6243564626237	54.18181818181804	0.06102159211961485	139	761072	7
4847	85.42186289799746	65.37500000000028	0.03946647694501927	189	761261	11
4848	85.5300695563738	96.24252873563265	0.03903779419519568	186	761447	8
4849	86.04506025153854	137.02913907284824	0.08567946150496199	185	761632	14
4850	85.94855559496911	76.39459459459499	0.03938827461959249	181	761813	13
4851	85.91240738841702	82.33373493975978	0.33126605107234075	260	762073	4
4852	86.53675718212867	148.34738675958235	0.0868201661617198	188	762261	3
4853	87.07389665256092	140.25070422535262	0.10578178700821175	181	762442	1
4854	87.06288232371648	85.9724637681164	0.06803847865054483	190	762632	10
4855	87.44547447426208	125.32209737827759	0.10868301617323294	169	762801	2
4856	87.12623924171459	55.52195121951204	0.10574809107287177	145	762946	6
4857	86.71938648785165	46.44096385542156	0.03798214014429246	137	763083	11
4858	87.03555758647678	118.33649635036537	0.0831340996615858	166	763249	12
4859	87.09946844659818	93.42664359861628	0.06137898356415505	172	763421	5
4860	87.15392203799426	92.54482758620736	0.14107670757056628	177	763598	7
4861	87.11438281761433	83.20000000000087	0.05153014150898108	267	763865	9
4862	87.0368272247323	79.35882352941212	0.044382081790403885	176	764041	8
4863	86.93383990486595	76.73809523809571	0.09100061914195186	184	764225	14
4864	86.99188405615287	92.73825503355752	0.0726323953553951	179	764404	13
4865	87.53496521559136	141.3000000000005	0.1287606967392788	186	764590	4
4866	87.50394889676878	84.43333333333378	0.07101564204439204	188	764778	1
4867	87.13011124266347	50.12018348623841	0.0556882551738194	140	764918	11
4868	87.05720468805997	79.83945578231338	0.044869764603395514	187	765105	10
4869	86.72224429166481	53.56116504854357	0.09698022162164008	143	765248	12
4870	86.91097712031367	105.59552715655022	0.0885916317210478	221	765469	3
4871	86.68024535598339	63.83780068728548	0.0978034253152001	151	765620	5
4872	86.66715718813785	85.37142857142902	0.041250015490621496	181	765801	7
4873	86.30065739539756	50.017177914110334	0.0979080667028894	143	765944	8
4874	86.10315615952187	66.55053380782947	0.07170755612222772	152	766096	14
4875	86.07383888364095	83.17142857142912	0.09384522649454953	203	766299	9
4876	87.22410049480455	201.1000000000012	0.20320655239952934	288	766587	2
4877	86.98700133382813	63.514184397163355	0.06239140695995755	144	766731	11
4878	87.47153968061846	135.44083601286215	0.10306024551391602	188	766919	4
4879	87.2799706252757	68.3146341463417	0.06116192817687988	200	767119	13
4880	88.44018461765307	203.30136986301474	0.11919011171103248	329	767448	6
4881	88.77963991433369	122.38571428571467	0.07846338975997198	168	767616	10
4882	88.65821575493798	76.63722397476386	0.03671836053858922	179	767795	1
4883	88.58373260728959	81.20990099009944	0.06395704732776361	177	767972	12
4884	88.57172506845073	87.38297872340483	0.03351191868857732	189	768161	5
4885	88.25729353205193	57.12857142857128	0.024123146500385984	142	768303	7
4886	87.95067484509742	57.59542483660121	0.03252399807244959	142	768445	8
4887	88.01898764551864	94.78195488721856	0.022738834999127096	179	768624	14
4888	87.936715750136	79.79179810725596	0.025002258449959354	179	768803	9
4889	87.37185583901146	31.450724637681475	0.05733083981519554	171	768974	2
4890	87.10499052294217	60.68532423208194	0.04477993091503223	143	769117	4
4891	86.81462482823906	58.06842105263147	0.037535230878373266	142	769259	10
4892	87.01004648119125	106.35679012345713	0.08397337969611673	170	769429	11
4893	86.69314854802491	55.320253164556824	0.031689650575879594	142	769571	13
4894	88.48303524436282	265.68181818181733	0.3155756585391951	324	769895	3
4895	88.58217672290512	98.39718309859198	0.039820113424527445	177	770072	1
4896	88.8975600838812	120.12051282051326	0.05059978094967929	176	770248	6
4897	88.70206331040396	69.3478827361567	0.03368157824954471	185	770433	12
4898	88.54160789469123	72.65652173913071	0.04410227923326089	142	770575	8
4899	88.19781457023532	54.16227544910168	0.038211188904226645	146	770721	5
4900	87.8753578969256	55.9521472392637	0.034440777219575024	145	770866	7
4901	87.71774605023982	72.11417322834676	0.05276240242852105	144	771010	4
4902	87.3748097472937	53.42411575562691	0.033485613550458634	140	771150	9
4903	87.90486479942706	140.38031496063036	0.06877381380866555	170	771320	2
4904	88.43392215849994	140.81060070671418	0.07275612973376533	181	771501	14
4905	88.11626035626978	56.667741935483754	0.03185674506174007	142	771643	3
4906	88.07898853769002	84.38907849829401	0.028647236317895643	179	771822	11
4907	88.5804823402564	138.22836879432685	0.06904854747535145	177	771999	13
4908	88.39213648341918	69.74589665653522	0.04234784027266372	183	772182	10
4909	88.35495010091715	84.67349823321594	0.03449717483951547	177	772359	1
4910	88.35550621046904	88.41056105610602	0.05770647595500388	171	772530	6
4911	88.27771224051453	80.57610921501758	0.031722316325036554	183	772713	12
4912	88.14519117347271	75.02560553633263	0.24779160296330688	183	772896	8
4913	88.02518607024862	76.14468085106441	0.025548939827160957	195	773091	5
4914	88.82736683365962	168.2432624113483	0.11696402880610252	196	773287	7
4915	88.93018223414894	99.10890688259165	0.027751430050357358	182	773469	4
4916	88.62877742177423	58.7897009966776	0.040844729248906524	142	773611	14
4917	89.03477536184221	129.22857142857185	0.06889504995959544	171	773782	9
4918	88.80062341241958	65.6195804195807	0.02627800922004544	147	773929	13
4919	88.55233146400968	63.971428571428824	0.01736560525565312	145	774074	10
4920	88.4989824612962	83.21743119266097	0.0416712842204354	176	774250	2
4921	88.37693858262918	76.29459459459501	0.023910360021905584	182	774432	3
4922	88.420280307914	92.71111111111166	0.02173066530071321	183	774615	11
4923	89.02480477756214	148.8727272727278	0.07498634317533566	183	774798	6
4924	88.82704757227735	69.24908424908458	0.0360304365222086	149	774947	5
4925	88.50347508313176	56.46979865771798	0.021693428643315815	139	775086	7
4926	88.69783106077726	107.9390728476828	0.08640850663750092	211	775297	1
4927	88.55630759966782	74.54548494983331	0.04176321531596937	190	775487	12
4928	88.35530974106244	68.45652173913071	0.048286360243092415	184	775671	8
4929	88.02612088206241	55.43642384105946	0.0494333096912929	140	775811	4
4930	87.74590914320645	60.00494699646636	0.04553935882893014	141	775952	14
4931	87.42832545113541	55.987539936102095	0.03661059661650322	142	776094	9
4932	87.09327201028864	53.92298136645951	0.07616880723646471	143	776237	11
4933	87.39208929018577	116.97500000000042	0.08726712044952922	173	776410	13
4934	87.47290068074847	95.47322834645723	0.05483183809505996	186	776596	10
4935	87.78153663744463	118.33649635036537	0.11314781602606716	166	776762	3
4936	87.69432782844724	79.06065573770546	0.05817954738934835	192	776954	2
4937	87.39365499041435	57.62704402515713	0.06440325959088052	146	777100	6
4938	87.07292097215577	55.320253164556824	0.03147138340372435	142	777242	5
4939	86.8184374371747	61.62456747404853	0.047998375362820096	144	777386	7
4940	86.51593048215778	56.56774193548375	0.04251334050318578	143	777529	1
4941	86.26934693491197	61.85757575757586	0.03645787031754204	138	777667	4
4942	85.95358497241216	54.69315068493139	0.01706263966804003	137	777804	14
4943	86.15707070542184	106.30215827338162	0.04886063989603295	159	777963	8
4944	86.51636131223624	122.08613138686171	0.0754420771743312	165	778128	9
4945	86.24047042638661	58.92727272727257	0.020592901828515267	137	778265	13
4946	85.9499301289024	57.18644067796595	0.03106362871128878	139	778404	11
4947	85.71736065217478	62.69298245614051	0.04426987303627862	144	778548	3
4948	85.48007593454192	61.98888888888897	0.04354983776599377	143	778691	6
4949	86.48645818173244	186.1183006535957	0.24154412655429985	262	778953	12
4950	86.46374428484663	84.21506849315102	0.1243536631266276	150	779103	7
4951	86.42455980367065	82.54529616724784	0.03038178319516389	184	779287	2
4952	86.83701690833665	127.6702702702706	0.05678849356515067	175	779462	1
4953	86.57171898259931	60.307224334601415	0.07391208151112431	184	779646	5
4954	86.81420814197966	110.82063492063585	0.06819910208384196	240	779886	10
4955	87.36696928636633	142.09032258064553	0.0859491637864038	191	780077	4
4956	87.00676539154827	51.346579804560136	0.08225265558618698	137	780214	9
4957	86.9278521000489	79.1154362416112	0.0373696016343259	181	780395	14
4958	87.41303511750995	135.4461538461545	0.07104733993446892	183	780578	8
4959	87.10260275291203	56.36979865771798	0.04145989758627755	140	780718	13
4960	87.34280749461368	111.12307692307722	0.094015795713777	157	780875	11
4961	87.11096150921979	64.15820895522417	0.026640569064634065	141	781016	6
4962	87.63001607323208	139.01641791044827	0.053794551979411735	176	781192	3
4963	87.35276538246443	59.90494699646634	0.038179572199431945	142	781334	12
4964	87.07507983390295	59.584210526315694	0.030933638981410435	140	781474	2
4965	87.08039970694202	87.60706713780961	0.029284005608063577	183	781657	7
4966	87.14170682098371	93.21111111111155	0.03924697972415538	178	781835	1
4967	86.48610793459207	21.58181818181866	0.07869963473584278	166	782001	4
4968	86.83033872803766	120.90918727915228	0.08139309996650332	168	782169	10
4969	86.61336867409062	65.13333333333357	0.016830976496743894	181	782350	5
4970	86.69011610623083	94.2881118881123	0.03987427575247628	175	782525	14
4971	86.62091191486549	79.76969696969734	0.0402316099021867	171	782696	8
4972	87.15579482025672	140.10920245398825	0.17353306903740284	193	782889	9
4973	87.12878073170327	84.4543859649127	0.04063985514086346	172	783061	11
4974	87.85020721010054	159.27142857142923	0.08486146728197734	192	783253	13
4975	87.51031678848497	53.86116504854357	0.02599048784800938	140	783393	3
4976	87.96658996468615	133.1376344086026	0.07880339319306302	173	783566	6
4977	88.27935081663165	119.24267515923613	0.06389388171109286	176	783742	2
4978	88.50103497169557	110.4477663230245	0.0975893549172275	166	783908	7
4979	88.18488902875828	56.88644067796595	0.08109162558971995	142	784050	5
4980	87.89788224373385	59.48421052631569	0.05941186052687625	141	784191	14
4981	88.08142723082034	106.25238095238191	0.09301956300813008	246	784437	12
4982	87.79885620175538	59.824324324324266	0.05411710010634528	144	784581	8
4983	87.75153562392757	83.0667984189729	0.03761363272764245	196	784777	1
4984	87.74909093906639	87.50706713780961	0.03907365384309188	184	784961	4
4985	87.63504683818638	76.3446808510644	0.030438529395068865	193	785154	10
4986	87.79838264431433	103.96862745098086	0.04083805901663644	175	785329	11
4987	87.37261915685424	45.22203389830496	0.02918635777064732	140	785469	3
4988	87.07461651477377	57.57235494880536	0.022957612786974224	140	785609	6
4989	87.03238386313954	82.85135135135178	0.04412157120911971	184	785793	9
4990	87.32263964234255	116.05796178343995	0.04821944778615778	176	785969	13
4991	87.06513022705121	61.571698113207624	0.03054870038792707	138	786107	7
4992	86.77912252339661	58.46435986159159	0.0649920659707793	141	786248	5
4993	86.44875065300134	53.741935483870854	0.056963731916688326	139	786387	14
4994	87.0668947254187	148.26315789473725	0.12668419867446742	194	786581	2
4995	86.80365043569877	60.742465753424675	0.03877044217339878	145	786726	4
4996	86.54171229199751	60.6098360655738	0.04548609337839139	147	786873	12
4997	86.82602114772523	114.97259786476914	0.12363426943859422	166	787039	1
4998	87.49745481379901	153.96938775510245	0.09730648748653452	194	787233	8
4999	87.18015468426567	55.76744186046498	0.06667002671056514	139	787372	9
5000	86.83408484474009	52.573170731707165	0.05287379688686795	144	787516	6
5001	87.32615576099857	136.04117647058865	0.10310258184160505	168	787684	11
5002	87.93156087005525	147.86666666666704	0.1592891713514685	187	787871	10
5003	87.82509141520086	77.28461538461583	0.05126928753323025	180	788051	3
5004	87.60296199637595	65.61214953271055	0.0510979528012483	184	788235	13
5005	87.60059904307886	87.36666666666709	0.09166209283703101	167	788402	7
5006	87.53459305264808	81.00000000000031	0.07545931387267657	149	788551	4
5007	87.62377825765275	96.45311355311401	0.041545898774090935	170	788721	14
5008	87.40473627927203	65.71958041958071	0.08420054553306267	146	788867	1
5009	87.40344055046624	87.27516339869325	0.04217663753864377	172	789039	2
5010	87.9585677611232	142.91616161616216	0.10187823798066827	186	789225	5
5011	87.97721619722435	89.82341137123794	0.056426288091648395	171	789396	12
5012	88.15521326602135	105.77692307692345	0.05199305401291958	172	789568	8
5013	88.01617870524612	74.25175718849884	0.048950643487315364	183	789751	9
5014	88.07820532399077	94.21884057971056	0.04841665161980523	180	789931	10
5015	88.70552707697924	150.81038062283793	0.1830590709841629	221	790152	11
5016	89.3386320849551	152.01602787456508	0.13967010877790495	221	790373	6
5017	89.30817717204778	86.29314079422429	0.03909060212432361	183	790556	3
5018	89.07569310147673	66.0597701149428	0.06054801540774899	143	790699	4
5019	88.99108685539348	80.61506849315118	0.062246445686586445	186	790885	13
5020	88.81448533935752	71.33093525179886	0.05355447410737108	149	791034	1
5021	89.15978310891477	123.34426229508242	0.09585449530643488	159	791193	5
5022	89.08967878431913	82.14935064935105	0.023922049480935802	184	791377	14
5023	89.79672773291006	159.79457364341138	0.10531516697095789	184	791561	2
5024	89.51731097822903	61.85505226480842	0.05813387137691991	147	791708	8
5025	89.59096365241888	96.88257839721292	0.07393275896708171	180	791888	12
5026	89.88335298496686	118.8298969072174	0.06656530335193545	254	792142	7
5027	89.58681877484509	60.22993197278909	0.08139327476764548	145	792287	3
5028	89.59985967800573	90.89090909090956	0.03668112517720428	181	792468	10
5029	89.63912751721183	93.52664359861629	0.062120950710006624	171	792639	11
5030	89.67284735315083	93.01111111111163	0.030741728676689995	180	792819	6
5031	89.6605406483268	88.44217687074864	0.05640595340164455	169	792988	4
5032	89.36793524184353	60.39999999999998	0.032328520150020204	145	793133	12
5033	89.6966047266344	122.23488372093061	0.07029416394788165	172	793305	1
5034	89.85240791013729	105.27692307692348	0.057713864213329254	177	793482	5
5035	89.76464492318608	81.07610921501754	0.024581113558137014	178	793660	2
5036	90.19777040377879	133.07719298245658	0.05172573779262392	177	793837	14
5037	89.89353344048175	59.77407407407404	0.059944999050086656	142	793979	7
5038	89.80759810607694	81.30000000000045	0.0467826166460591	186	794165	8
5039	90.25426125545096	134.4739130434786	0.08774068680676547	176	794341	3
5040	90.55390614289645	120.21875000000043	0.10478510507723181	164	794505	11
5041	90.27377785587827	62.541077441077626	0.07408122758607606	148	794653	6
5042	89.96438689812872	59.33468208092467	0.03294907846758442	186	794839	10
5043	91.63670599211041	257.19629629629657	0.19569936899038462	390	795229	9
5044	91.6094756228368	88.91366906474869	0.04392577479125331	189	795418	4
5045	91.63167534513603	93.82944785276115	0.10753133369214607	165	795583	12
5046	91.36358241839947	64.82238267148043	0.08727586680445178	145	795728	14
5047	90.97573640313267	52.578980891719624	0.08580428110042089	142	795870	2
5048	90.73987456148942	67.38955223880627	0.028933881080313903	146	796016	8
5049	90.59689223816191	76.44164222873935	0.10350039928634731	173	796189	1
5050	90.98151155107442	129.0588235294123	0.07951713007921613	179	796368	5
5051	93.75626053812776	368.45641025640856	0.22680256063703724	417	796785	13
5052	93.38003906987024	56.13411371237446	0.026354680742536274	140	796925	6
5053	93.65732172415423	121.10830449827026	0.08851428919060286	172	797097	3
5054	93.38546935496922	66.47208480565395	0.0331794193812779	147	797244	10
5055	93.10481046561533	65.3195804195807	0.06393906911214192	150	797394	9
5056	92.93613460070681	76.23722397476384	0.041589017774237964	183	797577	11
5057	92.86083553843676	85.40622837370285	0.047926188818092554	183	797760	4
5058	92.52841285080483	59.618566775244204	0.09237703524137798	152	797912	14
5059	92.28954478069093	68.64160583941633	0.09394505149439762	152	798064	1
5060	92.66652030062596	129.9870967741939	0.08076903859122855	183	798247	12
5061	94.03320644897106	229.33513513513643	0.22733960477847617	307	798554	7
5062	94.41780986835232	132.4935483870972	0.07941807321755283	166	798720	5
5063	94.63090111951401	115.72693498452055	0.06272981345998069	173	798893	2
5064	94.60897465865445	92.4382550335575	0.06654369438087547	182	799075	8
5065	94.64976812374672	98.68832116788364	0.06672979990641276	180	799255	13
5066	94.31389113216443	61.062068965517284	0.0473258706177173	147	799402	6
5067	93.93197757295546	56.12253521126751	0.05916197870818662	142	799544	11
5068	93.81460224167036	82.19444444444494	0.04047868303630663	184	799728	3
5069	93.56695812039435	69.05019011406871	0.053483325037462955	145	799873	4
5070	93.331642280687	70.03537414966019	0.05563545227050781	183	800056	9
5071	92.95377030232459	55.54444444444431	0.040884933609893356	138	800194	1
5072	92.65901037707913	63.477777777778	0.046711632903193086	142	800336	7
5073	92.47177321448481	73.93529411764733	0.04401963193651656	142	800478	8
5074	92.11273290169481	56.56774193548375	0.044507553527405215	143	800621	12
5075	92.28374149500796	109.21359223301023	0.07207185417942746	169	800790	14
5076	92.2510147811649	89.01107011070162	0.02670934346801076	179	800969	5
5077	92.2810357688844	95.25311355311406	0.049154496454930564	182	801151	13
5078	92.35860263539485	100.0377224199293	0.06905948771217654	173	801324	6
5079	92.38129647252214	94.62798634812337	0.03773270505766629	179	801503	11
5080	92.04973854135397	59.225503355704575	0.02529199534449084	145	801648	3
5081	92.41981794774931	129.0576791808879	0.05000383203679865	176	801824	4
5082	92.4176197682718	92.20000000000037	0.04122572430109574	177	802001	9
5083	92.15626710000086	66.28235294117677	0.018409964133953224	145	802146	7
5084	92.49515152797697	126.04470989761143	0.07180636428123296	172	802318	1
5085	92.17283399962531	60.263398692810455	0.04501634030728727	148	802466	14
5086	93.9044389929624	265.3333333333332	0.2554339406358221	379	802845	10
5087	93.64858328227807	68.31886792452858	0.06631209099129455	146	802991	5
5088	93.51769072162654	80.55932721712577	0.09988771482955577	172	803163	8
5089	93.44405926895574	86.15454545454597	0.05767305692036947	192	803355	12
5090	93.40328534293286	89.36666666666704	0.03612820492234341	172	803527	13
5091	94.80195519220625	233.27027027027194	0.1619419625134972	369	803896	2
5092	94.68192165427021	82.79860139860185	0.021446632694553686	185	804081	6
5093	94.62328482766462	88.81823899371116	0.052231152852376304	180	804261	11
5094	94.45501294034894	77.79609609609648	0.034861315737713824	182	804443	3
5095	94.47233132305617	96.18685121107306	0.03596253634831093	179	804622	9
5096	94.55572922194682	102.81212121212164	0.025723793467537302	183	804805	1
5097	94.41376520189861	80.35932721712578	0.047423296961291085	174	804979	14
5098	94.25585057146237	78.62230215827384	0.025738682435906452	184	805163	7
5099	94.8675388189945	155.42467532467592	0.11189661122331715	198	805361	4
5100	94.46993273773525	55.10693069306917	0.03850888867750236	141	805502	12
5101	94.31666438678889	79.14309764309812	0.026120455368705418	184	805686	10
5102	93.97123848366175	59.77407407407404	0.042212422464934875	142	805828	13
5103	93.81642576437697	78.48996655518447	0.036372881868611213	184	806012	5
5104	93.40081846875852	52.25569620253151	0.04514321536882549	141	806153	2
5105	93.21977106838466	75.29607843137286	0.05119274435816584	148	806301	6
5106	93.14082335770081	85.3250000000004	0.050529075881182134	177	806478	11
5107	92.90912361120868	69.97084870848738	0.04633359651307802	148	806626	14
5108	94.08299836149116	210.29659863945656	0.36838884752279694	311	806937	8
5109	94.18489841589907	104.27300380228185	0.04651615385375271	173	807110	4
5110	94.25770160565312	101.46521739130472	0.1075225724114312	180	807290	9
5111	94.3961245895966	108.10000000000039	0.08515073004223052	168	807458	1
5112	94.45463393193593	100.24705882352981	0.05372795479835114	173	807631	12
5113	94.40632170632895	89.62341137123792	0.050573591552028764	173	807804	7
5114	94.07484789323918	61.25894039735101	0.05379170984835238	148	807952	2
5115	94.36115823783621	122.70588235294157	0.06072391419721073	169	808121	5
5116	94.26733595311671	84.97892976588682	0.041920108179892265	186	808307	10
5117	94.15164860757156	82.69860139860184	0.03456118286296885	186	808493	13
5118	94.64583715746707	143.5705035971228	0.06683060363098815	182	808675	6
5119	94.3592395917532	65.98608058608087	0.08902339277596309	145	808820	8
5120	94.3249379759775	90.92907801418495	0.049619972390472576	189	809009	11
5121	94.48329423002055	110.16056338028207	0.08600566748416785	165	809174	9
5122	94.48921306076998	95.0751773049651	0.0468251431574587	183	809357	14
5123	95.81577059459183	227.14496644295414	0.17036201366479847	345	809702	3
5124	96.00449178137947	114.68788927335675	0.08050079117278139	167	809869	1
5125	95.87799072321481	83.35438596491275	0.050776137680303854	183	810052	4
5126	96.18747376418983	126.8262948207176	0.09436330506295869	165	810217	7
5127	96.30959902654794	108.4000000000005	0.07882366758404356	165	810382	12
5128	95.95392769381671	60.742465753424675	0.07727857129327183	145	810527	2
5129	95.64261224359333	64.82238267148043	0.04498238727964204	145	810672	5
5130	95.57630904474544	89.01229235880433	0.08577171591825264	172	810844	10
5131	95.24495672870876	62.441077441077624	0.06200021065321545	149	810993	6
5132	95.19784678406319	90.53396226415143	0.06027701053213566	188	811181	13
5133	94.77628767106127	53.04193548387086	0.050211462256026594	146	811327	9
5134	94.72161434658946	89.30895522388113	0.05871952848231539	188	811515	8
5135	94.26606672680045	49.16685236768791	0.0922699361234098	148	811663	4
5136	94.75344114725175	143.00350877193023	0.1359516623241654	183	811846	3
5137	94.69733530720781	89.1428571428575	0.08592808046820444	179	812025	7
5138	94.56895169772547	81.8589743589747	0.025592203797965216	174	812199	1
5139	95.40137414986019	177.8111969111976	0.14467547567267167	190	812389	14
5140	95.3774715194727	93.01111111111153	0.062205992804633244	180	812569	2
5141	95.00583473531246	58.21379310344817	0.12276783395320812	141	812710	6
5142	94.79100894609888	73.52325581395391	0.04217181254907982	194	812904	12
5143	94.62532107886013	78.22222222222274	0.06010237194242932	189	813093	5
5144	94.39852241352608	71.94545454545525	0.04589902665879991	225	813318	11
5145	95.07322949708313	161.86923076923114	0.11216410170210168	188	813506	10
5146	95.02191293244938	89.94157303370817	0.07810692016236083	167	813673	13
5147	94.59134440553453	51.96506024096371	0.0687659223314742	142	813815	8
5148	94.53172305769911	88.62920962199358	0.04911488629458995	178	813993	9
5149	94.24826498205171	66.18591549295805	0.052010348054016525	147	814140	7
5150	94.50960362500686	120.38212927756705	0.07646071620103789	164	814304	1
5151	94.3150075887568	75.0500000000005	0.05380969406456076	186	814490	4
5152	93.92294565876588	55.108814589665506	0.04946984725744546	147	814637	11
5153	94.13788503334706	115.41688311688348	0.07535102692517368	176	814813	3
5154	94.79482735089681	159.83211678832183	0.150284590544524	189	815002	6
5155	94.76899018849896	92.21111111111168	0.05170195153419008	188	815190	12
5156	94.59220439620302	77.09041095890463	0.03882188847995697	187	815377	2
5157	95.13445066907268	148.81683168316889	0.13934726321820132	194	815571	14
5158	94.92756101188029	74.44548494983333	0.03470098785080835	191	815762	5
5159	94.52610930113255	54.78238993710683	0.046092953715291055	143	815905	13
5160	94.48256750636685	90.1719298245619	0.023977403382997257	185	816090	10
5161	94.18796565801799	65.02238267148041	0.05930959261380709	143	816233	9
5162	94.16252137558746	91.64353741496635	0.036823520883482105	171	816404	8
5163	93.72778373579608	50.68875739644957	0.05830850134362708	143	816547	4
5164	93.31115846641394	52.06525679758297	0.05203650547907902	143	816690	11
5165	93.18519756668131	80.7150684931512	0.025111466485100823	185	816875	7
5166	93.64868865670793	139.53430656934356	0.0665335958403659	173	817048	1
5167	93.29288598066717	58.068421052631464	0.05404219157259229	142	817190	12
5168	93.00267140657479	64.27142857142881	0.030198688238439426	142	817332	6
5169	92.63152009187006	55.8875399361021	0.03858731676648547	143	817475	2
5170	92.30464151066965	59.943661971830956	0.038418920777684495	139	817614	13
5171	92.35442087953508	97.28257839721294	0.0481158820065585	176	817790	14
5172	92.250292006203	81.94153354632626	0.02948282746707692	170	817960	5
5173	91.98371053629202	65.59214501510601	0.15359655511442316	189	818149	10
5174	92.31636097541309	125.24875444839907	0.07233471589929917	170	818319	9
5175	92.01500944619588	62.1812080536914	0.035742202861197045	149	818468	11
5176	91.75005515592973	65.5195804195807	0.06616469331689782	148	818616	1
5177	91.91455460437044	108.20000000000032	0.08065850720434131	167	818783	4
5178	91.54877329673732	55.336423841059464	0.02706897512395331	141	818924	12
5179	91.13448739863233	50.12018348623841	0.047416159084865024	140	819064	2
5180	91.86642030242379	164.32777777777855	0.1083028170527244	196	819260	8
5181	91.56115178285279	61.339568345323805	0.017280527885923994	141	819401	13
5182	91.28420941000569	63.86691449814151	0.016312397963611794	141	819542	14
5183	91.72899147697946	135.76241610738307	0.0949171427133921	185	819727	6
5184	91.39986822887633	58.81666666666653	0.02721883910042899	140	819867	5
5185	92.95521853987617	246.93489932886035	0.17085332021663327	382	820249	3
5186	92.57286888612298	54.72025316455682	0.05013283523353371	148	820397	10
5187	93.03901157989841	139.18713826366627	0.16736542551141037	247	820644	7
5188	92.64889597390335	54.027450980392054	0.0310843040203226	145	820789	11
5189	92.27781971257701	55.541269841269745	0.06316324019096267	142	820931	1
5190	91.93472572597756	57.96842105263147	0.05562761613539049	143	821074	4
5191	91.57237846871779	55.699999999999896	0.04945717395191461	142	821216	8
5192	91.25409130374892	59.74366197183094	0.03935686070868309	141	821357	2
5193	90.93181612497716	59.02657342657332	0.04364501846420182	143	821500	13
5194	90.71465585846424	69.21578947368458	0.039003743880834336	195	821695	9
5195	90.44888730675245	64.13780068728549	0.04562250021341685	148	821843	6
5196	90.297345802106	75.29473684210579	0.03317942142486572	200	822043	12
5197	90.10138231086233	70.70099667774126	0.04564258535072286	189	822232	14
5198	90.22303747730075	102.26689895470416	0.09291065997958924	161	822393	3
5199	90.01550175901629	69.46946564885523	0.034639179706573486	144	822537	7
5200	89.87479354993677	75.94468085106443	0.020740615534903434	197	822734	5
5201	89.56152969087051	58.54840764331198	0.04277575832523712	146	822880	10
5202	89.26854838088991	60.263398692810455	0.022823159759109084	148	823028	11
5203	88.9195535877717	54.36906906906892	0.03472313488999458	146	823174	1
5204	88.70969618139038	67.93381294964058	0.041617244279303515	147	823321	13
5205	89.12485318783045	130.22539682539738	0.08972786412094579	165	823486	8
5206	89.0795324910037	84.59278350515513	0.047466666802116066	184	823670	4
5207	89.25333866985306	106.46015037594036	0.05058942522321429	175	823845	9
5208	89.01419901137753	65.33937282229991	0.04269360522834622	147	823992	6
5209	88.79944163664837	67.5384615384618	0.03739332522034014	189	824181	2
5210	89.17557431058289	126.4127090301009	0.06959683082007259	173	824354	12
5211	89.9920517690581	170.8233201581032	0.10378340457348113	188	824542	14
5212	89.88786333859494	79.57320872274182	0.06459639622614934	169	824711	7
5213	89.92584957007386	93.68648648648686	0.04216774170008083	177	824888	10
5214	89.88754212332418	86.09510489510538	0.02847659779104957	187	825075	5
5215	89.94442726547122	95.57605633802858	0.06951193529016832	170	825245	11
5216	89.8437329928165	79.87500000000034	0.05986454077726285	169	825414	1
5217	89.72981290426765	78.4517241379315	0.02796939214070638	180	825594	13
5218	89.85306194503629	102.05471698113253	0.03542126378705425	186	825780	8
5219	90.1873673911597	123.28360655737757	0.06969734755429355	176	825956	4
5220	90.09008687314164	80.45931558935413	0.03565322896821903	183	826139	6
5221	90.52121349581917	133.20274914089396	0.09515382990490791	179	826318	9
5222	90.45193239534375	83.5931034482769	0.04352156426819456	301	826619	3
5223	90.26746518865416	72.00521172638474	0.023445718575522537	191	826810	2
5224	90.33958123444204	97.4790697674424	0.029209980990159957	187	826997	12
5225	90.02689273917078	59.070731707316924	0.05386340958731515	140	827137	7
5226	89.68126075445423	55.463694267515805	0.0471096893836712	145	827282	5
5227	89.65707972585706	87.26315789473723	0.0426082584445037	179	827461	14
5228	89.65163185218653	89.11229235880434	0.03967862380178351	171	827632	10
5229	89.33238597391623	57.72704402515714	0.05261807606138032	145	827777	1
5230	89.31348388288455	87.4421768707487	0.02642439730340542	179	827956	11
5231	89.30464114027565	88.4292096219936	0.020797899034288195	180	828136	8
5232	89.31162721984762	90.00324909747337	0.026909057910625752	182	828318	4
5233	89.07246416402342	65.39532163742714	0.023922618806670983	193	828511	13
5234	89.44668486000377	126.49453376205827	0.0822497942171044	181	828692	6
5235	89.18000282153032	62.778481012658325	0.03809188567486006	194	828886	9
5236	89.23648265679626	94.82798634812336	0.03897148337067857	177	829063	3
5237	89.22678449689495	88.26666666666709	0.020800572275464002	183	829246	2
5238	89.34901852458518	101.4501872659181	0.023032641801677765	183	829429	7
5239	89.78365568016329	132.8127340823974	0.10451153185240616	169	829598	10
5240	89.87368091197955	98.78617886178914	0.042434275777716385	190	829788	5
5241	89.68156951002588	70.66254071661294	0.03160420952969965	237	830025	12
5242	89.36975381492562	58.499999999999744	0.05926074268661927	214	830239	14
5243	89.26925052138068	79.3194244604323	0.04441144880554486	213	830452	11
5244	89.4253238154234	104.87657992565103	0.031124583745406845	177	830629	8
5245	89.53977780160376	100.87072243346054	0.03595716149143919	169	830798	13
5246	89.55234723670249	90.79672131147585	0.04550367421497499	173	830971	4
5247	90.04677113275652	138.99473684210565	0.08090302284727706	188	831159	6
5248	89.92471743416782	77.84140127388574	0.03128399090333418	176	831335	9
5249	89.94971531911467	92.42450592885444	0.058346722460440384	221	831556	3
5250	89.70448132381827	65.42631578947406	0.026838347911834717	200	831756	2
5251	89.90456778471138	109.71312741312794	0.05197025429118763	176	831932	10
5252	89.70709265901151	70.15705521472422	0.02580752092249253	187	832119	7
5253	89.68065331136876	87.06315789473732	0.02479106945227523	181	832300	5
5254	89.656598412242	87.27516339869325	0.073016039160795	172	832472	12
5255	89.83278154472737	107.2749116607777	0.10435302125895682	163	832635	11
5256	89.84198004506958	90.75263157894774	0.04095597994529595	177	832812	14
5257	89.88167135572999	93.81111111111159	0.0320322596749594	172	832984	4
5258	89.84578605011494	86.29314079422429	0.027577968243041324	183	833167	8
5259	89.72822785516563	78.08996655518449	0.0374450277774892	188	833355	13
5260	91.18682019435099	235.5874617737022	0.15742850863317928	426	833781	1
5261	91.2340274641056	95.9075471698117	0.03445134606472282	172	833953	6
5262	91.01310324785871	69.14160583941634	0.06129847416261427	147	834100	2
5263	90.69790769925109	59.49354838709668	0.04659741218775919	146	834246	3
5264	90.41115939148935	62.02307692307704	0.036097520106547584	148	834394	10
5265	90.1922086367353	68.51608391608423	0.02491991816003338	153	834547	5
5266	89.87276023457848	58.2473684210524	0.030810346881162774	206	834753	9
5267	90.44905835570536	147.50257234726732	0.09257435312076491	196	834949	7
5268	90.7573982806229	121.28305084745801	0.06175607984716242	176	835125	12
5269	91.48478128706398	163.49569892473173	0.07377545535564423	192	835317	11
5270	91.89295019660136	132.3016722408033	0.0764796588960932	181	835498	14
5271	91.88116301673273	90.7142322097383	0.02664453795786654	178	835676	4
5272	92.53716388656541	157.48125000000053	0.050610589457082224	182	835858	8
5273	92.56259926524362	95.08070175438638	0.05093107725444593	171	836029	6
5274	92.58578029013505	94.8807017543864	0.04920533902383264	173	836202	1
5275	93.25098426329548	159.10617760617825	0.06388215915016505	184	836386	13
5276	93.72850208864672	141.00276679841934	0.09938900891472312	170	836556	2
5277	93.69765244190992	90.64353741496639	0.04997884634449996	181	836737	10
5278	93.68278702860195	92.21111111111169	0.03501149441333527	188	836925	5
5279	93.22895915831593	48.29999999999987	0.0499139001183476	141	837066	7
5280	93.39401941193401	109.73498452012426	0.07112696017438208	171	837237	9
5281	93.10830304452946	64.82238267148043	0.043938807783455686	145	837382	11
5282	92.50147403337678	32.42540192926086	0.16231912215125752	187	837569	12
5283	92.18653520063377	61.00759075907591	0.04968219834405023	148	837717	14
5284	91.76373726435777	49.90674157303359	0.03858188080461058	146	837863	4
5285	91.47351066612497	62.74107744107764	0.048968729907519194	146	838009	13
5286	91.54924614769901	99.04705882352994	0.03558783144564242	185	838194	8
5287	91.67269118622202	103.89375000000044	0.04662325786568268	171	838365	2
5288	92.31717617027059	156.1211895910786	0.07384716755635029	185	838550	6
5289	92.09657309866373	70.25686900958492	0.03796754207910667	191	838741	1
5290	91.73930535425427	56.36979865771798	0.05014310564313616	140	838881	7
5291	91.49575616688274	67.38438661710065	0.054892086482548216	143	839024	9
5292	91.33003116335345	74.92325581395389	0.032604342036777076	180	839204	10
5293	92.60598168784034	218.9250836120421	0.23113329998858564	385	839589	3
5294	92.42780317659992	74.78813056379852	0.04115196138794659	171	839760	5
5295	92.13358396836334	63.005882352941384	0.04562970425220246	141	839901	12
5296	91.86285923979082	65.06111111111139	0.036326940367821935	147	840048	4
5297	91.4834604610575	53.9229813664595	0.041594682039914434	143	840191	14
5298	90.96392744374852	39.530158730159286	0.07821931938330333	192	840383	11
5299	90.64362150264436	58.93333333333323	0.05420035915774899	143	840526	8
5300	90.27954354306964	54.23582554517124	0.04092009638396787	142	840668	6
5301	90.27117948018795	89.44313725490247	0.03160359168964657	183	840851	13
5302	90.04289625681466	67.4428571428574	0.05273984229727967	146	840997	1
5303	90.06973373023268	92.72664359861633	0.033000868791974454	179	841176	2
5304	90.22680562369959	105.77692307692345	0.06042729976565339	172	841348	9
5305	89.91779260101964	59.325503355704576	0.057055897182888456	144	841492	3
5306	89.61355015888041	59.49354838709668	0.0195499985185388	146	841638	5
5307	89.50861335436002	79.11986970684087	0.03017366254651869	185	841823	7
5308	89.44579715946674	83.2269938650311	0.03755704251081584	179	842002	10
5309	90.00570282423571	145.43636363636415	0.0784507614472953	181	842183	12
5310	90.06643583158055	96.07900355871935	0.02149510248906195	177	842360	14
5311	90.0324102565347	86.66387832699681	0.028703701677661255	197	842557	4
5312	89.96532239992405	83.32362459546968	0.05683748256525344	169	842726	6
5313	90.10190447004246	103.62352941176513	0.026448209177364002	176	842902	1
5314	90.54404384118362	134.31584158415924	0.08372507890065511	240	843142	11
5315	91.0742678978858	143.56644951140132	0.07003723581631978	192	843334	13
5316	91.63781093319267	147.42857142857227	0.06800665915261751	239	843573	8
5317	91.55916966596601	83.77368421052672	0.017196464275128276	181	843754	2
5318	91.16618262046914	52.26046511627895	0.05348354208058324	145	843899	3
5319	91.05228188641463	79.77610921501763	0.026206326110200732	191	844090	9
5320	91.51120062599205	136.9441558441563	0.07647058304319991	188	844278	5
5321	91.34864706129058	75.25584415584458	0.03332425685639077	188	844466	7
5322	91.37026850434674	93.51079136690691	0.025420439309914018	179	844645	12
5323	91.29722404715137	84.06582278481048	0.04544576287966723	171	844816	14
5324	91.24300374466435	85.87519379844994	0.1291250667056522	148	844964	6
5325	91.73524996621052	140.46762589928142	0.054519622680173824	249	845213	10
5326	91.89289746654842	107.50000000000038	0.05850220822739875	174	845387	1
5327	92.21975010107833	124.57816091954061	0.129185656497353	190	845577	4
5328	91.96615543694698	66.86028368794355	0.04970868319681246	146	845723	2
5329	91.80022882233655	75.37349397590401	0.02246351881400167	179	845902	11
5330	91.80790546387908	92.56789297658915	0.03725204629413152	177	846079	8
5331	91.41299802640201	52.317161716172166	0.08531952892560415	193	846272	13
5332	91.11498764746689	61.61196013289042	0.042375746227446054	147	846419	9
5333	91.15617110432557	95.23333333333373	0.06011932161119249	180	846599	3
5334	90.83787512754803	59.32657342657334	0.0449775082724435	140	846739	5
5335	90.8264528980117	89.69565217391349	0.028163110137616517	189	846928	7
5336	90.73009617045003	81.19078014184448	0.039946201112535266	180	847108	12
5337	90.88056443951476	105.77692307692345	0.031912024631056676	172	847280	6
5338	90.65925277102323	68.74939759036174	0.022885799407958984	185	847465	14
5339	90.89466024331301	114.20000000000047	0.02988535940310376	177	847642	4
5340	91.40830268197577	142.25890410958954	0.09316440295147639	186	847828	1
5341	91.31832066525703	82.4101010101015	0.03666417147662188	185	848013	2
5342	91.44726287114572	104.21254125412608	0.1042367926141097	211	848224	10
5343	91.61166615484302	107.88759124087629	0.14888960086040615	161	848385	9
5344	91.47181439395685	77.62649006622563	0.03293216684476925	183	848568	11
5345	91.4739866609762	91.68904109589087	0.02377311299356182	178	848746	13
5346	91.0957393759688	53.64925816023727	0.03551823188518656	145	848891	3
5347	90.9762129586401	79.14309764309813	0.03061402362325917	184	849075	8
5348	91.39451794314768	132.80671140939648	0.06493236478521021	181	849256	5
5349	91.78884549098893	130.82727272727308	0.07438369592030843	168	849424	7
5350	92.20078853791055	132.98315018315066	0.07671108022767897	171	849595	12
5351	92.22591422653868	94.7133574007224	0.03773568805895353	171	849766	6
5352	92.1863473919656	88.26923076923116	0.05788808581472813	174	849940	14
5353	92.1836267751888	91.91428571428618	0.07065437439291235	187	850127	4
5354	92.35994840217376	109.81578947368462	0.10186368663136552	164	850291	1
5355	92.8297774895806	139.34285714285764	0.08534999351716985	177	850468	10
5356	93.10505016142018	120.35704467353999	0.10405846764059627	170	850638	11
5357	92.49326763366219	31.926797385621484	0.11018498047538426	184	850822	2
5358	92.55330678831147	98.49718309859198	0.06508295644413341	176	850998	13
5359	92.6081900773057	98.04163568773278	0.054978415282846194	171	851169	8
5360	92.20243694365593	52.032876712329255	0.0794389545917511	192	851361	9
5361	92.9075943924012	162.7181818181823	0.1345288828799599	190	851551	3
5362	92.99082614078488	101.23076923076965	0.029700431077839942	179	851730	7
5363	92.72177703430661	66.08591549295805	0.03572873811464052	148	851878	6
5364	93.54808867572827	175.35294117647126	0.1262333958419328	194	852072	12
5365	93.37310778897098	76.05000000000038	0.06936938112432306	176	852248	14
5366	93.405245223192	96.58685121107304	0.05827139173235212	175	852423	1
5367	94.97912763686047	250.79348659003907	0.313851965798272	288	852711	5
5368	94.88834582421427	85.90094637224018	0.053686384338041696	181	852892	4
5369	95.06222707185448	112.27647058823567	0.12862828026519962	163	853055	10
5370	95.31991514596353	120.83103448275911	0.20740906210506663	170	853225	11
5371	95.6952124980004	132.84965034965077	0.13504361558234554	174	853399	13
5372	95.51941473543651	78.11543624161128	0.046467291747088205	191	853590	2
5373	95.69103359621224	112.68130081300853	0.222639271289627	173	853763	3
5374	95.57533359235345	84.12103321033268	0.06198164555414809	191	853954	9
5375	95.39702386545248	77.74436090225625	0.06302291065005201	199	854153	8
5376	95.44629605104039	100.32424242424278	0.24764657862046185	170	854323	6
5377	95.29748741151765	80.56543209876577	0.10667320377918897	181	854504	7
5378	95.0371943555843	69.26818181818217	0.06262960790950346	187	854691	12
5379	94.63368646036682	54.68640483383674	0.11597445221985278	147	854838	4
5380	94.56946029687016	88.21107011070164	0.05902032801174225	187	855025	14
5381	94.70668418919927	108.29184952978102	0.0949981128468233	170	855195	1
5382	94.91723378566344	115.76164383561694	0.08523234135687015	177	855372	5
5383	94.86309393878153	89.50324909747339	0.05639128251509233	187	855559	10
5384	95.0481019885634	113.36389891696786	0.08337596546519886	165	855724	11
5385	94.75663851253742	65.90175438596519	0.09609246416156794	147	855871	2
5386	94.52573378154739	71.66616541353413	0.09243402026948475	147	856018	9
5387	94.46409210209491	88.36156583629942	0.048702396330286245	183	856201	13
5388	94.44113011083985	92.16789297658914	0.059728985991925825	181	856382	8
5389	94.8667728637855	137.0054054054058	0.07026162694712154	183	856565	3
5390	94.83551149557168	91.74063604240321	0.03195082939277261	177	856742	6
5391	95.07232304728264	118.5166666666672	0.09413581235068184	168	856910	7
5392	94.98638911446868	86.47892976588673	0.044859060767101264	171	857081	12
5393	94.64262358397973	60.60983606557379	0.05779793797707071	147	857228	14
5394	94.31344302288042	61.724567474048534	0.04722355795906974	143	857371	10
5395	94.06605153936007	69.57429467084665	0.03212051233533996	181	857552	4
5396	93.80276378382311	67.73727598566336	0.04471529346622833	146	857698	2
5397	93.69577373996985	83.10375939849676	0.04261644551011383	183	857881	1
5398	93.51458255309281	75.57665505226527	0.028745034466619076	184	858065	5
5399	93.35071258963086	77.1275862068969	0.045106692747636276	176	858241	11
5400	93.34844709942229	93.12416356877374	0.036277674586395095	183	858424	9
5401	93.24073461539875	82.57719869706888	0.03281431250233468	183	858607	13
5402	92.89148599940349	58.31587301587292	0.060434550455171765	146	858753	8
5403	92.57616054338295	61.35894039735101	0.06057194301060268	147	858900	3
5404	92.2144732413547	56.407430340557156	0.04496351229090269	147	859047	6
5405	91.77447390953462	48.21454005934707	0.035583605085100445	140	859187	7
5406	91.45406574001856	59.73365695792874	0.04342721586358057	146	859333	12
5407	91.15214577227356	61.2620689655173	0.04996757507324219	145	859478	2
5408	91.19376130085219	95.31369863013745	0.04994151267138394	176	859654	14
5409	91.17874225461892	89.69185667752487	0.06795710224216267	177	859831	10
5410	91.13430010894571	86.73452768729683	0.0625237432019464	174	860005	4
5411	90.84498413488328	62.202702702702865	0.04938528754494407	154	860159	5
5412	90.65108501817213	71.45507246376842	0.029529198922746167	183	860342	1
5413	90.87363666799041	112.9062500000004	0.14456678186572572	159	860501	3
5414	91.49496255811985	153.00622568093428	0.049224331892656355	181	860682	11
5415	91.8792760904334	129.92631578947405	0.06057925224304199	180	860862	9
5416	92.19626153964579	123.57782101167359	0.09578321619731624	164	861026	6
5417	92.7914121317965	151.71132075471746	0.06606329282124837	180	861206	8
5418	92.75505321552586	89.15552050473232	0.04486807717217339	180	861386	13
5419	93.27004403675406	144.25413533834643	0.056712310438211254	173	861559	7
5420	92.87984359638652	54.24999999999988	0.05357772774166531	144	861703	12
5421	92.52133087470837	57.02857142857132	0.05342357475440819	143	861846	2
5422	92.5407739233496	94.46563573883198	0.07278333391462054	154	862000	14
5423	92.4003255337096	78.4959349593499	0.06214822218722145	149	862149	5
5424	92.2600722783725	78.37500000000043	0.045551875363225525	184	862333	10
5425	92.23002676063611	89.25552050473232	0.04966381009064573	179	862512	4
5426	92.5055941973099	119.786770428016	0.07057931818113737	163	862675	1
5427	92.74887158867014	116.83333333333384	0.09388234557175054	164	862839	3
5428	92.49281144421202	67.14285714285741	0.06224017815301882	149	862988	8
5429	92.77635471024128	120.84713804713843	0.07350770492999874	171	863159	11
5430	92.8028638904116	95.42727272727315	0.041920356972273004	172	863331	6
5431	92.8049463626186	93.01111111111156	0.0334735631942749	180	863511	13
5432	92.7731310127048	89.62341137123792	0.047798801708772695	173	863684	7
5433	92.99682075520934	115.14210526315856	0.06686000912277787	216	863900	9
5434	93.01798953395863	95.11369863013746	0.03869633728198791	178	864078	12
5435	92.84040695405528	75.25973154362467	0.03234847899406187	186	864264	2
5436	93.57006401988592	165.8061135371184	0.06109701429094587	175	864439	14
5437	93.25859414891784	62.423076923077076	0.06686133808559841	144	864583	10
5438	93.19855366197412	87.2545454545459	0.04111705432280651	181	864764	1
5439	93.45250032874421	118.5932203389834	0.07952905124461157	169	864933	3
5440	93.5217710243815	100.37956989247355	0.059503110607018635	178	865111	6
5441	92.91954065590983	33.29873417721569	0.0819890268387333	186	865297	11
5442	92.80572273279444	81.53774834437128	0.03567815500464143	177	865474	7
5443	93.4242798399375	154.66143344709963	0.09001023287600186	193	865667	13
5444	92.89698440995917	40.69473684210581	0.06883668899536133	172	865839	12
5445	92.84944313728815	88.14285714285762	0.03962759492258546	189	866028	9
5446	92.53619438065574	61.52456747404852	0.03539914755985655	145	866173	14
5447	92.5452354219238	93.44029850746323	0.05560456669848898	184	866357	2
5448	92.65401836182221	103.42352941176513	0.08678205897299092	178	866535	10
5449	94.48341316272409	275.5934984520113	0.3336683737265097	370	866905	5
5450	94.31786474538256	77.92857142857189	0.11632499487503715	184	867089	1
5451	94.25377934551717	87.90932475884284	0.05688153577772952	181	867270	3
5452	95.81097788646716	249.97363344051558	0.3003876281907354	361	867631	4
5453	96.3194931076025	146.66250000000048	0.06835987664371557	173	867804	6
5454	95.89241272761005	53.61145510835902	0.06672410832511054	144	867948	11
5455	97.74116743245072	280.7678832116782	0.30871754307900706	403	868351	8
5456	97.82175575812622	105.8000000000005	0.04990297391269747	181	868532	13
5457	98.28383577839963	144.02975778546752	0.11994062887655722	185	868717	12
5458	98.76574294032889	146.47455197132666	0.15813516919078724	183	868900	7
5459	98.78943261836363	101.13471074380213	0.08622502767911522	186	869086	14
5460	98.68117707544997	87.96387832699672	0.10063227363254713	184	869270	9
5461	98.98603946199884	129.1674157303375	0.09790981383550734	168	869438	10
5462	98.91112024384944	91.49411764705931	0.048648074348980094	187	869625	2
5463	98.58572988946749	66.37208480565396	0.039738036490775445	148	869773	1
5464	98.81282534647833	121.29527559055161	0.09450248392616831	164	869937	3
5465	99.14995111230617	132.52540192926085	0.0840373065020587	185	870122	5
5466	98.93119716331329	77.27455621301804	0.04386644418529003	173	870295	11
5467	99.51444857196185	157.2563380281696	0.1334806636055523	187	870482	4
5468	99.11454732948548	59.52432432432425	0.03201968329293387	147	870629	7
5469	98.76493232214045	64.15304659498233	0.058143517742418264	146	870775	14
5470	98.66671157034763	88.94285714285758	0.10677151126756194	181	870956	8
5471	99.24643041955643	156.63859649122844	0.13636288158396348	187	871143	13
5472	98.81994022539322	56.597411003236125	0.05218976119468952	145	871288	2
5473	98.42849406989254	59.67532467532456	0.06343282149142067	149	871437	1
5474	98.32122960700931	87.70204778157046	0.03794865608215332	180	871617	10
5475	98.59042756734948	125.24102564102645	0.06268131497349193	253	871870	12
5476	98.23950622682958	63.49829351535861	0.05305332145434898	149	872019	11
5477	97.74377783122796	48.6666666666672	0.07702980041503907	180	872199	3
5478	99.0149326455083	224.85925925926094	0.3259582741962577	343	872542	6
5479	98.85673247159559	83.19491525423771	0.04202157518138056	184	872726	5
5480	98.70526745711066	83.71023102310278	0.03917182973913244	185	872911	4
5481	98.33344555177032	61.52307692307698	0.07725648319019991	153	873064	13
5482	98.40345437983471	105.33432835820946	0.03396139845336225	177	873241	8
5483	98.22249446290205	80.30746268656756	0.09624523352522876	181	873422	7
5484	97.83959068615624	59.93211678832182	0.11189185248480903	189	873611	14
5485	97.47381546894985	61.2620689655173	0.09244273613239157	145	873756	2
5486	97.3855934432926	88.65161290322615	0.134715527464441	177	873933	1
5487	97.15093081740986	73.9193308550189	0.21881715874922902	152	874085	12
5488	100.81780229215387	463.8380782918123	0.37703247807452067	414	874499	9
5489	100.53468676923234	72.50625000000056	0.08172254713754805	189	874688	11
5490	100.40616968877406	87.6829787234048	0.0441627553714219	186	874874	3
5491	100.38652828174139	98.44202898550759	0.059305048536980286	174	875048	5
5492	100.39931517283702	101.66521739130471	0.06485961528306597	178	875226	4
5493	100.01901432880096	62.36923076923114	0.12732572140900986	184	875410	8
5494	99.7588768170919	74.00526315789513	0.07122669219970704	180	875590	2
5495	100.20813684617185	144.68487972508663	0.09569549560546875	236	875826	13
5496	101.99605547771013	278.99999999999886	0.2704123080133678	334	876160	10
5497	101.91320603404415	93.71111111111156	0.12459191559367097	173	876333	1
5498	101.96135699257164	106.72830188679283	0.06226724958689199	177	876510	9
5499	103.61248609365569	267.074267100977	0.2712093177208534	325	876835	6
5500	103.19048397640145	61.412274368231124	0.07127265663413734	143	876978	3
5501	102.76021312356555	60.16339869281044	0.06186219029778602	149	877127	5
5502	103.36512712136216	163.25161290322632	0.08323490290351994	181	877308	11
5503	102.9222618033258	59.07859531772564	0.054099202156066895	144	877452	4
5504	102.82144217036716	92.84029850746326	0.20382531818590666	190	877642	2
5505	104.70189441533016	290.8666666666661	0.5112995393469888	357	877999	14
5506	104.92040693970833	126.55314685314738	0.4457123633658532	202	878201	8
5507	105.01131811194695	114.01152416356918	0.05356897115707397	160	878361	10
5508	105.38416310573243	142.29581749049487	0.13740883535043352	173	878534	1
5509	104.94895783831147	61.86363636363642	0.038585788673824735	144	878678	6
5510	104.48973399419408	59.02657342657332	0.06602934190443346	143	878821	9
5511	105.9477330943816	250.28964401294618	0.31640139291452807	344	879165	12
5512	105.7489916124944	86.07358490566081	0.0434222627769817	176	879341	13
5513	105.23031987818763	53.88181818181803	0.05928830697502888	142	879483	3
5514	104.79359243698151	61.55757575757584	0.036485898579266055	141	879624	5
5515	104.36220703525979	61.655052264808404	0.031314987464239136	149	879773	4
5516	103.9216996602477	60.3114695340507	0.13579197030849557	189	879962	11
5517	106.78744379438724	390.4961130742022	0.31303910406601637	511	880473	7
5518	106.35828364215766	63.87142857142881	0.0571116421320667	146	880619	2
5519	105.8277131514151	53.3012345679011	0.047081204118399785	145	880764	8
5520	105.31596061006488	54.65245901639335	0.046597359028268365	141	880905	10
5521	104.84493893499871	58.21379310344817	0.05066436064158771	141	881046	1
5522	104.5215054186646	72.50158730158762	0.04561110256480522	147	881193	12
5523	104.08271502201221	60.64246575342467	0.04695845630070935	146	881339	9
5524	104.49625150815572	145.43636363636415	0.07182582307257046	181	881520	14
5525	104.09565589954899	64.4366906474823	0.04394710227234723	146	881666	3
5526	103.68334722787745	62.86478873239457	0.035307976295208106	145	881811	5
5527	103.55240426654758	90.58905109489099	0.04504651211677713	188	881999	13
5528	102.69081237727444	17.39321533923342	0.07763569732832779	183	882182	6
5529	102.50829769612466	84.43934426229549	0.07611575321844447	171	882353	4
5530	102.7599779700468	127.67632508833958	0.09361767908285933	171	882524	11
5531	102.22877760725596	49.63994169096197	0.03990599844190809	144	882668	7
5532	101.67071943843416	46.42296072507542	0.027171407672141094	139	882807	12
5533	101.92197450820078	126.79622641509468	0.08122412941672585	165	882972	8
5534	101.47770901148478	57.49542483660121	0.04063236796772563	143	883115	1
5535	101.7382077834389	127.52758620689704	0.07191875369049781	172	883287	2
5536	101.67484632416122	95.40206185567058	0.04328411251473027	179	883466	10
5537	101.99618236796186	133.8084507042258	0.0635749271937779	175	883641	9
5538	101.94175167981338	96.553113553114	0.13029626699594352	169	883810	5
5539	101.8278834587899	90.55492957746527	0.04217936026083457	185	883995	14
5540	101.53403141547926	72.44267912772624	0.036010707362314286	178	884173	3
5541	101.10317517775758	58.44840764331198	0.04808679892092335	147	884320	13
5542	100.60888331037306	51.673988439306214	0.05251237648684962	147	884467	6
5543	101.01835185431851	141.55573770491864	0.09381864447342722	190	884657	4
5544	101.77138784797044	176.3219512195127	0.08021871291379877	187	884844	11
5545	101.48956285837963	73.58888888888922	0.05576190195585552	152	884996	2
5546	101.13552638472541	66.08591549295805	0.039334078092832826	148	885144	8
5547	100.72788810201024	60.37169811320755	0.06295801798502604	150	885294	1
5548	100.6051253500224	88.45161290322618	0.035074449784262884	179	885473	7
5549	100.78861831420924	118.9544217687078	0.0956721025354722	170	885643	12
5550	100.3794853778204	59.87532467532458	0.035894760469190115	147	885790	5
5551	100.75150602219719	137.58154981549868	0.06399672293249582	173	885963	9
5552	100.57837557735984	83.438461538462	0.04483697149488661	180	886143	10
5553	100.83203892056235	125.94470989761143	0.06491973083143289	173	886316	3
5554	101.19007191481539	136.63533834586522	0.0719268623439745	174	886490	13
5555	101.05826444325567	88.00932475884284	0.05569062762790256	180	886670	14
5556	100.87568179882311	82.80000000000037	0.09698731718007585	171	886841	6
5557	100.79360391060077	92.66789297658912	0.05314176732843572	176	887017	11
5558	100.35174217490032	56.60743034055715	0.07677235438905913	145	887162	12
5559	100.27288111053963	92.46563573883205	0.051678575318435144	174	887336	8
5560	100.24299845328039	97.2846153846158	0.04068399005466038	180	887516	2
5561	100.23303905698288	99.24705882352988	0.03135807527219012	183	887699	1
5562	99.97423105447275	74.35223880597049	0.04693260571814531	151	887850	5
5563	99.58417691597103	60.96881720430108	0.05820620227867449	142	887992	10
5564	98.95673320506376	36.83980582524333	0.07683836447226035	185	888177	7
5565	98.48762644083646	52.04605678233429	0.05418268839518229	141	888318	14
5566	98.3487501764281	84.60000000000036	0.05743481754477507	153	888471	6
5567	98.24021808867656	87.49554140127428	0.04383002417428153	175	888646	9
5568	98.29752808491156	103.97121771217765	0.0293368215614793	177	888823	13
5569	98.3538492467502	103.92964426877518	0.025960038159344646	185	889008	3
5570	98.32307131766298	95.27605633802858	0.031062881381525468	173	889181	11
5571	97.81630963103503	47.64690265486712	0.03492345608456034	142	889323	2
5572	97.58665786158552	74.85113268608467	0.04040602275303432	189	889512	8
5573	97.79030901346613	117.95177304964591	0.07556247140119175	167	889679	10
5574	97.76833695781423	95.59310344827635	0.027255593083840048	181	889860	5
5575	97.71665358823608	92.60000000000036	0.0445237325106053	173	890033	7
5576	97.60579084982209	86.63037974683583	0.043626400037000405	177	890210	9
5577	97.48152223898273	85.17892976588682	0.051994344462519104	184	890394	6
5578	98.69729808188502	219.0591065292105	0.3374080958802617	317	890711	12
5579	100.87457038408503	316.42452830188535	0.2576296617084904	514	891225	4
5580	101.10918638237186	124.33617021276683	0.2226652495715083	245	891470	14
5581	101.57087190370716	147.2777385159015	0.098455612672204	187	891657	11
5582	101.56336929154031	100.8206106870233	0.04880055613901423	174	891831	2
5583	101.27585647774579	72.81208791208824	0.07305630366007487	150	891981	10
5584	100.8121042221166	54.9006309148264	0.0969993339644538	144	892125	5
5585	100.92945153432582	112.54683544303835	0.10854308368169774	171	892296	7
5586	103.59759046608151	367.7433447098948	0.27655832076508446	383	892679	1
5587	103.2211738834546	65.95593220339009	0.10681662216685177	153	892832	6
5588	104.76703906769697	257.80769230769187	0.24738030100977698	344	893176	3
5589	105.11840238488517	139.90337078651726	0.08668195581160529	173	893349	9
5590	106.71106378690382	264.38454258675034	0.2926394289190119	352	893701	13
5591	106.52437491774228	88.04217687074865	0.04240410038501541	173	893874	4
5592	106.31461392718555	85.54827586206939	0.1022989187347755	178	894052	12
5593	106.94482072909017	169.33529411764746	0.08622379505887945	188	894240	14
5594	106.88770826187147	101.23357400722061	0.06447877776756715	178	894418	11
5595	106.6907865932655	87.19554140127428	0.05597916613803821	178	894596	2
5596	107.06950034895446	144.56216216216274	0.07844253540039063	175	894771	5
5597	106.7396866511029	74.08813056379852	0.041547997613971155	178	894949	10
5598	108.57059590704084	289.8306122448971	0.206367305067719	366	895315	8
5599	108.77742399814964	129.2534050179216	0.06362223625183105	176	895491	7
5600	108.2784357113454	58.878595317725626	0.06886884610946864	146	895637	9
5601	108.11654176519085	92.08904109589085	0.05909237368353482	174	895811	6
5602	108.282816063851	124.74397163120622	0.10539761711569394	170	895981	3
5603	107.87686096822797	67.68730650154826	0.04141754574245877	189	896170	13
5604	107.83580453566746	103.77121771217764	0.04469478330132681	179	896349	4
5605	108.1073590378393	134.99125475285226	0.11391442242790671	170	896519	14
5606	108.66302014133846	163.67346938775552	0.11183379283502473	199	896718	12
5607	109.39526395567312	181.88740157480373	0.15606125364912318	188	896906	11
5608	109.07621098166823	77.48996655518451	0.053323603167976304	194	897100	2
5609	109.02767109407377	104.22222222222275	0.041626112421131664	179	897279	5
5610	109.2959749074776	135.85805243445736	0.08880102634429932	176	897455	10
5611	108.79219464558231	58.91794871794858	0.10579228563373591	147	897602	9
5612	109.02032825468206	131.60555555555615	0.07255740599198775	176	897778	3
5613	108.68749206074283	75.73670886075993	0.045352027054232455	191	897969	8
5614	110.86530679530779	326.46896551723916	0.2525533112002091	355	898324	1
5615	111.04634664074054	128.9692913385831	0.17606542196618505	166	898490	14
5616	111.16445460290456	122.85714285714334	0.2711517295645709	199	898689	13
5617	112.441849202783	238.90391459074854	0.41527581983996975	279	898968	7
5618	112.56301574476879	124.5585034013611	0.13975448961611148	216	899184	4
5619	113.75428881312756	231.69032258064587	0.26490126787605933	295	899479	6
5620	113.42753474487206	81.07888198757806	0.05002332519698929	182	899661	11
5621	113.2771055512695	98.3846153846157	0.11907860795421714	169	899830	5
5622	113.55252989805567	140.8195402298855	0.1780831718444824	200	900030	2
5623	113.40187959907512	98.48750000000052	0.09629762300881006	186	900216	3
5624	113.13008636699415	86.22255639097821	0.09712993941118013	227	900443	1
5625	113.10290144535318	110.41159420289887	0.16513364592944185	163	900606	14
5626	112.82436249712482	85.24900662251694	0.15911974383227398	173	900779	7
5627	112.35131467634939	65.51958041958069	0.1628830626204207	148	900927	6
5628	113.29493865333173	206.71371237458322	0.5643177521534455	273	901200	8
5629	114.93570856504401	277.37192982455997	0.20531563560802715	313	901513	9
5630	117.97108794148741	418.4736462093834	0.262685076921111	363	901876	12
5631	117.60937706207254	81.80000000000038	0.0691040629181414	181	902057	4
5632	116.9946787898441	56.139549839228195	0.11222268466291757	145	902202	2
5633	118.83278086188051	300.80488599348456	0.26600205967192014	346	902548	10
5634	119.08017136312085	143.57183098591602	0.22345400117134137	183	902731	5
5635	118.87400601312602	98.46363636363682	0.04172721873508411	178	902909	3
5636	118.73656239568251	105.12964426877511	0.12778417774707596	173	903082	14
5637	120.18491472044363	263.57179487179434	0.1980303006294446	312	903394	13
5638	120.32900979634677	134.59442231075744	0.1242357242607071	167	903561	8
5639	120.1006144352254	97.48947368421099	0.05060933710454584	182	903743	7
5640	119.79803966342217	89.84313725490243	0.04877824090712563	179	903922	9
5641	119.50358558257743	90.35263157894775	0.05813505899840297	181	904103	12
5642	119.4919146902553	118.33649635036537	0.12253768185535109	166	904269	10
5643	119.79187530874866	149.48797653959014	0.2958979350764577	205	904474	6
5644	122.07025067330821	347.6294117647037	0.23621754857952226	383	904857	11
5645	122.00683388086085	115.72857142857195	0.11249822542812284	181	905038	4
5646	122.22915015743686	144.23846153846188	0.08926967132923215	172	905210	5
5647	123.32636026357953	231.9501607717049	0.3447637423663072	284	905494	1
5648	122.72348181995433	63.03851590106024	0.0591478021177527	146	905640	14
5649	122.00071703330053	50.44700315457476	0.15961980580085486	199	905839	3
5650	122.39063293989061	160.99230769230854	0.31319335708044527	266	906105	2
5651	122.0067550802426	84.00284697508953	0.06328503873335753	191	906296	9
5652	121.52848009909962	74.1792569659447	0.35854286275884156	186	906482	6
5653	120.86220160725689	54.9006309148264	0.11769188774956597	144	906626	3
5654	122.034922248527	238.13426573426656	0.3161581698330966	275	906901	8
5655	123.41297843144713	259.84054054054025	0.2614733378092448	306	907207	13
5656	123.11211508311882	93.32664359861627	0.194496441438708	173	907380	2
5657	123.89187312691851	201.08791946308804	0.77003744619864	270	907650	12
5658	123.46944790214285	81.64935064935106	0.8040290307746363	189	907839	14
5659	125.20588626444982	297.11328413284025	0.26627332736284304	312	908151	7
5660	125.8773757889021	192.3548387096781	0.7548998864609956	269	908420	10
5661	126.43493536434643	181.6333333333345	0.357481246604059	266	908686	1
5662	126.35075267736964	118.01666666666722	0.20499556877709538	173	908859	9
5663	127.9038869416407	281.6641791044754	0.23941201678777146	354	909213	11
5664	129.24400061459718	261.9152542372877	0.1988340105329241	329	909542	5
5665	128.53811044767951	58.65498392282948	0.06524486290781122	152	909694	13
5666	127.90854015401354	65.58108108108136	0.08270157157600701	154	909848	10
5667	128.1487835195967	151.93287671232923	0.1261040965716044	192	910040	8
5668	127.80150706651455	93.42113821138265	0.23148640975576315	203	910243	6
5669	126.97427987463728	45.07878787878823	0.28624028838082644	178	910421	12
5670	126.6725370758909	96.80000000000052	0.05751521425097401	191	910612	7
5671	130.57366666696402	516.7854961832023	0.5937651952107748	480	911092	4
5672	130.2337633336277	96.58333333333383	0.09595361635005674	179	911271	1
5673	130.47164248350822	154.02167832167902	0.12176944795718864	242	911513	2
5674	131.04940309047527	188.24770318021282	0.4178437906153062	272	911785	3
5675	131.1605757262372	142.1666666666673	0.16198499085473234	244	912029	14
5676	131.20682071524348	135.78507462686616	0.11155610335500617	171	912200	11
5677	130.93680619936623	104.20536912751722	0.14733338789506392	165	912365	5
5678	130.48578341424553	85.83452768729688	0.12378452905540258	183	912548	6
5679	130.58537323353266	140.44476534296066	0.5168245242593067	183	912731	12
5680	130.48799088166874	120.84713804713843	0.07872138107032106	171	912902	4
5681	130.73424140763464	155.1130434782612	0.20380554607207763	187	913089	7
5682	130.29020279102664	86.33037974683583	0.05692245165506999	180	913269	2
5683	131.90111471660472	291.3813953488362	0.261992558006667	341	913610	9
5684	133.429131938233	284.702836879432	0.3088544127228972	308	913918	13
5685	133.60000089759632	150.51602787456514	0.3372038825083587	236	914154	11
5686	135.73922560772147	347.5224719101104	0.47750978691633356	344	914498	10
5687	137.68204182069962	330.0208469055365	0.8994801985770894	347	914845	8
5688	136.89268294095416	58.74615384615375	0.0631916872660319	150	914995	4
5689	136.40484935913307	88.10932475884283	0.05588048796413997	179	915174	6
5690	135.67678380069532	63.59829351535861	0.07518862389229439	148	915322	7
5691	135.05258284166925	73.25668789808964	0.11129125293932463	190	915512	12
5692	136.2888396219482	258.67826086956455	0.42480204909266933	347	915859	1
5693	137.7544632532201	282.85120274913925	0.15601563740925617	332	916191	3
5694	139.60951393841367	323.2595317725745	0.35907305289005886	345	916536	14
5695	141.78894710091632	357.5528301886768	0.20980431567663435	348	916884	5
5696	141.32892614201788	95.78685121107308	0.054029324015633005	183	917067	2
5697	140.758351166312	84.27142857142907	0.06550932923952739	192	917259	9
5698	140.21194798251773	86.11803278688575	0.040907031074564726	187	917446	13
5699	139.36852081038484	55.869230769230676	0.07234300793828191	148	917594	11
5700	138.94178900729892	96.69534050179254	0.046587230106971786	179	917773	10
5701	139.00638179338253	145.40106761565892	0.15162018367222377	182	917955	4
5702	138.42171253327183	80.53945578231333	0.04641517533196343	180	918135	7
5703	137.8039954079391	76.65000000000035	0.2173059351303998	170	918305	1
5704	137.8096937088933	138.37382550335644	0.19885714708176333	226	918531	8
5705	137.23172353236774	80.01267605633872	0.3662193645130504	220	918751	6
5706	136.71973963037738	86.03333333333369	0.05473584352537643	172	918923	14
5707	136.57127045707014	121.87282229965196	0.10642706114670326	174	919097	9
5708	136.61786494204193	141.23071895424894	0.13731659219620077	188	919285	5
5709	137.7533764334666	250.16901408450843	0.2599571802282846	279	919564	2
5710	138.6500299803102	227.418731117826	0.43683853385618227	323	919887	12
5711	137.8964149264087	63.28852459016417	0.2487741108813317	153	920040	7
5712	137.2205936342875	70.314285714286	0.24012105605181525	153	920193	8
5713	136.66484790555708	81.64602076124612	0.1346852805024834	186	920379	1
5714	138.32682280312486	302.8623376623371	0.334432596432029	347	920726	3
5715	137.46322124176027	51.966666666666555	0.12042617797851562	146	920872	14
5716	138.4953390293427	240.67500000000115	0.5724874907367866	311	921183	13
5717	139.60550128530778	249.5115646258511	0.14511078453714937	293	921476	10
5718	139.4933849697727	128.39386973180112	0.1987730550487139	171	921647	5
5719	140.7948847770329	269.6433656957923	0.15526986564818365	377	922024	11
5720	140.93705062460307	155.01146953405097	0.40841636816001037	241	922265	9
5721	140.20010868978562	67.2428571428574	0.11639382388140704	148	922413	8
5722	140.12510760288777	132.70000000000036	0.1723596218020417	172	922585	12
5723	140.08331806532044	135.94615384615432	0.1954747960808572	178	922763	2
5724	141.60682116785307	292.4336283185834	0.510239172118441	349	923112	4
5725	140.86218152760313	67.14285714285741	0.07743742641986616	149	923261	1
5726	140.067679313656	61.4119601328904	0.05839159024641818	149	923410	3
5727	141.35951055910462	269.25080385852	0.16613989832915796	329	923739	6
5728	141.42815625618917	148.22408026755923	0.14227481620021598	189	923928	7
5729	140.65697814190315	64.31034482758649	0.058033495141355786	149	924077	13
5730	140.7304340839568	148.0025723472673	0.12122426856874796	191	924268	5
5731	140.00949337948086	68.6363636363639	0.08672296280828898	149	924417	8
5732	140.16135625159322	155.19578059071776	0.13538617064050362	177	924594	12
5733	139.72657602241063	96.68333333333383	0.07905949903338143	178	924772	2
5734	139.34831026218652	101.90000000000047	0.14012300703260633	180	924952	4
5735	139.31970520834514	136.48780487804925	0.11922061254107763	189	925141	9
5736	139.1609155636691	123.44074074074129	0.12055505708206532	172	925313	6
5737	138.74320114487452	97.389473684211	0.20699053905049308	183	925496	1
5738	138.15378179165364	79.80126582278521	0.11042552989917798	182	925678	13
5739	140.0987145619724	332.64705882352814	0.34792642675361524	349	926027	10
5740	141.24096109332862	254.3233676975942	0.3631452585195566	308	926335	11
5741	140.95306848919807	112.45170068027242	0.14076251184155128	167	926502	5
5742	144.4405231522914	489.69853479853134	0.28673875596788195	450	926952	14
5743	144.11461630264552	111.84983818770282	0.08623922620500837	175	927127	8
5744	144.87847013961908	220.50000000000105	0.16184195693658324	294	927421	3
5745	144.28394350273902	85.42580645161325	0.0773282185786188	177	927598	2
5746	143.82818180622752	98.70777385159049	0.05875164739201578	178	927776	4
5747	142.6250183313605	23.511834319527026	0.13277718827531143	185	927961	12
5748	142.23519848860417	103.64303405572794	0.09600371192483341	170	928131	6
5749	141.58463662717492	77.17901234567933	0.04971027892568837	184	928315	1
5750	141.61499593466203	144.6205673758872	0.13563328203947647	184	928499	13
5751	143.76009434132845	356.1248366013052	0.5542010093221859	392	928891	7
5752	143.19151387573086	86.9020477815705	0.055479795374768846	188	929079	10
5753	142.67249983587465	91.29010989011041	0.060316632245038006	185	929264	14
5754	142.55378082553986	130.80059880239563	0.14772814892707986	188	929452	5
5755	141.94869597895695	82.04529616724784	0.061052867344447544	189	929641	8
5756	143.32719943450283	279.79904153354585	0.18967770955648766	332	929973	9
5757	142.83368800353807	93.97605633802866	0.037453402755081015	186	930159	12
5758	142.26564729075008	86.0296167247391	0.05611456477123758	184	930343	4
5759	141.53548166033343	69.24908424908456	0.0963447301979833	149	930492	13
5760	140.9750657504825	85.49389067524152	0.1792985001051357	173	930665	6
5761	140.52918360508843	96.38685121107305	0.08510478607005319	177	930842	1
5762	139.66270995085574	53.88181818181803	0.06468891090070697	142	930984	7
5763	142.20366079811524	393.7577946768044	0.34086841178339955	358	931342	11
5764	142.70232883148432	192.07046413502152	0.12101363121195043	188	931530	10
5765	142.01449885171968	73.9193308550189	0.08015616316544383	152	931682	5
5766	143.2460374075063	265.1683544303798	0.46873213489603555	322	932004	3
5767	142.7201033492207	90.65263157894773	0.046648716658688666	178	932182	8
5768	142.24503930202988	95.21369863013744	0.07476153077378785	177	932359	9
5769	141.90895672510152	108.63678160919576	0.04507507712154065	177	932536	12
5770	141.06741920832368	57.75520504731851	0.1523128301918912	147	932683	7
5771	141.45047784066793	179.37328244274883	0.1841756921065481	190	932873	1
5772	140.61713179241997	58.115873015872914	0.3844529744741079	148	933021	11
5773	143.5757382522735	436.4777777777743	0.5148374316761795	412	933433	2
5774	145.87164496241485	373.16640926640633	0.5674474928114149	360	933793	14
5775	145.14056265913217	72.7634146341467	0.11240181871639784	186	933979	3
5776	144.58412254978225	89.49655172413836	0.22900776504781206	173	934152	8
5777	145.9065591020622	276.8277777777775	0.36216029942592726	321	934473	13
5778	146.21168474610135	176.41912350597653	0.25441884739513704	187	934660	9
5779	145.2998852418138	55.03173431734368	0.15038904936417288	184	934844	12
5780	144.51470120421047	66.78148148148176	0.12658110056837943	146	934990	2
5781	145.6478471214613	257.82929292929305	0.20959058489118304	350	935340	6
5782	145.2037043903189	101.23357400722061	0.128489558616381	178	935518	1
5783	144.5776673464157	82.60000000000036	0.11158353331461118	173	935691	7
5784	144.16168188174274	102.97912087912137	0.11068802737118152	178	935869	11
5785	145.02121890907915	230.11538461538564	0.4182669970454002	294	936163	10
5786	147.2087836984056	363.7776978417234	0.325508058988131	390	936553	4
5787	146.55008241604338	81.3386554621852	0.06835528423911647	152	936705	14
5788	147.6077244490258	252.3142857142865	0.13346444665490687	333	937038	5
5789	146.99465666825793	86.30094637224018	0.06514466280317575	177	937215	3
5790	146.06206835702707	53.735825545171245	0.06489828979076982	147	937362	9
5791	145.50397398924628	90.25263157894776	0.053382622016655217	182	937544	8
5792	145.05052532742073	100.15910780669196	0.04199932730771641	187	937731	13
5793	144.5308849390114	93.08648648648688	0.0666691774878997	183	937914	12
5794	143.6543260896213	56.87499999999987	0.04988880605505617	149	938063	4
5795	143.0780801260224	86.02972972973015	0.05989372089344968	186	938249	2
5796	142.8797730089727	123.24736842105298	0.11383575102242317	181	938430	6
5797	142.496859336854	104.58840579710184	0.04359031883445946	185	938615	1
5798	141.8642829003482	79.239215686275	0.05089693018459381	187	938802	11
5799	141.8026276874438	135.6987616099076	0.10786881697805305	190	938992	10
5800	141.0697622497302	68.51608391608421	0.07205528683132595	153	939145	5
5801	140.75029539646366	109.1230769230773	0.07700735296906724	177	939322	14
5802	140.38913572608112	104.6343283582095	0.03856625764266304	184	939506	3
5803	140.01859357516952	103.33492063492109	0.15498213435328284	172	939678	9
5804	139.36093002747754	74.25223880597049	0.19838001853541323	152	939830	4
5805	139.47482245730654	150.750173010381	0.09810656787239931	187	940017	8
5806	139.02921121903483	94.91369863013747	0.09896936416625976	180	940197	13
5807	138.31636893383413	67.74498269896223	0.09542962751890484	152	940349	2
5808	137.9035688808594	97.03636363636394	0.1376892783425071	165	940514	6
5809	140.5254354476899	400.0902255639071	0.21355827140276812	359	940873	7
5810	140.43119770450866	131.10166112956855	0.09145687707786351	183	941056	1
5811	140.1902190607969	116.33333333333375	0.10694269033578727	169	941225	10
5812	139.58773220565217	79.94153354632637	0.06024732087787829	190	941415	5
5813	139.10119450623716	90.93396226415139	0.06191156739773958	184	941599	9
5814	139.26975988076245	155.95773195876333	0.12230360507965088	192	941791	3
5815	138.47877926308692	60.17169811320753	0.1582135275790566	152	941943	8
5816	137.74099147045604	64.70000000000027	0.07457710567273591	152	942095	1
5817	137.25001012718005	88.64285714285754	0.061392597530199135	184	942279	2
5818	136.84434335924158	96.68333333333383	0.18211000421074	178	942457	7
5819	136.39061515743725	91.4715231788084	0.11606225051448843	177	942634	6
5820	137.82386758191464	279.71585760517706	0.19909464369071894	341	942975	11
5821	139.5582003346669	311.2571428571417	0.6800287640283978	315	943290	14
5822	139.51902669144886	135.64083601286214	0.10137122164490403	186	943476	10
5823	140.44899213387694	232.51557093425674	0.13330211426688837	269	943745	13
5824	143.2221833719584	417.76811594202564	0.4456953327120779	459	944204	12
5825	144.4313504271277	264.13888888888874	0.21680045513659232	309	944513	4
5826	143.98460835142785	99.75714285714328	0.04300948513878716	180	944693	9
5827	143.5255735886683	98.08113207547215	0.03317183382967685	188	944881	8
5828	142.89091294480616	80.05950920245441	0.04598118993971083	180	945061	3
5829	142.49151673048726	102.95129151291613	0.09776309806268334	261	945322	5
5830	141.99198411351796	92.5382550335575	0.06288897266704074	181	945503	1
5831	141.6268707239957	105.48064516129064	0.10512075985179228	170	945673	14
5832	141.08829432444804	87.76923076923114	0.07285136750290513	179	945852	6
5833	140.57996067697823	90.25492957746528	0.06902165615812261	188	946040	11
5834	140.50631258535995	133.215151515152	0.12139010167383886	182	946222	10
5835	139.98948357321873	88.82341137123794	0.2536557023696478	181	946403	12
5836	139.67424545390446	108.46567164179159	0.09160617140472913	183	946586	4
5837	139.34010450312482	106.26015037594036	0.06519769140556034	177	946763	8
5838	138.68373434612445	73.70308880308913	0.08082421620686848	150	946913	1
5839	138.71183730117068	141.49402985074673	0.09958311003081653	196	947109	9
5840	138.3232903567304	99.85714285714327	0.1342793469988434	179	947288	3
5841	137.5904511813861	65.0393728222999	0.1598627726236979	150	947438	14
5842	136.73400723739556	51.94605678233429	0.07848087498839472	142	947580	11
5843	136.41273982938145	104.60726643598647	0.09296371878647222	164	947744	6
5844	136.10429870559744	105.56862745098077	0.24171846017897505	159	947903	12
5845	139.64601043552256	490.2754716981084	0.4501220922675922	417	948320	2
5846	142.33012660235374	408.0576271186414	0.48015503240298985	393	948713	7
5847	142.1297867262916	122.29613899613949	0.16645992233092527	166	948879	10
5848	141.24876336883258	54.02745098039206	0.1102889948877795	145	949024	4
5849	142.5511649859586	271.48892508143314	0.4236261444973808	346	949370	13
5850	144.24576783991577	312.0114503816787	0.4189127053424811	314	949684	5
5851	143.4757387329452	67.2428571428574	0.08911677308984704	148	949832	14
5852	142.59932248273947	55.83411371237446	0.050806809138584805	143	949975	11
5853	142.52327697033036	134.99477124183065	0.07900113801698427	185	950160	9
5854	141.8808996223138	78.28554216867511	0.05027378929985894	180	950340	6
5855	141.08079480615496	61.87041800643098	0.10800247443349738	152	950492	2
5856	140.1735449317478	50.355807365438956	0.09878529658933886	147	950639	7
5857	139.91668837516391	114.48788927335673	0.10268852414464104	169	950808	10
5858	139.52786544045688	101.03439490445899	0.11574754315222095	167	950975	4
5859	140.50564801054213	237.3061224489803	0.1544744840232275	279	951254	8
5860	140.68941344824492	158.88219178082238	0.11405352647391913	191	951445	12
5861	140.13968478138835	85.7165467625904	0.0355649793470228	185	951630	13
5862	140.37715028175262	163.88623481781437	0.08693796723753541	182	951812	5
5863	140.05537877893508	108.2000000000003	0.08247232722665021	167	951979	11
5864	142.50940033361144	385.45753424657306	0.2711126225073929	391	952370	1
5865	142.1701476001166	108.58412698412758	0.09629697747569267	183	952553	6
5866	144.49209318293893	374.3647058823512	1.06445238865093	373	952926	3
5867	144.16837085738132	112.11986062717806	0.12537910552795775	167	953093	10
5868	143.62711852135655	90.04313725490242	0.06292509089755473	177	953270	7
5869	142.82483027129658	63.39829351535861	0.11632925669352213	150	953420	12
5870	142.43780419080582	104.12222222222276	0.11184649997287327	180	953600	8
5871	142.43626556495616	142.28394160583997	0.09046034760527559	182	953782	13
5872	143.63471354053584	262.2810631229235	0.28858203143328875	333	954115	14
5873	143.06571168200347	86.73452768729683	0.06299751106349902	174	954289	11
5874	142.52697313195867	89.1918566775249	0.06810740586165544	182	954471	5
5875	144.72033976427542	361.8636363636339	0.3346543866534566	344	954815	9
5876	145.82779882720047	255.46624605678227	0.39727320595393106	315	955130	2
5877	145.34741557577055	97.78947368421098	0.034708499908447266	179	955309	1
5878	145.31145443116526	141.75130111524214	0.09697963926527235	180	955489	12
5879	146.31869247044025	246.03525835866424	0.3305012261689599	335	955824	4
5880	145.67399905222936	81.84935064935105	0.14935499589073467	187	956011	7
5881	145.71500078356138	149.77417218543098	0.14088782260292454	190	956201	13
5882	145.16140007150042	90.35492957746528	0.10321592647124102	187	956388	14
5883	145.74270297622954	203.29169054441383	0.6074817936594893	287	956675	6
5884	144.82293111888103	53.7655172413792	0.1922213699643975	151	956826	2
5885	146.0543560132997	267.9654205607473	0.22482959378150202	310	957136	3
5886	148.15972290092785	356.5910447761164	0.22084171479923434	351	957487	10
5887	147.24000221512844	56.18765432098751	0.0653873365752551	147	957634	7
5888	148.8426548245561	307.5052631578938	0.399111230822577	345	957979	8
5889	148.27011868726942	91.58904109589086	0.08186893889357924	179	958158	14
5890	150.96987204585125	418.2454545454527	0.7665911932676537	362	958520	9
5891	151.57818610494547	211.80127795527332	0.11019067022819622	373	958893	11
5892	151.831367206859	176.89629629629684	0.2549431756370426	193	959086	6
5893	153.0801646459015	276.71111111111003	1.032387602781068	343	959429	1
5894	154.50169633277582	295.2333333333333	0.7836975900750411	380	959809	5
5895	155.33350112171394	237.68217522658728	0.3963051455580537	311	960120	12
5896	155.38805924026778	160.78931297709988	0.17439905115076013	185	960305	10
5897	157.6606881535685	382.65095057034057	0.2809840242627641	355	960660	4
5898	157.36389539842685	127.98141263940565	0.15270020975869084	169	960829	8
5899	157.338573787616	154.83173431734372	0.07850329940383499	185	961014	7
5900	158.9204294290502	315.5241379310328	0.5437194739682523	361	961375	13
5901	159.0180779957951	168.68528610354326	0.18394463253717352	274	961649	2
5902	157.96951997032815	54.16227544910168	0.18581837170744595	146	961795	11
5903	158.41120962866904	202.13848580441766	0.2936707032032502	312	962107	3
5904	158.3314496918508	150.43521594684444	0.11731737126749028	189	962296	9
5905	157.384806427809	63.66712328767149	0.04651222229003906	150	962446	5
5906	156.73061472091925	91.96563573883206	0.0506881362233082	179	962625	1
5907	155.81030857371005	64.70000000000029	0.04185149544163754	152	962777	10
5908	155.24301680872767	99.0811320754721	0.040229082107543945	178	962955	12
5909	154.35709197871867	66.65053380782948	0.07143075576681175	151	963106	13
5910	153.75828162231178	94.47605633802861	0.09161940727444644	181	963287	7
5911	155.56116939432397	334.0470588235283	0.16703820299746386	335	963622	14
5912	155.35865326352067	135.3095563139941	0.3208226318359375	250	963872	8
5913	154.72720958802833	92.21428571428616	0.04912582169408384	184	964056	3
5914	154.02104577240283	84.1108280254781	0.054774257422840526	177	964233	9
5915	155.6476448384883	316.6809523809509	0.39245408304621665	356	964589	6
5916	154.93865114872412	84.74827586206946	0.09783325400403751	186	964775	10
5917	154.26033530861497	87.10706713780962	0.1233731635073398	188	964963	12
5918	155.1538299947445	243.60980392156995	0.4188550478452212	308	965271	2
5919	157.30703580254115	370.4744107744082	0.2911822950068991	402	965673	4
5920	156.62410481733804	89.0139372822304	0.06652562580411396	189	965862	7
5921	155.66019473001873	60.233096085409215	0.0414641002813975	144	966006	8
5922	157.2946738637996	319.10810810810636	0.5508954359510564	389	966395	11
5923	159.67332788561785	395.16007604562515	0.3906099409333074	382	966777	1
5924	161.69659460676164	361.999999999997	0.47390960451795433	379	967156	5
5925	161.7100572321226	163.04285714285777	0.19149031388132196	190	967346	12
5926	163.57448046932518	348.15238095237936	0.4105950685086965	327	967673	13
5927	163.7043720282683	176.56363636363685	0.1486303745792602	197	967870	2
5928	164.4264895983082	235.9161290322587	1.0860825923451207	285	968155	3
5929	165.18692740502783	240.47027027027156	0.5016861218796034	297	968452	9
5930	164.3219761120501	78.691798107256	0.11924464577122738	190	968642	8
5931	166.13347857315182	345.47222222222115	0.4891474761499098	329	968971	6
5932	167.47629143842698	300.4147651006701	0.4231661246025976	317	969288	10
5933	167.03500220825325	123.347368421053	0.1593004438612196	180	969468	11
5934	166.26761939928545	90.29672131147586	0.0943441605300046	178	969646	5
5935	169.38831090288707	478.3367697594474	0.4449615478515625	439	970085	14
5936	170.23788681025167	254.34590163934448	0.39361956212427707	308	970393	4
5937	169.78307937072057	124.75714285714324	0.11465352376302083	180	970573	13
5938	169.77298541911864	168.77368421052677	0.3689752967612257	206	970779	12
5939	168.77084380022157	69.55882352941207	0.14990855223380478	149	970928	2
5940	169.84224347032747	275.9108108108105	0.6994227266859734	348	971276	7
5941	169.38137939524566	123.75583596214562	0.11436651029639482	181	971457	3
5942	168.27402713975474	58.64615384615375	0.13726675273566846	151	971608	10
5943	167.28734340545964	69.60565371024761	0.06830577976656275	151	971759	11
5944	168.1029256676076	248.84556962025496	0.23647616325168436	327	972086	1
5945	167.02991015663596	60.801374570446754	0.0854741180835127	147	972233	4
5946	165.9164864544306	55.687539936102105	0.09928169250488281	145	972378	13
5947	165.14528275493487	88.79611650485487	0.10347086091281316	179	972557	14
5948	165.9799960173509	248.6166089965405	0.20188868512462466	281	972838	8
5949	167.45243346724934	313.223741007193	0.45085577964782714	320	973158	9
5950	166.85227276894048	107.43636363636406	0.2507506186917702	161	973319	7
5951	166.09646527303914	91.2715231788084	0.04150095465462967	179	973498	2
5952	165.81321648746743	137.77158671586784	0.5354610956632174	208	973706	12
5953	165.62432210760906	146.9237785016293	0.17101181988940814	191	973897	3
5954	167.941804376729	397.37254901960574	0.3634952331362924	339	974236	5
5955	167.2338066228168	97.14202898550766	0.11244711646421708	187	974423	4
5956	169.83512372900236	427.3655172413746	0.47730227550828314	415	974838	6
5957	169.44778910300803	131.10166112956855	0.08181793442189368	183	975021	13
5958	168.36655688671843	61.3245674740485	0.07033355219834515	147	975168	7
5959	168.26034342513094	157.74521072796972	0.07826808224553647	184	975352	14
5960	167.0974066575463	51.966666666666555	0.08973657268367402	146	975498	2
5961	167.08828444282267	166.18518518518573	0.11015141199505518	189	975687	8
5962	168.200830169823	278.3428571428566	0.47685805264250325	287	975974	10
5963	167.20493375623667	68.61118881118932	0.1215881593156569	202	976176	9
5964	168.7150642747894	318.21798561150916	0.5208917361253883	342	976518	11
5965	168.30989402419837	128.1980392156867	0.1588937100910005	168	976686	3
5966	167.2264759350202	59.96808510638292	0.07460897498660618	144	976830	4
5967	166.1781410002314	62.392982456140494	0.06273867808231691	147	976977	6
5968	166.1163053266632	159.99457364341137	0.0873525273668897	182	977159	5
5969	165.14463311588742	68.94908424908458	0.06292816839720074	152	977311	13
5970	164.08245251899427	58.926573426573306	0.05032488703727722	144	977455	14
5971	164.5178369490282	207.62089552238888	0.224658450197919	281	977736	12
5972	163.45899191287126	58.63333333333323	0.07250139158066005	146	977882	2
5973	162.6975823216114	87.31803278688568	0.04346487317766462	175	978057	7
5974	164.99503884162957	392.4432343234299	0.6200225293336801	398	978455	1
5975	164.01090326802807	66.58148148148176	0.04310926231178078	148	978603	10
5976	163.48020247504817	110.94082397003785	0.10993656790329635	163	978766	8
5977	162.5102152651125	66.48148148148177	0.07322605824310507	149	978915	9
5978	162.15944233056837	127.43292181070007	0.0909903555205374	165	979080	11
5979	161.12810294081973	59.02550335570456	0.07120636531284877	147	979227	4
5980	160.0817960214439	56.497411003236124	0.06223051515344071	146	979373	6
5981	159.3944134353791	91.34353741496635	0.09288167405402524	174	979547	3
5982	158.79168206698276	99.12127659574519	0.06604450740171282	178	979725	5
5983	158.31948746853516	111.57222222222272	0.13610442479451498	168	979893	7
5984	158.05630931625785	132.00167224080332	0.14472919961680536	184	980077	14
5985	157.6596312405169	118.38850174216067	0.15198214300747576	174	980251	1
5986	157.1930974281117	111.00625000000048	0.1080716915344924	178	980429	9
5987	156.17393568459983	55.276923076923424	0.16123043017440966	178	980607	11
5988	155.199020608904	58.68242811501584	0.30411687837976986	147	980754	6
5989	156.53121288456677	288.41824817518216	0.5627207262762661	290	981044	12
5990	157.89559772541804	292.96969696969586	0.2436839964975535	289	981333	2
5991	157.24374966183294	92.71079136690695	0.1761436870391356	187	981520	3
5992	158.2689470858495	259.76349206349136	0.26760034975798236	322	981842	13
5993	159.57284897711725	288.6591362126238	0.2953818933287663	335	982177	10
5994	159.07325176147734	109.61312741312793	0.3070308879270392	177	982354	7
5995	159.72345575179907	224.0936507936514	0.6536864087097627	266	982620	4
5996	159.65554966143435	152.93284671532908	0.19618769465266048	185	982805	1
5997	159.09770634194177	103.87121771217764	0.06280035919018007	178	982983	9
5998	160.47832387311692	297.1594594594575	0.24063114453387516	372	983355	8
5999	159.64138678823193	76.78461538461585	0.0951827590529983	185	983540	11
6000	158.80700345470075	76.20305343511481	0.1902567670236226	153	983693	13
6001	158.42339810416863	120.44646840148745	0.17519977793974034	170	983863	2
6002	157.84095982205167	100.17956989247357	0.07894768185085721	180	984043	3
6003	160.02701410215812	376.4463878326982	0.25897742576263516	341	984384	5
6004	161.81823415721496	339.149019607841	0.41214456644144143	333	984717	14
6005	161.20289132181566	100.28395061728428	0.11205518598387228	169	984886	10
6006	160.1596124085975	56.87499999999987	0.055476156657174126	149	985035	1
6007	162.75777086326607	419.97545787545556	0.5348382778268642	378	985413	6
6008	161.7454239238642	61.52307692307698	0.3984040653004366	153	985566	13
6009	163.16530301795888	303.73333333333255	0.34182496151681674	295	985861	7
6010	164.48062086156568	294.69708737863846	0.6075068141515803	353	986214	12
6011	164.06516349015934	122.93488372093066	0.21246705488725143	165	986379	5
6012	163.6000945324231	117.55826771653584	0.17241671055923274	162	986541	14
6013	164.79309358709887	282.8999999999995	0.5810680841995498	295	986836	9
6014	164.58054726661248	143.53846153846192	0.13669730031956506	179	987015	10
6015	166.242914317908	330.817252396165	0.45143274072412254	333	987348	4
6016	168.23758003638898	365.70948616600595	0.27259794680658217	334	987682	8
6017	169.287458917673	273.2254681647928	0.1859204107364321	263	987945	3
6018	170.30757733548927	271.2993006992999	0.48508851764145156	293	988238	2
6019	171.89536642699923	329.08648648648534	0.31427505067996564	323	988561	11
6020	171.77748500607524	160.10722433460143	0.14455801474081503	185	988746	6
6021	171.4626192469236	140.29090909090957	0.1650761589009494	187	988933	7
6022	170.6112968519227	86.33037974683583	0.11440785725911458	180	989113	14
6023	170.1977179335827	129.25340501792158	0.11612223495136607	176	989289	9
6024	172.4659818889986	397.0241134751756	0.5064500405754842	355	989644	1
6025	172.02412011571124	128.27980456026114	0.16661601014189667	182	989826	4
6026	173.5099777738697	320.60988593155787	0.4363137209128678	291	990117	12
6027	174.0095723482905	223.46943521594804	0.310171902179718	256	990373	5
6028	172.89670739403837	62.723076923077095	0.09122550910246288	141	990514	6
6029	172.56728167348143	139.95413533834665	0.403321866635923	216	990730	11
6030	174.28667443051708	344.5065573770464	0.48394622802734377	390	991120	13
6031	174.00017132257557	145.6363636363641	0.11774777034141498	179	991299	7
6032	173.21192370771047	95.17540983606598	0.18724980766390575	162	991461	9
6033	174.15766067978367	267.7856209150322	0.26095081911248674	295	991756	8
6034	176.27462952753126	385.854545454544	0.4801717564679574	345	992101	10
6035	177.16726418463688	265.53809523809434	0.18190990911947713	296	992397	2
6036	176.41626530165576	102.06737588652538	0.10666154778521994	184	992581	1
6037	175.69998670661022	104.78840579710183	0.09174417797984973	183	992764	4
6038	174.4402616933453	49.72748538011683	0.13492315884294181	145	992909	12
6039	174.02020944137536	132.43503649635082	0.11189719529179802	171	993080	6
6040	175.18348040085382	290.34730538922037	0.24458470251566852	359	993439	3
6041	174.16050819226513	72.88625954198501	0.13439842172571131	148	993587	7
6042	173.0682968385655	64.9393728222999	0.10227875362168874	151	993738	13
6043	173.9752292547952	263.76153846153767	0.5531787762063087	346	994084	14
6044	173.14322272495912	90.77457627118682	0.32787650281732733	176	994260	8
6045	172.88688103268893	147.50905349794283	0.12136010562672335	170	994430	1
6046	171.9610868492277	80.30746268656756	0.11822088252114986	181	994611	2
6047	172.69980931406877	245.8333333333346	0.5122697927655965	274	994885	11
6048	171.63641405780754	66.36028368794356	0.1298851872122051	151	995036	3
6049	171.08133349931904	116.12835820895562	0.11359346505686722	181	995217	6
6050	173.48915267315977	411.8632508833909	0.37599331399668817	368	995585	5
6051	174.3922233457409	263.7962199312705	0.35125202151900486	282	995867	9
6052	175.1569139068963	250.86127946128084	0.20524599844949287	285	996152	10
6053	174.76460283234346	135.92580645161337	0.13523747200189634	172	996324	7
6054	174.19430564122933	117.73488372093081	0.4961784468268469	217	996541	13
6055	175.16366291485005	271.1300330032995	0.3841027590827024	291	996832	12
6056	176.77823681201733	336.6210526315766	0.2548444729874187	317	997149	4
6057	175.5953514538639	58.489700996677605	0.06539437524203597	145	997294	2
6058	175.27694667578737	143.7548736462098	0.07276293539231823	186	997480	8
6059	174.83032161336163	130.61444043321336	0.0930492312921954	173	997653	1
6060	173.9084821196255	82.64637223974809	0.07935358927800105	182	997835	11
6061	173.1232621632941	95.38648648648677	0.06858537793159485	160	997995	6
6062	172.423255222595	103.12256809338567	0.12060072230196547	174	998169	5
6063	172.6858647756322	198.68421052631635	0.23662141240744228	249	998418	14
6064	171.5067956015601	54.778947368420944	0.11642304272718833	142	998560	10
6065	172.062975820727	227.12481751824936	0.33722311500611346	246	998806	9
6066	171.1715823084744	82.92362459546969	0.14996852764504492	173	998979	12
6067	171.31734474625924	185.74782608695716	0.1517244699838999	185	999164	8
6068	171.2167268543522	161.2555555555563	0.16938499609629312	192	999356	4
6069	172.06495894683107	256.03993610223637	0.3123306711767889	314	999670	3
6070	171.19015407785966	84.58447204968984	0.1399970001049256	178	999848	5
6071	171.69091920374774	221.26666666666773	0.29907461777034955	253	1000101	11
6072	172.65403798373822	268.0027972027964	0.31115874719783615	291	1000392	2
6073	173.50520993266795	257.77123287671145	0.4071464026534317	298	1000690	13
6074	174.0336403508238	226.34825174825247	0.7960788289548851	253	1000943	6
6075	176.21960596073833	392.63020134228026	0.31907834177431854	368	1001311	7
6076	175.32475517800393	86.73452768729683	0.14686663397427263	174	1001485	9
6077	177.64963789442308	407.8130268199205	0.22441353054221616	327	1001812	1
6078	176.50452667448943	63.13851590106024	0.08486309051513671	145	1001957	4
6079	175.2941183504197	55.463694267515805	0.08329676924080684	145	1002102	8
6080	174.1808914526298	63.97142857142881	0.08493647739805024	145	1002247	3
6081	175.80320467550806	336.4122137404573	0.2562539091078334	299	1002546	10
6082	176.9420561238986	289.6883495145619	0.48542336856617646	306	1002852	14
6083	175.670837397522	49.82018348623841	0.07762438100534719	143	1002995	5
6084	174.47482701012396	56.06979865771798	0.07152408653205924	143	1003138	13
6085	173.8180787400227	108.80000000000032	0.12092041821213242	161	1003299	11
6086	174.32685961396433	224.6961661341865	0.18357793835626132	276	1003575	12
6087	173.1316603247554	54.80693069306916	0.08067221111721462	144	1003719	6
6088	172.54034372150784	114.00000000000047	0.06575627033936911	179	1003898	2
6089	171.34301720736968	52.807692307692186	0.03379629717932807	144	1004042	9
6090	171.23263181141542	160.30447761194077	0.11236381530761719	187	1004229	8
6091	170.10120250326804	58.0897009966776	0.2709223856061897	149	1004378	6
6092	169.7530266557098	135.28361774744084	0.19359917693085724	182	1004560	5
6093	170.99644674376262	294.0950354609923	0.3708195736533717	285	1004845	4
6094	170.24901341185614	96.253113553114	0.9117582454237827	172	1005017	11
6095	169.31547608009745	76.8952802359885	0.17260448411963453	174	1005191	13
6096	168.46842959955126	84.61082802547807	0.9538913105809411	172	1005363	12
6097	167.38574530355575	60.19999999999996	0.1436109867225699	147	1005510	9
6098	168.40190083753316	269.0012987012985	0.32907011702254013	296	1005806	1
6099	169.40739750860033	268.9515679442501	0.6092480927510978	306	1006112	3
6100	170.27499517530535	256.1671641791039	0.26041316671339987	303	1006415	7
6101	171.09611463935985	252.38694158075626	0.22680588549721364	293	1006708	14
6102	170.6417199265327	125.6566433566438	0.15240760283036667	176	1006884	8
6103	172.33011628658937	339.4813559322015	0.4446219137839011	333	1007217	10
6104	171.14740898037874	54.05938566552892	0.0659992610309141	141	1007358	6
6105	170.04982377946382	61.388888888888935	0.09719739824333447	149	1007507	11
6106	169.75112869127548	140.18031496063043	0.1340406994486964	172	1007679	5
6107	168.50798104072638	45.43636363636412	0.09999722700852615	182	1007861	4
6108	169.94094682302426	311.8045592705158	0.6742325711112491	346	1008207	2
6109	168.9666582339149	72.51208791208825	0.45357563293058106	153	1008360	8
6110	168.29699165157575	102.00000000000047	0.1250231758842255	179	1008539	10
6111	168.8859770615205	227.19553264604872	0.3790354128237124	270	1008809	3
6112	168.1302284020164	93.31111111111154	0.09295105799443304	177	1008986	6
6113	167.12429887785285	67.53727598566334	0.6183721181508657	148	1009134	4
6114	166.597112626663	114.40567375886576	0.30555154035191334	167	1009301	11
6115	168.49205846790537	356.0916967509004	0.538700907449694	337	1009638	12
6116	170.0612189643074	325.408108108107	0.27181496649432035	326	1009964	9
6117	171.59433141234547	323.37246376811476	0.27688482743275317	316	1010280	7
6118	173.54765664945876	366.92685512367314	0.3729098016323324	358	1010638	13
6119	172.41247940269207	60.029931972789086	0.06118620009649368	147	1010785	2
6120	173.47876840176858	279.0413793103421	0.5626999261811023	381	1011166	1
6121	175.12791095030903	338.3930232558124	0.22285272961571104	336	1011502	14
6122	174.55214845712015	117.5516616314204	0.10800971359503074	183	1011685	8
6123	173.4212936392156	61.46666666666674	0.17699071113636952	151	1011836	6
6124	172.26039217823327	57.331147540983515	0.20720326170629386	147	1011983	4
6125	173.4649677436304	292.71794871794805	0.29482052009854115	309	1012292	5
6126	173.0388245597006	130.85064935064977	0.11925860073255456	184	1012476	3
6127	171.9877612238509	67.93249097472953	0.11195167541503906	150	1012626	7
6128	171.87518134624023	160.7297734627838	0.47758835437251074	204	1012830	11
6129	171.52919985079902	137.27703180212052	0.24796086516828167	181	1013011	1
6130	170.42702745361993	61.3119601328904	0.26007581075032554	150	1013161	6
6131	170.19477412823625	147.20169491525468	0.13757526113631877	188	1013349	8
6132	170.8040772230743	231.1250836120414	0.21199000833605633	263	1013612	2
6133	171.92603645084355	282.99999999999943	0.7432184543739371	294	1013906	12
6134	173.26110646981593	305.43303834808177	0.30934038926302854	337	1014243	10
6135	172.14438429400667	61.58888888888895	0.17703729746293048	147	1014390	3
6136	173.68436902249516	326.14285714285575	0.47179775793575546	309	1014699	9
6137	173.0343148059544	108.67894736842166	0.17868418442575554	228	1014927	4
6138	171.91821733263535	61.424567474048516	0.133765991419962	146	1015073	1
6139	173.68646814899972	348.74329896907057	0.4747724942634442	326	1015399	14
6140	172.5980562976984	64.84528301886819	0.13281224657605578	143	1015542	6
6141	172.8877109930801	201.56352583586738	0.3054550228916647	263	1015805	5
6142	171.72351130250414	56.46774193548376	0.06994508372412787	144	1015949	8
6143	170.6718790263585	66.56028368794355	0.05900622374259386	149	1016098	3
6144	173.22968482625885	426.4524590163904	0.4452562985972592	423	1016521	13
6145	172.1436700292783	64.62820512820538	0.05028289014642889	154	1016675	2
6146	172.96568686058401	254.34535315985156	0.48928425147098564	318	1016993	7
6147	174.02547826784024	278.9448275862064	0.6004554334159096	313	1017306	11
6148	173.24139465633303	95.61711711711766	0.6261115386107258	214	1017520	9
6149	173.98086130678462	247.18805970149305	0.3195958232499689	251	1017771	4
6150	173.81075362829623	156.97009345794464	0.3473359642959223	205	1017976	1
6151	173.17425172581608	110.16056338028206	0.17387686064749053	165	1018141	8
6152	172.26345906106528	82.09498525073779	0.06631728957371158	181	1018322	14
6153	171.12430854688773	58.34840764331198	0.2052874436249604	148	1018470	2
6154	171.6876846564653	227.46191950464555	0.3872182053786058	325	1018795	10
6155	171.39554606493422	142.4738255033562	0.09610562711148649	185	1018980	13
6156	172.84563696190074	316.4046357615868	0.5418590969509549	378	1019358	12
6157	171.7588825790367	64.17019867549693	0.09143007429022539	152	1019510	11
6158	172.93408322693054	289.27894736841967	0.35236654056844485	297	1019807	5
6159	174.47738473042764	327.2642335766416	0.2834989088203254	303	1020110	3
6160	176.52430153060536	379.1690647481988	0.3807570435280024	344	1020454	6
6161	176.1608085152993	140.1750000000005	0.15765898140313114	191	1020645	4
6162	175.34264940973813	94.34489795918405	0.056541716114858566	178	1020823	14
6163	174.96038463181236	137.11617161716256	0.25335078336754624	245	1021068	9
6164	176.47498768204593	326.42068965517035	0.2676877648659584	321	1021389	7
6165	175.76047939543955	105.02415902140723	0.16197621545126273	172	1021561	10
6166	175.46023124484182	145.73566433566478	0.1236239768363334	185	1021746	13
6167	174.5968630461058	89.12341137123794	0.15116842677084247	178	1021924	11
6168	175.2982277489781	244.73333333333466	0.24419164824904058	285	1022209	1
6169	175.78989104110858	224.46455696202676	0.3066161895965363	286	1022495	2
6170	174.56346550347854	53.14733727810636	0.1425739623404838	148	1022643	6
6171	174.6930840130007	187.52531645569724	0.21574315868440222	244	1022887	12
6172	174.1940636206319	124.79104477611989	0.1539556514581985	169	1023056	4
6173	175.74271845368122	329.0595469255646	0.355699212701471	333	1023389	8
6174	174.923935336941	93.86440677966141	0.07981912517014829	179	1023568	14
6175	173.9128892921218	73.8193308550189	0.11986592860003702	153	1023721	11
6176	172.91338011751043	73.96197183098661	0.1609800309699199	197	1023918	7
6177	171.89999141437454	71.57450980392186	0.11372112901243445	146	1024064	1
6178	172.92557423404372	274.4582733812943	0.1429533612900886	276	1024340	3
6179	174.38691317608865	319.05946843853667	0.2277656786369555	330	1024670	5
6180	173.55781823787618	91.47741935483909	0.16079449521902517	181	1024851	2
6181	174.67542320568054	285.3183150183139	0.5173298088279931	296	1025147	10
6182	176.69657806453282	376.7909090909075	0.21894315162800854	322	1025469	9
6183	177.9815444872773	305.1932203389817	0.19603725471118888	303	1025772	13
6184	176.7635263845972	56.17973421926973	0.25042182117251294	199	1025971	8
6185	176.522062837923	152.6171717171723	0.14162493254009045	190	1026161	3
6186	177.51806669933967	276.1224489795909	0.2462334266075721	299	1026460	12
6187	179.07812845658867	333.5242424242401	0.3351585568760979	338	1026798	6
6188	179.73170614638175	244.43589743589837	0.34173078092622927	279	1027077	1
6189	180.319685820823	238.52967359050575	0.4820137266900129	314	1027391	14
6190	179.97197439950799	145.54854368932104	0.1519632831062238	194	1027585	13
6191	180.98914939235502	281.6894736842092	0.42011296889361216	340	1027925	11
6192	184.6676722410609	548.8414342629437	0.30201153204540654	407	1028332	4
6193	186.6001896578444	377.9194139194117	0.6447398151195813	359	1028691	7
6194	186.9934291405763	225.92413793103506	0.5511297084941938	257	1028948	8
6195	189.29033005516303	416.68352059924865	0.40283685202126973	364	1029312	5
6196	188.95700407419903	155.95773195876333	0.2101767659187317	192	1029504	6
6197	189.82544951333318	275.80154798761583	0.41747448491115197	306	1029810	10
6198	191.34246122980392	341.5266211604075	0.5487947181837093	338	1030148	2
6199	193.72605194317634	429.70153256704657	0.34278467844223837	338	1030486	9
6200	192.33356250808194	54.4771084337348	0.11595440559646711	147	1030633	14
6201	192.91146178232998	250.12348993288663	0.3097670592183359	283	1030916	12
6202	191.94227819898944	95.99310344827633	0.08730674463476838	177	1031093	11
6203	190.9755974664695	95.27420494699685	0.07648050448315291	177	1031270	7
6204	191.6794047101956	261.35632183907944	0.16573603272898316	259	1031529	1
6205	192.841970791711	307.93601286173487	0.3093080520629883	328	1031857	3
6206	191.7454240996669	83.18730158730206	0.06126660206278817	183	1032040	8
6207	190.27251859513234	44.45487364620976	0.09703126483493381	180	1032220	6
6208	191.74020093269198	337.0407523510961	0.41549589109287954	359	1032579	4
6209	192.84321963533915	302.04207119741017	0.4890361310217375	409	1032988	13
6210	192.71578743898579	180.10000000000056	0.19144568780455926	198	1033186	1
6211	194.304219670603	351.5590106007057	0.33001401531162544	335	1033521	2
6212	196.37733132005079	401.615384615383	0.2134103977933843	329	1033850	9
6213	197.2906504923994	287.70924855491234	0.31154123942057294	330	1034180	5
6214	198.916778470234	359.9034482758595	0.21382740401069203	331	1034511	14
6215	199.91674352686005	298.9132841328402	0.6934481250996493	294	1034805	11
6216	200.2768618058772	235.928571428573	0.534740383342161	354	1035159	10
6217	200.35274892552334	207.86557377049292	0.48238750199830405	281	1035440	7
6218	202.6493390833269	430.0117647058801	0.39593617812446924	368	1035808	12
6219	201.64027812492606	101.74324324324354	0.20648979559177305	164	1035972	4
6220	200.7024768474362	107.8601503759403	0.28795545589849814	161	1036133	9
6221	201.76809070824532	307.2638629283479	0.3292510228127426	322	1036455	8
6222	203.7553709319049	400.4961130742021	0.2945559981965671	411	1036866	3
6223	204.66669376579574	294.88765432098637	0.4520323239839994	260	1037126	5
6224	203.9667245025564	134.66976744186076	0.1647450738620264	193	1037319	10
6225	205.0456537487589	311.8596491228051	0.3009463462710007	319	1037638	13
6226	205.2838669932028	228.8669781931477	0.28996186643033417	296	1037934	1
6227	205.8978479954019	266.68196721311415	0.2926054775925491	283	1038217	11
6228	206.02660945352838	218.77399380805093	0.29327313653353987	319	1038536	2
6229	208.6230527015536	465.67093425605117	0.5927519281226469	498	1039034	6
6230	209.02027836789154	248.34561933534852	0.26367071119405455	295	1039329	14
6231	209.5135250956133	258.34495114006484	0.3022394924299091	282	1039611	7
6232	210.1676007290109	274.9210884353731	0.41987695246396944	277	1039888	12
6233	210.2411628169589	217.52380952381088	0.2246215197504783	294	1040182	4
6234	209.3666006511549	122.78494623655955	0.1553358721309865	169	1040351	5
6235	208.32227792822545	104.93432835820948	0.11478028903349988	181	1040532	13
6236	209.52416626005427	328.5111111111102	0.2603409752478966	325	1040857	8
6237	210.6328035783454	320.3878980891691	0.3628410634414926	362	1041219	9
6238	209.90714220922862	138.06666666666712	0.15778958088642842	185	1041404	14
6239	210.78365808872363	297.5587301587289	0.5905955153245193	325	1041729	3
6240	211.55313833951953	287.7316831683159	0.2760570657664332	290	1042019	10
6241	211.98748638874847	254.98794326241156	0.31112593537444	286	1042305	1
6242	212.89636624184212	302.87547169811205	0.3900798260141484	291	1042596	6
6243	213.86918035720146	310.17777777777695	0.37019282023111977	300	1042896	2
6244	214.83351753913666	310.30289855072357	0.3502541491265833	338	1043234	11
6245	213.8616492407169	117.64668769716138	0.1623970116982913	179	1043413	8
6246	214.65732686595678	293.42941176470504	0.36719810485839843	300	1043713	7
6247	213.2819569871277	77.12033898305111	0.2096313714981079	160	1043873	9
6248	214.04331549944817	289.4178082191764	0.11491995681951075	324	1044197	12
6249	212.9616585682299	105.87762237762274	0.27158178934236854	164	1044361	14
6250	213.75345205449003	292.1410071942433	0.16079653785342263	315	1044676	4
6251	214.414064842727	279.8147308781857	0.2504168248703051	317	1044993	5
6252	213.8394875745814	156.95633802816963	0.12808041823537727	190	1045183	1
6253	216.17024762841302	446.915492957744	0.25975171949685694	389	1045572	13
6254	215.33179802569214	132.32528735632218	0.15276614918428308	170	1045742	12
6255	214.62012155486917	144.16415094339666	0.16122975879245335	180	1045922	9
6256	216.13492033932044	366.09999999999735	0.44685752010909763	338	1046260	3
6257	217.41640557301332	344.28344370860793	0.45075449410522095	331	1046591	10
6258	218.34474332233734	310.2501805054135	0.28353810803643587	290	1046881	2
6259	218.3960991678025	223.48032786885344	0.46262168884277344	256	1047137	8
6260	218.5677719789414	235.5633802816913	0.5484917575575741	249	1047386	14
6261	219.74680190034798	336.4707641195997	0.3025484736661733	322	1047708	11
6262	219.0460756031988	149.674172185431	0.26760071360003884	191	1047899	1
6263	221.12137643657076	426.5761589403953	0.3290404239644203	369	1048268	6
6264	219.44898085402323	53.88181818181803	0.18417400037738638	142	1048410	13
6265	221.5707889178234	431.62978723403984	0.24167561753887998	321	1048731	7
6266	222.96190559004862	360.68245614034794	0.2390673856557526	322	1049053	4
6267	223.29387274104468	256.1586206896542	0.24856299634249704	265	1049318	5
6268	221.965901226749	90.49672131147587	0.1420805887742476	176	1049494	9
6269	220.41536808860738	66.912587412588	0.072189681670245	204	1049698	3
6270	218.950184104691	73.8969696969703	0.0730111080667247	207	1049905	10
6271	218.3312456439258	157.05633802816962	0.10271474041005291	189	1050094	14
6272	219.05125331949972	290.33201320131906	0.2810278741598932	297	1050391	12
6273	218.2334074529714	137.26666666666716	0.14781873566763742	168	1050559	4
6274	218.20934498337996	215.82716049382842	0.29207077846732193	279	1050838	2
6275	217.1033862853192	107.61347517730545	0.1994858485896413	164	1051002	3
6276	216.3938369585485	146.1484536082479	0.2532149738168971	187	1051189	10
6277	217.0036727825114	277.3774193548376	0.7917343992624224	322	1051511	11
6278	217.88046364089317	304.68275862068793	0.3776657926514494	297	1051808	7
6279	218.17577465074277	247.4115646258512	0.3905031483644133	314	1052122	13
6280	220.19847144968986	420.4454545454529	0.36437009923598346	340	1052462	6
6281	222.17400525371147	417.7518518518488	0.3232018639059628	340	1052802	1
6282	224.03041659559662	407.815139442227	0.588139626126999	383	1053185	8
6283	223.33205360611126	154.1941176470594	0.16630918141957876	185	1053370	12
6284	224.43686378900438	333.8130718954236	0.34665530195860106	321	1053691	9
6285	225.10037143977414	290.7876288659782	0.27092620636943326	287	1053978	14
6286	226.74330418022586	389.39364548494734	0.34194827697437663	386	1054364	5
6287	228.13356630570982	365.7695167286227	0.3108906760858518	319	1054683	4
6288	226.82569322768674	97.34625850340176	0.08232861822778052	182	1054865	1
6289	227.06635656119062	250.8920265780747	0.604221028127488	314	1055179	2
6290	227.74064335018863	294.4950354609923	0.2981363479777163	281	1055460	7
6291	228.40412580557563	294.0888888888877	0.4131493894209773	322	1055782	10
6292	228.0423111336226	192.22265861027276	0.37634035140749006	252	1056034	12
6293	229.06486333092835	330.2975308641968	0.35685321424134386	338	1056372	3
6294	229.713165052229	293.89503546099235	0.2576491193073552	287	1056659	8
6295	229.64028752711926	222.42541254125513	0.48102941392343257	316	1056975	13
6296	231.22185762482104	387.7972972972957	0.20107606399890987	344	1057319	11
6297	229.45870835550355	54.906930693069164	0.13321056232585773	143	1057462	4
6298	227.744259202983	58.013793103448165	0.1269492836265297	143	1057605	1
6299	226.02026105539758	55.34444444444431	0.12503723417009627	140	1057745	2
6300	227.17793515717236	341.78767123287514	0.39310282810478453	314	1058059	5
6301	229.65838868231293	475.22328767122957	0.42075986725291564	418	1058477	6
6302	230.96933309737656	360.75283018867697	0.37605973738658277	316	1058793	14
6303	232.17909047062813	351.9450704225329	0.2442899684316104	388	1059181	9
6304	231.0404662325885	118.3166666666672	0.14931779749253216	170	1059351	12
6305	231.11310968022826	238.3048109965641	0.24579742664599236	262	1059613	10
6306	231.63134806133763	282.93694779116413	0.30347990079690484	262	1059875	13
6307	232.95772974801048	364.26951672862276	0.492323047386672	334	1060209	7
6308	231.73640245053036	110.8250000000004	0.3009231478668923	172	1060381	6
6309	232.6325734813756	321.3535055350541	0.6987079213984644	291	1060672	1
6310	233.394305998989	308.805825242717	0.34152147607895933	309	1060981	3
6311	233.67914275551286	261.87798165137616	0.4454296450071697	316	1061297	8
6312	235.1012604188668	375.8909090909077	0.3452163880685305	331	1061628	11
6313	236.43734001325967	368.7092198581546	0.15374537022509918	319	1061947	4
6314	237.69201009138794	361.90434782608565	0.3715124292992081	293	1062240	2
6315	238.21487320725726	289.9783216783206	0.25479456744616547	316	1062556	14
6316	238.935489181067	310.276470588233	0.25970681921228184	308	1062864	12
6317	239.37945112093948	283.331683168316	0.32473512752327377	334	1063198	5
6318	238.38374818482166	139.80915750915796	0.11783982406963002	176	1063374	6
6319	237.51575240181515	151.5841698841705	0.1498847164950528	182	1063556	3
6320	236.09653447511243	95.59395973154413	0.1332556372103484	184	1063740	1
6321	235.16460421808063	142.90350877193023	0.1117928753728452	184	1063924	8
6322	235.41507445496956	260.21162790697605	0.2534732502468383	362	1064286	9
6323	234.18988773919685	112.8964028776982	0.24482666940400094	165	1064451	14
6324	235.29851445907445	345.0525597269589	0.38398874287978013	371	1064822	10
6325	235.3670277664961	242.1498452012396	0.1978256676029895	271	1065093	11
6326	236.23851642922847	322.51589403973304	0.4383058820452009	350	1065443	13
6327	237.75041697922188	387.42857142856894	0.43090082129194324	339	1065782	7
6328	236.46015009756525	108.72372881355966	0.2272394938641284	166	1065948	6
6329	236.4930280486444	239.74794520548022	0.45665241452692384	307	1066255	4
6330	235.537045136579	140.8947368421058	0.18966769607814812	169	1066424	1
6331	236.83943980976835	365.7765124555146	0.21169033692152858	327	1066751	2
6332	235.96715861921786	149.61132075471764	0.4183679836899487	201	1066952	3
6333	236.41776481080345	281.02777777777726	0.2904840011323225	279	1067231	12
6334	236.6281165744601	257.4529411764695	0.5623626093710622	248	1067479	9
6335	237.68253987606946	342.07044673539366	0.20286689569920668	324	1067803	8
6336	238.91958771674535	361.38732394366093	0.6446795201563573	364	1068167	5
6337	238.53444513111396	200.40532915360606	0.32129242306663874	252	1068419	11
6338	238.32243401313616	217.33333333333442	0.27472742736109435	259	1068678	10
6339	238.80508599809312	286.58763250883305	0.2465565084553451	278	1068956	14
6340	237.71571934863852	129.86842105263202	0.12689139925200363	174	1069130	12
6341	237.85767780141063	251.91156462585067	0.17939257710396578	269	1069399	7
6342	237.41248197577747	193.33809523809634	0.25529238003403393	268	1069667	4
6343	239.19944806511057	416.1090909090876	0.30398893768574387	347	1070014	13
6344	239.16946020697603	236.20066225165644	0.18554116629220388	286	1070300	1
6345	239.45884023177192	268.10746268656646	0.27827030597346847	303	1070603	6
6346	239.45646995976583	239.22181303116218	0.3419012543339057	298	1070901	2
6347	239.66613404245598	260.42287822878154	0.3431992862687443	273	1071174	3
6348	238.45283766553507	118.33649635036537	0.09567501458777003	166	1071340	14
6349	239.08688949365788	301.8580204778144	0.17897255232244014	291	1071631	9
6350	239.120328291029	242.43076923077012	0.44584415735823385	267	1071898	8
6351	239.30459076154338	257.54657534246473	0.3456278636043233	266	1072164	5
6352	238.19161958702404	128.00747330960905	0.13678739311989774	178	1072342	6
6353	239.25316140642096	344.3458015267167	0.28099748250600454	296	1072638	10
6354	240.05303115290096	319.2401360544206	0.3444524457377772	310	1072948	11
6355	240.61256535750096	296.0064516129021	0.29095412745620264	297	1073245	7
6356	241.9027920170932	369.6352313167245	0.27579274589632763	324	1073569	12
6357	242.31865220881033	283.48881118881036	0.5826447528341542	276	1073845	13
6358	242.39111648037303	249.56507936508007	0.11217367769491793	297	1074142	1
6359	243.33357495253298	336.63696369636835	0.22385269675211342	329	1074471	4
6360	242.53597389688522	163.57346938775552	0.45495540618896485	200	1074671	8
6361	244.10474412181526	399.4129963898889	0.17901774330025966	337	1075008	2
6362	244.30787315118533	264.41764705882275	0.291347142812368	296	1075304	9
6363	244.64976163278823	278.49672131147474	0.3538780470152159	296	1075600	5
6364	247.41513405256137	521.1870036101027	0.5677121340573489	455	1076055	3
6365	248.1876493787024	324.6666666666651	0.3706741811339758	319	1076374	6
6366	247.18221732935982	147.64444444444496	0.1578932208215405	167	1076541	2
6367	246.9013045411795	219.0909385113279	0.2502720642089844	300	1076841	10
6368	247.37898728864795	294.6695792880248	0.418330215381093	418	1077259	14
6369	248.25523108579515	335.0033670033654	0.21468987061312206	319	1077578	11
6370	249.3033239362275	353.0645161290313	0.28934343523006373	299	1077877	7
6371	250.22757641115092	341.72857142856986	0.3138844773576066	296	1078173	13
6372	250.60711882885758	288.1818181818176	0.26255971851157506	299	1078472	12
6373	250.68359836520665	258.2550724637663	0.37054024348183284	315	1078787	1
6374	250.8369388521428	266.01764705882266	0.198356751033238	280	1079067	8
6375	252.20569989840394	387.71304347825844	0.3661583559664993	361	1079428	4
6376	252.24051912091824	255.68762214983695	0.5117236151211504	276	1079704	9
6377	252.5970345646297	287.89206349206285	0.19928167006548714	255	1079959	5
6378	253.49346847430252	342.2404255319137	0.26528340657552085	300	1080259	10
6379	253.8492361306966	289.07023411371125	0.37013567502969486	319	1080578	3
6380	254.54560341851243	323.4859649122784	0.40842041411957186	308	1080886	2
6381	255.00207965524362	300.1932270916319	0.26287055738044507	264	1081150	12
6382	255.74033038186997	328.82715231787955	0.17584072351455687	320	1081470	14
6383	255.94124154346008	275.8314465408796	0.5715264389195394	291	1081761	7
6384	253.92665302739655	54.482389937106824	0.18627802966392204	146	1081907	9
6385	253.711249689305	232.38631921824233	0.23061297542259787	281	1082188	13
6386	252.45510534527818	128.0968152866247	0.18897647544985913	183	1082371	4
6387	253.04904473768525	311.84904458598544	0.2903889656066895	320	1082691	11
6388	253.91933807409217	340.0783783783756	0.20783079856353281	382	1083073	6
6389	252.70561252960854	132.54678362573142	0.1424985865956729	194	1083267	5
6390	253.34076401676919	316.22076124567354	0.33195166796546194	297	1083564	8
6391	254.5878546344412	378.0498257839698	0.42840275619969226	330	1083894	1
6392	253.44092345651782	139.89473684210586	0.10715606092740704	179	1084073	3
6393	253.36628425679586	245.9770034843213	0.3450252072820404	257	1084330	14
6394	253.24785320230737	241.5231788079479	0.30770108532347407	299	1084629	12
6395	252.9591806903512	224.38060200669042	0.42464470140861743	297	1084926	2
6396	252.64803259205695	221.84437086092788	0.2258266391176166	264	1085190	9
6397	252.46083024447574	233.92779783393567	0.30820983533233287	259	1085449	6
6398	251.97687928468832	204.06573426573527	0.5150912465447207	301	1085750	13
6399	253.19161753409495	373.450704225351	0.46546354539756446	349	1086099	10
6400	253.20737668342935	254.76753246753267	0.17987758525903674	276	1086375	11
6401	252.66749772178989	199.2194805194819	0.3008083930382362	312	1086687	7
6402	253.21322346659363	307.24007220216447	0.390075576137489	284	1086971	8
6403	253.89446390273514	321.3372670807431	0.30419758053645035	326	1087297	4
6404	253.80177175540214	244.62524916943664	0.28470102027865524	277	1087574	1
6405	252.62951662777618	136.57625899280623	0.14052339129977756	180	1087754	14
6406	252.83905379682776	273.583233532934	0.43871577809798273	347	1088101	5
6407	251.33237386979195	102.17106109324793	0.15656012118219614	167	1088268	13
6408	252.25931434514084	344.02642140468083	0.36340239485340003	338	1088606	3
6409	252.30123402220224	256.451282051281	0.35397602156096813	255	1088861	12
6410	251.47307882483736	169.48571428571498	0.3189632783686449	197	1089058	8
6411	252.11804092048408	315.9692883895116	0.5254806250856634	285	1089343	9
6412	252.05037949862103	245.35189873417866	0.2354884629838922	267	1089610	6
6413	251.01354237030148	148.36666666666704	0.1675632288167765	182	1089792	1
6414	249.6730521078888	116.96451612903266	0.15769180059432983	160	1089952	14
6415	250.51196309624385	333.56415094339445	0.2857672151152071	286	1090238	10
6416	250.32184346528143	231.5000000000013	0.6019522975867903	284	1090522	11
6417	250.87795836396194	305.9333333333321	0.372371575771234	273	1090795	7
6418	251.97892071580617	360.9741935483849	0.5323249111656382	357	1091152	2
6419	252.60370293721954	314.45714285714166	0.46786218649928224	283	1091435	4
6420	251.4452989353703	136.76330275229427	0.1493658095754254	191	1091626	13
6421	250.47229470926746	154.14487632508875	0.09213037844057437	189	1091815	8
6422	249.4862754658785	151.87037037037092	0.21239863271298615	184	1091999	10
6423	250.73534677715375	374.39340659340473	0.4051098214503018	321	1092320	5
6424	250.59905213291162	237.1058823529419	0.43891903963955964	275	1092595	3
6425	249.70882789510742	161.5766283524908	0.1872316443401834	184	1092779	2
6426	250.44322313263984	323.1483516483502	0.3383624385780012	284	1093063	6
6427	250.70533144185399	276.6540540540534	0.25435311453683035	273	1093336	14
6428	251.4560924986929	325.78143712574695	0.32349850317675194	334	1093670	12
6429	251.86542812543007	292.3896551724122	0.2631954436606549	282	1093952	11
6430	252.33309642482092	298.63225806451476	0.27056406354746804	303	1094255	1
6431	252.72008559258592	291.03201320131893	0.15965776114628233	290	1094545	7
6432	254.10082119150954	390.79364548494755	0.9843672885689684	372	1094917	9
6433	254.07955511795925	251.9742138364788	0.3598365234814102	278	1095195	4
6434	254.84426518475715	330.55056179775113	0.3736452676845669	289	1095484	13
6435	253.25068739777444	95.48648648648677	0.33852511232004223	159	1095643	3
6436	251.92081717974526	120.26366559485568	0.15242117343668166	179	1095822	10
6437	250.68889472223353	128.72857142857185	0.116007999940352	176	1095998	2
6438	250.28049634104894	209.84905660377459	0.2853563227708735	259	1096257	5
6439	251.17693872746176	339.9247349823311	0.2960772360524824	310	1096567	8
6440	250.9371761429082	227.20068027210937	0.3166674629586642	244	1096811	1
6441	251.34333379324383	291.5529411764696	0.21293337125304743	282	1097093	14
6442	251.5952149207202	276.5314465408796	0.2110579987646828	284	1097377	12
6443	252.346145933025	326.68831615120126	0.31575121910743464	306	1097683	6
6444	251.41948194204917	159.67974683544378	0.2800295005724268	206	1097889	13
6445	252.76195378929535	385.6666666666651	0.35986913292153366	309	1098198	11
6446	253.0593342514024	282.49999999999955	0.45408972290447325	299	1098497	7
6447	252.73531094146165	220.6570032573302	0.18195139472164326	268	1098765	10
6448	252.43414830823752	222.61904761904813	0.26376624662713355	249	1099014	2
6449	253.41918966343897	350.9382838283814	0.5223966394580385	318	1099332	4
6450	254.26411897892578	337.91212121211896	0.5166194410209196	332	1099664	9
6451	256.2971419112739	457.5664122137387	0.3753907041522199	347	1100011	3
6452	254.93107696698132	119.69064748201475	0.19531613411988027	169	1100180	1
6453	255.66765767017972	328.5891472868208	0.38573704654597896	279	1100459	8
6454	255.79873109347793	268.7749999999993	0.3629469190325056	280	1100739	5
6455	253.6290308487892	38.82870662460624	0.11880377108457858	189	1100928	14
6456	253.72931493476494	263.65743944636586	0.1906905901033196	269	1101197	6
6457	252.48943641956365	129.74146341463455	0.20648091634114582	165	1101362	3
6458	252.678542055368	271.3999999999994	0.3255120796069764	285	1101647	12
6459	252.82896211426637	267.7205479452043	0.24760888488998128	267	1101914	11
6460	253.44628539634948	314.5612903225794	0.24706020667904713	305	1102219	13
6461	253.97087140232082	305.9048859934845	0.24025814250364141	295	1102514	7
6462	254.25996473607916	282.88020477815604	0.21604166169097458	276	1102790	10
6463	254.6288856879693	291.1520599250923	0.25751931728912014	271	1103061	9
6464	254.39418345722945	231.15866261398298	0.22032911575148467	271	1103332	4
6465	255.1869597434625	333.6718120805356	0.383150053024292	320	1103652	2
6466	255.9413526044996	330.62624584717463	0.2526751475729001	314	1103966	1
6467	257.57092458570094	418.8985507246358	0.26813770395464603	339	1104305	8
6468	258.42991980719785	343.4704467353934	0.20336106823336694	310	1104615	14
6469	256.69023027455336	84.46096654275155	0.34927364349365236	200	1104815	13
6470	258.1028459574193	397.9517985611473	0.3397200184483682	372	1105187	5
6471	258.0611549591454	253.93374613003144	0.3343232357975378	277	1105464	6
6472	258.1999563788372	271.94129692832684	0.2530155249282244	283	1105747	11
6473	259.2957907918828	367.7833976833954	0.16059309684190173	298	1106045	3
6474	259.08697335219136	238.41404682274376	0.2355067182607688	257	1106302	7
6475	257.67541678592926	117.93131672597913	0.38630325849666153	172	1106474	8
6476	257.6675004559078	256.88378378378343	0.3943222956870919	268	1106742	4
6477	258.1197334268088	302.8907975460098	0.6548190104166667	375	1107117	12
6478	259.04668993869456	350.8153846153835	0.2700572028004451	337	1107454	10
6479	260.9685866756712	451.23636363636103	0.5071372679027731	373	1107827	9
6480	261.9047638226131	354.5863013698612	0.4233269942434211	323	1108150	2
6481	262.16163564747427	287.59194630872315	0.3031600510575764	311	1108461	1
6482	260.99935505742286	145.93357664233633	0.19713994958898523	182	1108643	7
6483	261.2815227971712	289.21612903225724	0.2133729722764757	252	1108895	3
6484	262.6276846684361	395.8977099236619	0.7595481116103046	353	1109248	13
6485	263.5544644255252	355.3056603773562	0.13030877840721	295	1109543	11
6486	262.49270423356677	157.3784452296824	0.14669335881868997	192	1109735	4
6487	264.2162491384258	434.8471947194698	0.25168925104914486	370	1110105	14
6488	262.5906580756129	101.6571428571432	0.09380650372238633	161	1110266	9
6489	262.81309411324116	284.8342618384394	0.4995705125022069	354	1110620	5
6490	263.573727147264	338.8763975155257	0.48574679830799933	368	1110988	6
6491	264.1947359075374	325.6746031746022	0.5179788631244298	274	1111262	12
6492	263.03545521512865	148.26666666666722	0.20802642738884264	183	1111445	1
6493	262.3218045735919	191.67039106145367	0.2824418487020842	289	1111734	8
6494	263.93003814075917	423.1451612903213	0.4484182758095824	324	1112058	10
6495	263.88499665902793	259.4258899676368	0.395927161501165	285	1112343	2
6496	262.32814669243766	108.2000000000003	0.11426792030562898	167	1112510	14
6497	261.22971953014905	152.4854304635767	0.08189366788280253	196	1112706	11
6498	260.34746581310844	173.00434782608755	0.10237883473490621	182	1112888	5
6499	259.0453789100794	130.1387755102045	0.15731198202350183	167	1113055	1
6500	257.9656760235057	151.07509025270798	0.17184095640440245	185	1113240	12
6501	259.2935109576228	390.74916943521333	0.28909898358722064	344	1113584	7
6502	259.7321704426412	303.1594594594584	0.3543517772967999	312	1113896	13
6503	259.7457012455894	261.08525073746273	0.5139929415911613	338	1114234	3
6504	259.9688193965322	282.05751633986847	0.37989402744037104	283	1114517	9
6505	260.05586785737114	268.67366548042645	0.31377419493252173	266	1114783	6
6506	258.78506601770323	132.9756838905781	0.08729845884615782	189	1114972	10
6507	260.9108210922932	471.3605734766992	0.4045869140625	375	1115347	4
6508	260.79616449427346	249.44516129032337	0.5970165093228748	311	1115658	8
6509	259.4201375572345	123.19347079037851	0.1370295069434426	176	1115834	7
6510	257.924478166395	109.85419847328282	0.10496580600738525	160	1115994	3
6511	258.30439127946784	295.9157894736821	0.24337788698303425	303	1116297	14
6512	257.6587596229406	193.74122562674202	0.5387671635068696	290	1116587	2
6513	258.0711568175857	298.8984790874505	0.19902406848451626	318	1116905	11
6514	258.3284452494098	283.7999999999986	0.43023118772706787	286	1117191	5
6515	258.9396793154342	319.4518518518494	0.2148027449569466	323	1117514	1
6516	259.1581486640122	280.7866141732279	0.22046900159530058	262	1117776	9
6517	260.94339607471045	437.68288973383807	0.44814384301975146	337	1118113	12
6518	261.23377530077653	289.98131868131736	0.34064347593934385	286	1118399	6
6519	262.95493754776874	433.3499999999979	0.283666313538808	353	1118752	13
6520	262.52545207005465	220.006389776359	0.1989118951628107	259	1119011	4
6521	261.28854061504757	138.8343065693436	0.06994214057922363	180	1119191	7
6522	263.1855070607489	450.9851851851817	0.20028350919572488	341	1119532	10
6523	262.03489279281695	148.12408026755924	0.16450009596975226	190	1119722	3
6524	260.96611920735455	155.15753424657584	0.11396899665753867	194	1119916	1
6525	261.4019213357443	304.54633204633075	0.2690383465620723	274	1120190	2
6526	261.40890212238685	262.09999999999957	0.2927262560069132	278	1120468	14
6527	262.33034251292764	353.55294117646963	0.11557161018823497	287	1120755	5
6528	264.28440750885096	457.73684210525863	0.2798000428734756	369	1121124	8
6529	262.86788083990575	122.63174061433497	0.12958924714909043	172	1121296	7
6530	263.09397311584405	285.47710843373454	0.5513357281331138	337	1121633	11
6531	262.853790573184	239.07571884984142	0.3542973445012019	260	1121893	6
6532	263.6642598616968	343.90071942445843	0.47859338906120225	301	1122194	12
6533	264.3807484106208	335.31311475409694	0.37073123380073214	318	1122512	9
6534	265.59776510233877	386.0824175824156	0.23818221365570263	314	1122826	4
6535	264.64355123084295	170.17637795275652	0.16974016689361734	187	1123013	14
6536	263.77854190237855	178.1426183844019	0.33521565593096364	251	1123264	10
6537	262.33866295817495	119.79064748201475	0.14992260932922363	168	1123432	5
6538	264.8032915957687	508.801526717555	0.33699356120453294	369	1123801	13
6539	263.7428435854714	158.75849056603823	0.150975717080606	185	1123986	8
6540	264.2305969677985	312.51818181818004	0.2438473636156892	292	1124278	1
6541	264.66021692404644	307.19259259259206	0.7633543365737872	353	1124631	3
6542	264.6508689920941	263.72542372881287	0.36292007942061993	277	1124908	2
6543	264.6545138857909	265.01535836177413	0.24703966060154875	284	1125192	7
6544	265.6135798580441	360.5611111111098	0.273213792674549	317	1125509	11
6545	266.01593004077205	305.8485981308402	0.19629257702436603	305	1125814	6
6546	265.7501893450155	239.44186046511675	0.26896219014266914	279	1126093	12
6547	265.74405038592823	265.1362934362922	0.24635636891033633	282	1126375	10
6548	266.97089559635464	388.42857142856894	0.4665283852435173	329	1126704	9
6549	267.56621020941463	326.50235690235536	0.33230731825623966	303	1127007	4
6550	267.5553266540333	266.4778546712795	0.2678119044150076	310	1127317	14
6551	267.5602997032824	268.05263157894626	0.5403266824701781	279	1127596	13
6552	267.3789923037338	249.42955974842877	0.2141874537748449	272	1127868	8
6553	268.0264385430581	332.12361623616107	0.322664585243277	294	1128162	3
6554	268.34645620890956	300.0282051282044	0.7628766377766927	300	1128462	1
6555	268.29202428777	262.90326409495543	0.5024590349327316	367	1128829	5
6556	267.7596764354647	215.0572390572401	0.22007682832215122	239	1129068	7
6557	266.46702392198114	138.49442508710845	0.1340058295281379	182	1129250	12
6558	267.6667425716502	386.4388888888873	0.24442059653145926	336	1129586	2
6559	267.5943622746466	260.4287128712863	0.2183786836781896	266	1129852	6
6560	267.1677097911407	224.92911392405225	0.29346700065052167	313	1130165	11
6561	266.6355830287997	213.95503355704759	0.68583792694344	242	1130407	4
6562	267.3644377248275	339.52105263157705	0.2658949957953559	288	1130695	10
6563	268.21017718596306	351.9383838383818	0.46742445267971205	318	1131013	9
6564	266.9509148301619	142.28394160583997	0.25470943241328986	182	1131195	7
6565	266.8585485390031	257.71428571428544	0.30833962826745914	279	1131474	8
6566	265.46537768775937	127.54146341463456	0.3807116829775234	187	1131661	12
6567	266.3836497059348	357.29257950529916	0.18636091677144692	313	1131974	14
6568	267.62003543109756	390.0222222222195	0.3336704527477609	321	1132295	13
6569	267.5325714111917	258.8736334405135	0.2626059195574592	272	1132567	1
6570	267.6508304721663	279.35847750864923	0.15692193549976013	285	1132852	3
6571	267.6279888341113	265.3666666666663	0.2352749482365965	262	1133114	2
6572	267.8381227388736	288.6413793103433	0.2528094375342653	285	1133399	5
6573	265.67848673441483	51.874522292994214	0.18410658954980955	201	1133600	6
6574	264.26553768796623	124.38358208955268	0.2145718310741668	188	1133788	10
6575	263.70392633624385	208.1044025157242	0.41562876798668685	245	1134033	4
6576	262.37894262843696	131.20555555555617	0.2735644234551324	180	1134213	14
6577	261.0741532021526	131.90000000000046	0.434454091389974	180	1134393	8
6578	261.9352904580099	347.18787878787697	0.3820644802517361	315	1134708	11
6579	260.90229987227036	158.63623188405833	0.1734870748316988	188	1134896	1
6580	259.6785639397937	138.52870662460626	0.22163287257648887	191	1135087	3
6581	259.77096197386516	268.9183673469378	0.3716435485612947	269	1135356	7
6582	260.0875312656911	291.42789115646144	0.1627523679259821	282	1135638	9
6583	260.3335979820197	284.69420289854963	0.2024677191207658	268	1135906	13
6584	261.05138064626726	332.11186440677784	0.2607817853083376	305	1136211	12
6585	259.8393738820581	139.85070422535264	0.18195967803130278	185	1136396	11
6586	260.68398014323753	344.2999999999982	0.5177972332324857	306	1136702	5
6587	260.22673774440256	214.95974025974138	0.2775184086390904	252	1136954	10
6588	259.2731396896677	164.86693227091678	0.15449441586687265	183	1137137	3
6589	260.27444289484714	359.403460207611	0.5523667592850943	315	1137452	4
6590	260.63401730647837	296.23188405797066	0.7041930387492168	399	1137851	2
6591	260.95134274855553	292.3665615141943	0.6967106321159077	293	1138144	8
6592	260.74700173486303	240.51724137931083	0.5895334266754518	249	1138393	7
6593	261.4071768788047	326.76451612903105	0.3128339082766802	312	1138705	14
6594	262.0957624805346	330.2657370517909	0.3939282843407164	282	1138987	1
6595	260.5057873118696	103.09824561403546	0.14869648477305536	161	1139148	11
6596	260.8508961054175	295.016666666666	0.5412257352321268	278	1139426	12
6597	265.04954099051713	680.7153846153774	0.5174402286572084	538	1139964	6
6598	266.4210423857238	402.19968051118013	0.2701067735919845	354	1140318	9
6599	267.455719109202	369.8887147335406	0.2474906610888104	344	1140662	13
6600	265.89553418088366	111.43722627737263	0.16751401218367212	162	1140824	14
6601	266.0447706198967	280.8191780821906	0.2198094238728394	273	1141097	10
6602	264.701580753419	131.72578397212587	0.12668449613783095	180	1141277	7
6603	264.8449300252499	279.0365079365068	0.2730731699201796	288	1141565	5
6604	265.46708678560344	327.0606060606047	0.17562021433688366	289	1141854	3
6605	265.2224256897344	241.00097719869825	0.34449545053335334	260	1142114	2
6606	266.16623603491314	359.603460207611	0.393675295308756	313	1142427	8
6607	266.8337106608654	332.91369863013546	0.22833887736002603	300	1142727	1
6608	266.3121382601391	214.67647058823601	0.4741522760102243	264	1142991	11
6609	267.5232859805277	387.42691029900084	0.2113338736600654	344	1143335	4
6610	267.4113359490052	256.32828282828257	0.317184795032848	264	1143599	12
6611	267.471277572333	273.4054982817855	0.20251653598666602	289	1143888	9
6612	267.81786109290596	302.1296296296281	0.21846814399218037	274	1144162	13
6613	267.76475762648556	262.50751445086655	0.18048013680624067	293	1144455	6
6614	267.1148118046067	202.77017543859716	0.2937503693595765	252	1144707	7
6615	265.7312404783695	128.75767918088792	0.13778804800363892	179	1144886	11
6616	266.96500998484856	389.10819112627655	0.3728950500488281	340	1145226	14
6617	267.26659717313566	297.12372881355805	0.4517904511580231	282	1145508	3
6618	268.3488053272784	375.48741258741103	0.7779815673828125	370	1145878	10
6619	269.5593172740056	389.39999999999793	0.2623251993148053	305	1146183	2
6620	271.7157022034553	485.1978102189761	0.47643596878468664	366	1146549	5
6621	272.0548785147541	305.63333333333173	0.6323184137759001	276	1146825	12
6622	273.10455195182874	377.0222222222207	0.46662940276912385	326	1147151	8
6623	273.3990870774717	302.5580645161279	0.2867792232616528	296	1147447	4
6624	274.58880208904986	392.3705882352921	0.2312037748448989	340	1147787	1
6625	274.26032676657206	241.74126984127048	0.3372547149658203	280	1148067	13
6626	273.30147712209475	178.375362318841	0.42514225152822643	208	1148275	3
6627	274.2587326211441	369.0270270270254	0.49052313250973595	329	1148604	9
6628	274.81519291398024	329.9047619047604	0.2163623821772752	319	1148923	7
6629	278.01998216131096	595.2941176470541	0.26023870482480616	399	1149322	6
6630	279.09097152888705	385.11891891891725	0.3848338141285701	337	1149659	14
6631	279.95599492396605	365.59331103678795	0.42245374744521574	323	1149982	2
6632	281.5999740081836	444.35390334572213	0.43890280873007925	351	1150333	10
6633	282.12245931793564	333.84850498338693	1.2358033195374505	315	1150648	5
6634	282.85089669658726	354.96619718309756	0.5158909610816237	393	1151041	11
6635	281.4257917031313	140.34039735099392	0.22931469066722973	185	1151226	3
6636	281.9304817414903	331.894795539032	0.20502387893783464	286	1151512	4
6637	283.3084304452022	419.7253521126743	0.20204473096270895	344	1151856	12
6638	283.5163834078309	304.10372670807266	0.3545372302715595	312	1152168	1
6639	284.54944792020933	386.82283464566797	0.21291589736938477	304	1152472	13
6640	284.2690826927079	256.51292517006704	0.2817704909506475	257	1152729	7
6641	286.1479342386621	472.15423728813084	1.6786043388898984	430	1153159	8
6642	284.7457906626988	145.93357664233633	0.1672673801799397	182	1153341	3
6643	285.10197981489534	320.3647058823518	0.18485446770985922	288	1153629	14
6644	286.542589646376	429.1629629629596	0.3569266888083619	337	1153966	6
6645	285.03525964032315	135.80958904109636	0.13075883047921316	182	1154148	12
6646	285.6134932508164	342.8586206896522	0.3127361278438089	398	1154546	9
6647	285.2076259239421	245.02676056338154	0.21098433274489184	260	1154806	10
6648	285.17012482810134	281.4575163398687	0.17143908173980185	289	1155095	5
6649	285.37275691315364	305.433333333332	0.16300825763949386	278	1155373	4
6650	285.8764987317772	335.7469387755088	0.18157089475601437	315	1155688	2
6651	286.21669478342045	319.8961038961025	0.4272234981390579	339	1156027	11
6652	286.01465698687775	266.0129151291504	0.2536585049366388	254	1156281	13
6653	285.5455403173412	239.1029900332241	0.17003181227872205	299	1156580	1
6654	286.8882816354792	419.8196721311441	0.23131842752104825	309	1156889	7
6655	285.0233706501103	100.3971830985919	0.2863125163278762	157	1157046	5
6656	285.02852155899376	285.5384615384604	0.24364492055532094	259	1157305	3
6657	284.55650367013646	237.82673267326817	0.22164050251448236	294	1157599	8
6658	283.3396104481069	162.86718146718212	0.1787095765809755	185	1157784	2
6659	283.04267185996565	253.6457516339873	0.1530876718597971	273	1158057	14
6660	283.2715784746993	305.93333333333214	0.36652796259729853	273	1158330	6
6661	281.61847858399204	117.96158940397405	0.13455382309391	177	1158507	11
6662	280.0719557699831	126.96619718309901	0.17522209917189757	173	1158680	13
6663	280.4436239673853	317.2387755102028	0.1770207946364944	296	1158976	12
6664	280.1944336293508	255.5245901639344	0.2384543839196666	329	1159305	9
6665	278.6093506069259	121.68613138686172	0.16492796226366033	169	1159474	5
6666	278.71597984228964	289.272274143301	0.18901671152266245	315	1159789	4
6667	277.07469893660027	114.58788927335675	0.11198544502258301	168	1159957	14
6668	278.5904320695584	428.648012232413	0.3708438602104006	422	1160379	10
6669	278.5421907525258	273.76630036629905	0.15659915276293485	265	1160644	8
6670	278.57255132234195	281.57824773413785	0.674301406084481	295	1160939	7
6671	278.19523818025255	240.84123711340266	0.4964456593418473	271	1161210	2
6672	280.5801986904361	516.6912891986021	0.508894074461091	407	1161617	1
6673	280.2249156908735	245.0518987341787	0.3005415739836516	270	1161887	6
6674	280.6143690429253	319.17025089605596	0.27984046936035156	284	1162171	11
6675	281.413816099827	360.5590747330945	0.2087341407676796	308	1162479	13
6676	281.2315730699149	263.189513108613	0.4124529105258653	251	1162730	4
6677	281.02024014723867	260.09828080229215	0.24499514331556346	292	1163022	12
6678	280.60645044417896	239.6412698412706	0.36348123645465635	301	1163323	5
6679	286.7424065158688	894.2020576131637	0.5606601758934986	522	1163845	3
6680	286.43931578404346	256.43333333333305	0.26187224886310634	268	1164113	10
6681	287.1659661044639	359.1043478260857	0.33272552490234375	321	1164434	14
6682	287.83444465480136	354.01382113820955	0.2027815955025809	280	1164714	1
6683	287.7659072257972	280.9807017543836	0.21223946106739533	312	1165026	7
6684	287.28381046356964	239.55623100304118	0.694211031483338	339	1165365	8
6685	285.4573519209777	104.63795620437992	0.22477347987472632	157	1165522	5
6686	285.9476555348737	334.4877133105782	0.26485774719637206	306	1165828	6
6687	287.11074826791446	402.2569288389491	0.4657460625669295	321	1166149	11
6688	287.7324245690191	349.2783783783763	0.36755207982556576	290	1166439	13
6689	288.0963730506016	324.12727272727074	0.3585059450383772	285	1166724	12
6690	288.27235705528716	305.6947735191624	0.47353057329663	287	1167011	4
6691	290.3157243938252	492.6090909090862	0.34652190682775685	382	1167393	2
6692	290.14761495865184	273.5047808764928	1.0011958167666482	252	1167645	10
6693	296.1828054757319	893.6666666666612	0.4401578918359996	629	1168274	9
6694	296.20944655677704	298.8469135802464	0.2634747051202451	313	1168587	3
6695	296.6495994410326	340.22473498233086	0.30253397292345274	307	1168894	14
6696	294.881186491605	119.8083044982703	0.16807990203032622	185	1169079	13
6697	295.6277275678654	369.5352941176456	0.5723459421630074	311	1169390	1
6698	294.0577287731994	138.6278481012664	0.27964047162960737	195	1169585	2
6699	294.271987306363	315.4835820895503	0.6013130711304152	277	1169862	6
6700	293.48664596437277	215.73785310734542	0.3895652179788399	271	1170133	5
6701	293.5405934582174	298.88139534883635	0.3135926096062911	266	1170399	4
6702	293.7574451923469	315.2257668711642	0.2008524885573707	313	1170712	7
6703	293.7455780574966	292.57073170731667	0.27302116018826844	305	1171017	12
6704	294.31070122428997	350.25789473683847	0.5084030312835854	378	1171395	8
6705	295.42535891792943	405.77647058823305	0.48797758712984685	353	1171748	11
6706	296.18719304804836	371.6087719298215	0.32420154787459465	318	1172066	9
6707	297.5124963752998	428.71752577319364	0.44640939391915957	351	1172417	10
6708	296.0115067498927	147.41353383458707	0.2109057250635584	179	1172596	4
6709	295.24282411482625	219.14324324324414	0.46374613444010415	240	1172836	2
6710	295.49435691263903	320.39610389610243	0.32209140526320407	334	1173170	3
6711	293.9053843580054	136.59710144927575	0.24893887504857248	191	1173361	12
6712	293.42795120408056	246.16206896551796	0.3285445651492557	296	1173657	1
6713	294.80666123907804	431.2989547038297	0.2919781322210607	355	1174012	13
6714	296.73575252142405	487.7157894736791	0.4493944044237013	385	1174397	14
6715	298.38251620833097	461.4121212121192	0.22231538975960238	347	1174744	6
6716	298.9011240359384	350.24329896907045	0.19080817661101412	311	1175055	5
6717	298.56554136700754	265.34285714285676	0.20153026058249277	292	1175347	7
6718	298.5201716676232	294.02857142857056	0.26417575039706387	273	1175620	11
6719	297.91693458117203	238.19646302250896	0.19138943174350187	318	1175938	8
6720	297.8254015989967	288.76363636363493	0.49172651811079543	275	1176213	9
6721	297.4868465796622	263.96989966555157	0.28754805100451614	269	1176482	4
6722	297.8897053865928	337.7727272727251	0.3152267040849543	294	1176776	2
6723	298.70051967293307	378.97113402061643	0.6539346505929758	333	1177109	10
6724	297.1113523140416	139.78378378378423	0.20277009186921297	189	1177298	5
6725	297.1199054575678	297.96666666666556	0.1323295806671356	286	1177584	1
6726	297.24639921344965	309.7692810457505	0.2572321065266927	300	1177884	13
6727	297.1123735774795	283.84383561643716	0.14488907411210372	277	1178161	14
6728	298.7539488036424	461.2698961937696	0.4247730947768462	369	1178530	3
6729	299.5390691795515	377.26598639455517	0.3104439999194855	376	1178906	12
6730	298.8346540975121	229.0975609756111	0.23762825607810323	269	1179175	6
6731	296.97155317057207	112.52456140350921	0.12718790630961574	172	1179347	4
6732	297.21664269301795	321.4805054151607	0.2099741022069971	286	1179633	11
6733	297.7890663720948	354.4590106007055	0.20250721850426368	306	1179939	7
6734	296.0937607423875	128.2585034013609	0.10645598939011217	179	1180118	10
6735	295.66003092717136	252.72077922077997	0.20882119554461856	264	1180382	9
6736	295.39894785927896	269.55172413792974	0.2579064635095986	269	1180651	2
6737	293.4744976298329	102.95392491467621	0.13651006977732588	164	1180815	11
6738	291.9247526535346	138.50000000000048	0.16154253071752087	174	1180989	6
6739	290.8883431158261	188.2837988826826	0.28680265619513695	267	1181256	1
6740	290.443548120042	246.40884353741552	0.19293200969696045	256	1181512	14
6741	291.3195084092343	378.0395770392714	0.4947154944022877	418	1181930	8
6742	291.3763133251419	296.9999999999991	0.35121876706359206	279	1182209	12
6743	291.0865829787757	262.4032786885236	0.2673387494917209	293	1182502	4
6744	291.4939265352695	331.8209386281568	0.34149419568729694	327	1182829	13
6745	291.03443387185854	245.54466019417552	0.25051530444895037	262	1183091	7
6746	291.4087531968036	328.46636636636447	0.28238795043299436	378	1183469	5
6747	291.7900178660934	329.53522012578406	0.38399903774261473	320	1183789	3
6748	291.6062995056143	273.41818181818013	0.12441275229302397	283	1184072	9
6749	292.254355391677	356.4118881118869	0.28982263878930975	316	1184388	10
6750	291.5176603226087	218.5848484848496	0.42347212925853345	298	1184686	2
6751	291.51940424918394	291.6920529801311	0.3121778786587877	294	1184980	11
6752	289.9827102066921	137.85000000000065	0.5834570712730532	183	1185163	7
6753	289.6017683505268	251.8885245901647	0.24311631449152915	267	1185430	1
6754	290.52210154421454	381.635087719295	0.2512905959374395	323	1185753	6
6755	290.83444943336605	321.75689045936235	0.20614122663225445	315	1186068	8
6756	289.5093226512095	158.3217712177127	0.17917067991858499	187	1186255	9
6757	288.93615005961806	232.19206349206434	0.19134692656688201	312	1186567	14
6758	288.9805950106348	293.38064516128924	0.18349606228857926	291	1186858	4
6759	289.07320040804615	298.24113475177234	0.2327010999016437	279	1187137	5
6760	289.23083926489284	304.83708609271406	0.27029343944484907	295	1187432	13
6761	288.9668791150554	262.8348242811498	0.2375576101618705	278	1187710	3
6762	289.6270992127937	354.98888888888786	0.3090409724670049	338	1188048	12
6763	288.12077558908686	138.99473684210562	0.11167851914750769	188	1188236	2
6764	288.39069209355097	315.11242603550204	0.3551348795933006	339	1188575	10
6765	288.9514815288908	344.46963562752825	0.30580975932459675	279	1188854	6
6766	290.29725510311494	423.52883895130856	0.3404999008407822	333	1189187	11
6767	290.85806633586753	346.3783783783771	0.3608000704487289	319	1189506	7
6768	291.59081900584215	364.133333333332	0.8482001582278481	316	1189822	14
6769	293.4080358157837	473.31249999999693	0.6228277960488963	344	1190166	9
6770	293.1899554576259	271.599999999999	0.562666930073984	283	1190449	5
6771	294.4828740848678	422.4818181818143	0.2697693042540818	356	1190805	8
6772	295.45964966056584	392.1604316546735	0.23466245283991655	322	1191127	13
6773	297.39074220989653	488.5689045936361	0.6192013882847299	449	1191576	1
6774	298.0878487738115	367.10139860139736	0.18801458322318496	314	1191890	3
6775	299.8450273202939	473.80570342205056	0.17524283119801726	356	1192246	4
6776	299.6096834300697	276.3106382978706	0.10198697717018959	321	1192567	12
6777	298.23265508891967	161.90684931506897	0.14070501082982773	195	1192762	6
6778	296.5628658514633	131.2537313432841	0.09167628581297464	179	1192941	7
6779	297.7375153884374	414.0278195488679	0.21868364488756334	370	1193311	2
6780	296.12895573270794	136.8815498154987	0.09629341761271158	180	1193491	9
6781	296.03948435719906	287.1818181818166	0.23120366562531605	309	1193800	10
6782	296.1154228469604	303.63333333333253	0.3277705682290567	296	1194096	11
6783	294.42960195182417	127.53333333333393	0.13649109431675502	182	1194278	3
6784	294.2555108793024	277.02049469964504	0.14861386994717538	303	1194581	14
6785	293.30995577050936	199.70000000000078	0.4140725816999163	252	1194833	1
6786	293.8404825103821	346.3626297577841	0.17804576364324612	307	1195140	13
6787	292.1797048039224	127.76271186440718	0.1688489647550956	179	1195319	9
6788	293.4484027391607	419.0494983277572	0.6454014711353291	357	1195676	5
6789	293.2852026623864	277.1283950617282	0.7060568546903306	345	1196021	8
6790	292.8093506357625	245.70000000000147	0.27959065894558005	292	1196313	6
6791	293.8027803082128	392.1523178807928	0.36676042879208454	349	1196662	4
6792	293.60950519330265	274.4752688172034	0.1663989804825693	265	1196927	2
6793	292.2894101413696	161.60000000000053	0.3230137851068882	183	1197110	3
6794	291.89715801526455	253.064197530865	0.4008511980518107	277	1197387	10
6795	292.9218787428042	394.36923076922875	0.32918237523270705	363	1197750	7
6796	295.8835229690747	589.0863013698572	0.4476074474127223	478	1198228	12
6797	295.9407646624609	301.6076923076911	0.36359375598383886	306	1198534	11
6798	295.83423334092464	285.28763250883264	0.14510185530095576	291	1198825	14
6799	295.2747012969045	239.88102893890738	0.17803393509308202	269	1199094	13
6800	295.16495428393546	284.29999999999933	0.20855101996045095	281	1199375	9
6801	294.1897206432368	197.6415902140684	0.1895219092275582	255	1199630	6
6802	294.4702738184838	322.24503816793816	0.29814759890238446	288	1199918	8
6803	295.0093357861813	348.376470588234	0.3149147033691406	302	1200220	4
6804	295.10457576165277	304.5333333333321	0.24553023813493577	287	1200507	3
6805	295.969459581501	381.59295774647717	0.3220404901448086	338	1200845	5
6806	296.5183263891947	350.85614035087445	0.16511202615404885	315	1201160	2
6807	295.5507328688925	199.75897435897508	0.2503232683454241	245	1201405	7
6808	295.75147700219185	315.62514619882984	0.4685370468511814	410	1201815	1
6809	295.0068746900824	221.2912457912469	0.28280942948138127	244	1202059	11
6810	295.43633758875114	337.9531645569604	0.2595789417717027	322	1202381	10
6811	296.02404317838085	354.2068965517215	0.225967622475938	319	1202700	12
6812	295.16873334596613	210.49305993690948	0.3744601029616136	260	1202960	14
6813	292.8062767817372	58.923076923077275	0.188649410671658	180	1203140	2
6814	293.5038759857508	362.56619718309736	0.41557268690235605	317	1203457	13
6815	294.67828167033775	410.94444444444144	0.47193282806944703	334	1203791	9
6816	295.0675923788142	333.60935251798384	0.34757191426045186	296	1204087	4
6817	295.33908021809225	322.21637630661854	0.2789045797811972	296	1204383	3
6818	294.97283227305417	258.7142857142855	0.304028904570966	269	1204652	5
6819	297.0769512785679	505.38473282442544	0.37906431433272686	365	1205017	6
6820	297.97140041529985	386.5218649517657	0.4056351060812184	346	1205363	8
6821	296.56839389414006	157.6707482993201	0.20564527661388457	191	1205554	14
6822	296.6241106772203	302.1400722021646	0.4401667352932603	335	1205889	7
6823	297.54039588623755	388.25263157894403	0.3062621417031011	327	1206216	1
6824	297.30749996596035	274.25080385851976	0.4033299107705393	279	1206495	12
6825	296.6091825420583	227.47575757575873	0.1278567632039388	300	1206795	10
6826	297.41084634364734	376.77556270096176	0.21088965688040345	347	1207142	11
6827	295.892204015669	145.5466135458172	0.11850188950360832	177	1207319	3
6828	295.31525705339396	238.19750778816314	0.14881800525593308	265	1207584	2
6829	296.0617380706463	369.96335877862487	0.2739246877862887	307	1207891	13
6830	293.7449144642589	64.37937743190699	0.20687305347339527	185	1208076	7
6831	295.7155605577115	490.8095238095197	0.8954947335379464	329	1208405	9
6832	295.81523253834126	305.6827586206878	0.18184328245368983	287	1208692	4
6833	294.47719829413865	162.01180811808172	0.290538033062124	187	1208879	1
6834	294.7418501030188	320.9423791821547	0.3006940223801304	284	1209163	6
6835	294.1033541609112	230.89225589225705	0.16486720196214547	249	1209412	14
6836	295.0370898500713	387.4769230769218	0.3102412264112016	355	1209767	5
6837	295.6561579759608	356.9439024390218	0.23647441634212632	332	1210099	8
6838	295.29847927908406	259.8882882882882	0.3276175509072024	283	1210382	12
6839	295.489056323749	314.356183745582	0.3458278372936451	283	1210665	11
6840	295.97916576051153	344.4999999999988	0.3273927788985403	304	1210969	10
6841	294.38123375202923	136.18596491228112	0.10697550273073313	181	1211150	7
6842	292.6492395963271	121.18181818181868	0.14995339071962255	169	1211319	9
6843	291.1899196141569	146.71724137931082	0.1612428675360858	187	1211506	4
6844	289.76710260979615	148.90821917808267	0.11501260513954974	188	1211694	6
6845	288.0775146286809	120.80830449827027	0.12486615862165179	175	1211869	14
6846	289.7761126167224	457.93731343283184	0.26236954841060917	345	1212214	3
6847	292.0535415731998	517.5190082644608	0.5382202232973727	361	1212575	2
6848	293.76255597296597	462.9549815498134	0.4121064623536547	351	1212926	13
6849	293.52235146586787	269.7421052631568	0.30352333198159426	295	1213221	1
6850	294.3441421356063	375.70141843971476	0.26229817867279054	320	1213541	8
6851	292.4541158085899	105.34150943396273	0.18584932282913563	172	1213713	3
6852	292.5322879372173	300.2713286713277	0.48700517310691804	283	1213996	11
6853	292.7838803672914	317.6915309446247	0.751772757137523	340	1214336	5
6854	292.25396464054154	239.79230769230827	0.31466683037847065	278	1214614	7
6855	290.9242431759543	159.28181818181866	0.20125153724183428	188	1214802	13
6856	291.8721415892652	385.71408450704087	0.33166637190853254	332	1215134	12
6857	291.8201335491687	286.6713375796162	0.2179050385387914	317	1215451	10
6858	290.6300091367539	172.80769230769272	0.38624120495983005	194	1215645	1
6859	292.5269590453864	480.32499999999675	1.0763859315352007	352	1215997	9
6860	293.63599979976004	403.4310344827552	0.5140519696612691	344	1216341	4
6861	293.5579904511131	285.83506493506445	0.3889350628030711	290	1216631	2
6862	294.37397368653365	375.1563139931708	0.28811149485952303	343	1216974	6
6863	296.0260541743874	459.58202247190746	0.23434309725802638	347	1217321	14
6864	294.58697868602434	152.11850533807888	0.15141113855505503	186	1217507	12
6865	294.2410030971163	259.98941979522135	0.4301083213404605	266	1217773	8
6866	292.68487154715774	138.6278481012664	0.18715497530423678	195	1217968	1
6867	293.0412522223671	328.3229390680985	0.23969217936197917	300	1218268	3
6868	293.49411486792866	338.32751677852207	0.270994503257329	307	1218575	11
6869	291.9581210876704	139.89473684210566	0.2246987113739525	179	1218754	14
6870	291.501352826434	246.28129496403	0.24797035499855324	270	1219024	10
6871	292.2779578548707	369.1618556701012	0.31131944423768576	328	1219352	5
6872	292.1093891606757	275.4210884353732	0.6312975602991441	272	1219624	9
6873	292.54333124029193	335.5035971222992	0.48681990396669056	349	1219973	7
6874	292.62721765578016	300.93197278911447	0.1817631309007691	289	1220262	2
6875	293.06315600553813	336.221052631576	0.24345317139432437	321	1220583	4
6876	293.7174414129918	358.49169675090013	0.15871453818421774	313	1220896	6
6877	295.9077049550662	512.7437956204332	0.5791251329871697	492	1221388	13
6878	294.2649992410204	131.63713355048918	0.29665990165583994	181	1221569	5
6879	294.08345322414533	276.11039755351646	0.2879897968189136	296	1221865	1
6880	293.80691242127676	266.4293729372927	0.2447053404415355	272	1222137	3
6881	295.5722718684926	470.34285714285323	0.4188032851881812	367	1222504	8
6882	295.7147888501822	309.823970037451	0.4835008047159436	309	1222813	11
6883	294.03586484227736	127.822388059702	0.16017784855582498	176	1222989	6
6884	296.3807167201703	528.5210526315734	0.2623169865440484	398	1223387	12
6885	296.81556172688164	339.86521739130285	0.27235410020158096	296	1223683	9
6886	297.96707392968204	411.96678200691866	0.3385787385545736	343	1224026	14
6887	299.48551829829887	449.81151079136305	0.3524241514232646	357	1224383	10
6888	299.5549448054567	306.428169014083	0.25517989870101687	315	1224698	2
6889	299.68876790642173	312.93725490195965	0.3635198396701749	301	1224999	4
6890	300.2357691162464	354.3888888888869	0.29695867937664655	344	1225343	7
6891	299.115842797633	188.2431372549023	0.1741540762094351	195	1225538	12
6892	298.8807393524745	275.6054982817858	0.420003712400515	267	1225805	3
6893	297.220127542546	132.819558359622	0.1857627250052787	185	1225990	14
6894	297.5918034002263	334.3877133105782	0.4002860998097771	307	1226297	5
6895	297.9867315200701	337.08461538461404	0.14067667426792443	282	1226579	11
6896	298.0984294222607	309.1565217391292	0.1474857399179617	277	1226856	6
6897	298.58365734668763	346.62122186494946	0.1615386052962837	327	1227183	1
6898	300.15778155753446	455.9960784313699	0.3425009047880201	341	1227524	8
6899	300.3976187079455	324.1414965986382	0.41536066087625795	295	1227819	9
6900	302.35932708462445	496.5684563758356	0.5770596145489894	436	1228255	13
6901	302.13349482006754	279.77610062892984	0.47410184503022856	283	1228538	10
6902	302.31035659317837	319.8196721311462	0.3728892996087429	309	1228847	4
6903	302.22812841665467	294.0875389408091	0.320939723277252	298	1229145	7
6904	300.67887285596083	147.30257234726733	0.5097383441347064	198	1229343	3
6905	300.07920016835686	240.71160409556418	0.24989529106560654	254	1229597	12
6906	298.22974150000664	115.13333333333375	0.2492708448547026	181	1229778	11
6907	299.95087265643514	470.3428571428533	0.35371806381184007	367	1230145	2
6908	298.78897359529833	183.7609665427516	0.1742760371235968	206	1230351	1
6909	297.0094830688315	120.839920948617	0.20582981767325564	174	1230525	8
6910	297.3585269242746	331.9138686131378	0.2819965870307167	293	1230818	5
6911	297.8178257130029	343.2884057970999	0.458412426430107	298	1231116	6
6912	297.96992331794183	313.02758620689553	0.30047970840983584	317	1231433	14
6913	296.2716746776478	128.145059288538	0.13110906812879775	180	1231613	4
6914	296.81392808012504	350.4970149253705	0.45325154622395836	300	1231913	9
6915	295.129322849503	128.35340501792163	0.20779501425253377	185	1232098	11
6916	295.0925767908193	291.45471698113084	0.2864070526541096	292	1232390	10
6917	296.7122224514825	457.0571428571393	0.4205686424960609	357	1232747	13
6918	295.20022303398525	145.51228070175486	0.1982708076121276	193	1232940	8
6919	295.23609036886273	298.7869565217379	0.22712276963626638	272	1233212	2
6920	295.74684540720307	346.3115942028969	0.15683546819184957	304	1233516	7
6921	296.0197102864643	323.03333333333177	0.35233107307888817	302	1233818	12
6922	296.43064457046097	337.11313868613	0.21115539939540207	314	1234132	1
6923	296.52633812475636	305.9999999999983	0.3500724049796045	339	1234471	3
6924	294.7036553886701	114.25806451612938	0.302763954887177	179	1234650	9
6925	294.3234281993319	256.68093645484925	0.23661984530362215	275	1234925	5
6926	293.9500317551764	256.98378378378334	0.22349695498577218	267	1235192	6
6927	293.80833452642764	279.7803088803071	0.21163248522528286	290	1235482	14
6928	293.75214591800545	288.18947368420885	0.5822466486150568	275	1235757	11
6929	292.4035660395814	158.89415807560187	0.2791850094867842	197	1235954	2
6930	293.8733034288309	439.3773049645369	0.2446030688886883	357	1236311	4
6931	292.2114711037625	127.6900709219864	0.11567793109200218	176	1236487	9
6932	292.41677710469895	312.74207119740936	0.2787971496582031	302	1236789	8
6933	292.01375219079483	252.11428571428715	0.6039671940590019	335	1237124	13
6934	291.79174165301384	269.81269841269733	0.18006318744860197	285	1237409	7
6935	290.005955549615	113.21313131313175	0.21193152533637152	180	1237589	14
6936	289.28432842655127	217.84324324324416	0.377426569640872	253	1237842	1
6937	288.94912124543765	255.76361031518658	0.7434776222312843	364	1238206	10
6938	288.3319018776435	227.22718446602016	0.23536826509878456	251	1238457	3
6939	289.6048769765141	415.6294117647041	0.1685629007292957	328	1238785	12
6940	288.06192409715993	135.30958904109642	0.13207735479834246	187	1238972	9
6941	288.06462168787147	288.33168316831564	0.23202460920306997	284	1239256	11
6942	289.7196512389108	453.5675767918042	0.49128323509579613	378	1239634	5
6943	289.731642814296	290.918808777429	0.4636481148856027	350	1239984	6
6944	289.7295839112366	289.52575250836065	0.2333024863246497	281	1240265	4
6945	288.11751195272126	128.522388059702	0.17684233400243274	169	1240434	1
6946	288.6565955744528	342.0258741258725	0.3199187755584717	320	1240754	2
6947	287.18676787374187	141.67382550335626	0.2009645175439706	193	1240947	3
6948	287.0269334175958	271.2033222591357	0.1405743347608656	277	1241224	13
6949	286.12749952645777	197.08354430379867	0.6429353471235796	275	1241499	14
6950	287.02219185145464	375.596732026142	0.2929956854843512	328	1241827	7
6951	287.9794244783946	382.7454545454516	0.17972673000973483	317	1242144	12
6952	287.6678218503771	256.8191616766468	0.5271394644210587	335	1242479	10
6953	286.2466290687665	145.54854368932104	0.44909050538367834	194	1242673	5
6954	284.7273073563921	134.3144578313259	0.26523075501124066	192	1242865	4
6955	286.26495148028033	438.4917197452171	0.4681943347831708	423	1243288	8
6956	286.3601715306949	295.7869565217374	0.4186860394004165	302	1243590	9
6957	285.08315472104834	158.65849056603827	0.20450655619303384	186	1243776	14
6958	285.53459469701664	330.2271523178794	0.18231448005227482	306	1244082	6
6959	286.7174797969779	403.82310469313785	0.31301508848428	329	1244411	1
6960	284.95316706797365	110.28620689655222	0.1834412508232649	172	1244583	12
6961	284.8383267553186	273.4691358024689	0.482576733229482	289	1244872	2
6962	283.39031737500574	140.03738872403605	0.5429906892539257	201	1245073	8
6963	284.9196889265304	436.32747252746975	1.0257548070680402	361	1245434	13
6964	289.77273922827624	770.2247191011187	0.4487782021562657	499	1245933	11
6965	292.064038681631	518.9026845637554	0.618048073588938	414	1246347	3
6966	290.515720328713	137.23220338983094	0.3051121414348643	186	1246533	6
6967	290.3738775908346	276.3314465408796	0.2807337887637265	286	1246819	4
6968	288.87060690003267	140.04680851063875	0.24880240556132588	173	1246992	12
6969	288.5047236538552	252.28228228228357	0.509005543380278	299	1247291	5
6970	290.2408828230105	462.1206405693923	0.3493847952948676	360	1247651	7
6971	292.07036909967553	473.1895104895086	0.26733738888976394	372	1248023	10
6972	292.4646065851494	331.4941176470578	0.19878295738937962	287	1248310	9
6973	292.72218918823984	318.22286689419616	0.24856738916179477	298	1248608	14
6974	293.8381914956457	404.32241992882354	0.2742292157880537	333	1248941	1
6975	292.1384489858937	123.86394052044656	0.05421168817950122	173	1249114	12
6976	290.3848658428361	116.7801346801351	0.049883033452409034	178	1249292	4
6977	290.24537606942516	276.4358885017412	0.25880541120256695	266	1249558	13
6978	292.69614760517356	535.3225296442665	0.4770834844371684	377	1249935	2
6979	292.2628684395911	249.36823104693198	0.3495742920412117	249	1250184	3
6980	290.44661514951696	110.63753943217719	0.20578011133337534	186	1250370	10
6981	291.4932309652349	395.1081967213093	0.21927662841085094	343	1250713	8
6982	289.75990005418396	118.16013986014052	0.12807125515407985	216	1250929	9
6983	290.04174178312536	317.94407294832735	0.21724746946304563	315	1251244	11
6984	290.54322790227155	340.19035369774696	0.3866101886154315	327	1251571	6
6985	291.14229897895353	350.45033557046827	0.6430705547332763	320	1251891	7
6986	289.3569785532666	112.6102564102569	0.1999871361064401	187	1252078	1
6987	290.88464281028706	442.12340425531664	0.3850395725197988	365	1252443	5
6988	289.49676935515714	152.09729729729784	0.21178331897033387	201	1252644	2
6989	289.5296497628714	292.78481012658153	0.3755844779636549	299	1252943	14
6990	287.70373257558754	106.93793103448323	0.1321704262181332	171	1253114	8
6991	287.439777010838	261.3081761006283	0.30890059385675683	279	1253393	12
6992	287.5836248547647	301.82456140350683	0.38089503353214604	279	1253672	4
6993	285.9055167028938	119.77280966767422	0.13401259177642344	191	1253863	9
6994	284.43223202766814	138.57704918032843	0.24771734227471173	187	1254050	6
6995	284.4992298394047	291.13201320131907	0.17503300175122324	289	1254339	3
6996	285.7193236337258	406.50860927152115	0.3657261110701651	371	1254710	13
6997	285.7894637307219	292.73333333333187	0.4044166940157531	305	1255015	10
6998	285.74754345238904	281.59743589743516	0.2588024400684932	292	1255307	11
6999	285.462210875008	257.2142857142855	0.25030265055911644	284	1255591	7
7000	285.21119915586826	260.3610389610387	0.7552184523197643	285	1255876	1
7001	283.58448313746396	122.53959731543681	0.1836653954344369	183	1256059	4
7002	284.0192746697257	327.06363636363426	0.25583904736662566	292	1256351	5
7003	283.6305285249702	245.14466019417551	0.1806163357612782	266	1256617	14
7004	283.5247289868469	273.0505747126424	0.20209029676385426	257	1256874	12
7005	284.25037058586736	356.0888888888872	0.32835355519519305	327	1257201	2
7006	282.55717722483627	114.9310344827593	0.12356590704105827	229	1257430	6
7007	281.0947752639087	136.31698113207594	0.15928049556544568	183	1257613	11
7008	279.83821347618186	155.43859649122854	0.1710202969498371	199	1257812	13
7009	280.1506091191978	311.07777777777693	0.17888082917203607	291	1258103	9
7010	278.41515431005706	106.60512820512895	0.06994904806447584	215	1258318	1
7011	278.073234555036	244.22317880794773	0.30396826126996207	272	1258590	10
7012	278.3791597437322	308.66575342465507	0.2854832725638098	337	1258927	3
7013	279.02499811571386	342.96299694189366	0.23657619709871253	392	1259319	8
7014	277.3326102035222	109.78620689655223	0.18838380285575565	177	1259496	11
7015	277.1629964302541	260.37123287671125	0.1817924555610208	272	1259768	14
7016	275.8796781542633	148.8311688311694	0.374406287418538	199	1259967	9
7017	275.6459340042996	252.50526315789486	0.3736775716145833	270	1260237	12
7018	277.01308001542714	412.36053511705495	0.21279306705592393	357	1260594	7
7019	276.47082237161504	222.78731563421925	0.32225536990475345	308	1260902	5
7020	275.57732626911104	187.1212121212129	0.13609537637856112	249	1261151	2
7021	276.38494694581385	356.3393939393907	0.3594864908854167	375	1261526	4
7022	276.75783179369887	313.6734317343161	0.2614753619343245	294	1261820	13
7023	277.3953666833091	340.5113207547151	0.25012073778126337	292	1262112	10
7024	277.6694462268081	304.80332103320916	0.33560988482306986	272	1262384	8
7025	280.61593588006343	572.3184115523426	0.3991286160004918	413	1262797	6
7026	280.05754722189977	224.7770700636954	0.2735088948023359	299	1263096	3
7027	280.06615356786256	280.9181818181807	0.20262824657351472	258	1263354	11
7028	281.48676532410934	422.1273291925426	0.32674942424590575	374	1263728	1
7029	280.88784638881697	221.5948717948726	0.49488496210470617	251	1263979	9
7030	280.3798784680598	230.09105431310022	0.26422984205831695	254	1264233	5
7031	280.3966548467779	282.0575163398685	0.35158813800070393	283	1264516	7
7032	280.42744239667076	283.4754098360648	0.19424327727287047	279	1264795	2
7033	280.8974695600056	327.43015873015725	0.3110786095643655	312	1265107	14
7034	280.60969968368266	252.12048192771184	0.2233912150065104	279	1265386	4
7035	281.6734091384587	386.98064516128846	0.3738869250660211	355	1265741	12
7036	280.27009853461857	141.34234875444898	0.24061580392766127	187	1265928	6
7037	278.55052296181367	108.31254125412588	0.1564806769875919	170	1266098	9
7038	279.2727557395756	350.773800738006	0.2374632325890946	292	1266390	10
7039	279.4839990559662	300.39708737863924	0.1660426887306007	296	1266686	8
7040	277.8513603232682	116.22012578616409	0.16728783662987765	189	1266875	5
7041	278.2506679120885	317.7821192052968	0.3270366335875236	298	1267173	3
7042	279.3520597836922	388.38985507246207	0.38002340448727395	318	1267491	11
7043	277.62499737983524	106.64581939799383	0.10671880385454963	170	1267661	6
7044	277.79370262991745	294.4955223880581	0.17957247889993763	263	1267924	7
7045	277.86370763260373	284.7942028985496	0.6237185474638636	267	1268191	2
7046	278.0055599179798	292.04893617021213	0.20268064428258825	270	1268461	4
7047	276.6532259305216	142.77216117216167	0.20606634004519936	183	1268644	9
7048	278.1122492267719	422.55555555555236	0.38088012973588287	329	1268973	14
7049	284.17129855580987	884.0171821305718	0.5508935987851499	609	1269582	13
7050	284.97817740698645	364.8591836734679	0.2330808466131037	330	1269912	12
7051	286.2438906495278	411.5495016611246	1.8952502020474138	435	1270347	1
7052	286.3547578654815	297.3306122448967	0.24855959128678048	291	1270638	5
7053	287.8584960011123	436.72857142856816	0.31166173681358383	346	1270984	10
7054	288.74457513376524	376.46640926640606	1.0630082529983753	327	1271311	8
7055	289.4870194167918	362.9890034364243	0.3835172326393959	321	1271632	3
7056	289.1725194648384	258.0370242214524	0.47302576899528503	256	1271888	7
7057	290.09813261605467	381.7338345864633	0.21993977639953421	317	1272205	11
7058	289.364912483924	216.77611940298584	0.20553603907212561	279	1272484	6
7059	289.34394829059164	287.26849315068364	0.18316167012018417	277	1272761	2
7060	290.7715088076857	432.0999999999974	0.24179230696000392	318	1273079	4
7061	290.66099581020114	279.72020905923245	0.2711065776312529	268	1273347	14
7062	291.5222949430082	376.79090909090775	0.3709866067637568	322	1273669	9
7063	289.81321060743954	120.61386138613915	0.16853148178015342	179	1273848	10
7064	290.42760409863473	351.2525597269601	0.3826061606792956	309	1274157	13
7065	290.94046598868283	341.71379310344594	0.2957199695063572	306	1274463	12
7066	289.2172490421066	118.61877133105855	0.17334818036368724	178	1274641	6
7067	287.75350225449677	142.84257028112518	0.13447596663135594	177	1274818	2
7068	289.4323921403767	455.6424908424883	0.1679707171230914	351	1275169	1
7069	289.5927781165838	305.47098976109066	0.27813245515922363	289	1275458	5
7070	288.55792440949205	186.10740740740803	0.09909025228248453	212	1275670	4
7071	287.0490118320638	137.66666666666717	0.13001097825469163	189	1275859	9
7072	286.4219762591977	224.34545454545565	0.5024123587877647	301	1276160	8
7073	285.4876530483299	192.98965517241453	1.145409736080446	276	1276436	14
7074	286.77704641404034	414.4269896193753	0.38052748553138277	353	1276789	3
7075	287.8409777042859	393.1701754385928	0.730090305722993	348	1277137	7
7076	289.91645028018416	495.388235294115	0.3012411848027655	376	1277513	11
7077	290.2199692790658	320.2683501683487	0.2517478994075084	298	1277811	13
7078	290.20284650935207	288.5076923076916	0.3477358934355945	287	1278098	12
7079	291.57339699162696	427.2578947368379	0.4314285363564944	358	1278456	10
7080	291.1105822763691	245.2919254658392	0.21595296552104334	279	1278735	1
7081	290.3178586192105	211.83821656051066	0.3257033135803831	301	1279036	6
7082	289.88693278027114	247.22527472527526	0.41065608671981924	274	1279310	5
7083	290.9733229680394	398.5259515570918	0.3123637061555125	339	1279649	2
7084	288.94110586739123	87.7516129032262	1.1574334585538475	186	1279835	14
7085	288.71087127930554	265.9176470588232	0.19650565856716387	281	1280116	9
7086	288.69790676713944	287.4144200626953	0.1975540606836273	291	1280407	8
7087	289.8141888678529	400.3261168384854	0.32566333346896703	360	1280767	4
7088	290.0268247569521	311.07777777777693	0.19331197312607387	291	1281058	7
7089	290.0392097080358	291.265319865319	0.19523391723632813	285	1281343	11
7090	289.308130494391	216.93128834355878	0.37726309553907794	253	1281596	13
7091	288.95255078689115	253.75015974440933	0.261143806653145	273	1281869	10
7092	288.3775928465898	231.45675675675773	0.5578574528769841	252	1282121	6
7093	287.9917596790666	249.79427609427736	0.2907477225966126	262	1282383	2
7094	288.12591250481114	301.4070422535194	0.2103395635431463	330	1282713	12
7095	288.9770712902107	373.24179104476934	0.6437841695781573	483	1283196	3
7096	291.0571214728309	496.98208955223424	0.37255905360391695	365	1283561	1
7097	292.0882645438169	394.17142857142585	0.31978547121275963	343	1283904	5
7098	292.02750730030795	286.01254019292463	0.2307458548710264	290	1284194	9
7099	291.6030850801577	249.58528528528723	0.3440561830327752	356	1284550	14
7100	290.6383579542845	195.13037249283764	0.2599039753590982	254	1284804	7
7101	290.5935485072337	286.1574132492102	0.2556854143534621	292	1285096	11
7102	292.24782758154834	456.0214559386937	0.21413532846523095	343	1285439	4
7103	290.5811728351446	125.58235294117691	0.1252962101650777	177	1285616	12
7104	292.0472032120563	437.1842105263122	0.27658856570065676	364	1285980	8
7105	291.2215033318344	209.4772151898746	0.2868881845861916	246	1286226	10
7106	292.0394675099856	373.0179211469512	0.20795091491507886	319	1286545	13
7107	289.6889372416654	56.98644067796595	0.19637103790932514	141	1286686	7
7108	289.20112269918076	240.90748299319796	0.20078362971006317	277	1286963	2
7109	289.0061664550068	269.70549828178457	0.19968784074841833	326	1287289	6
7110	286.89711702287264	78.10122324159059	0.20505153701966067	166	1287455	11
7111	285.61992050053124	159.1774647887331	0.10452353190905943	203	1287658	14
7112	285.1730289878336	240.9307692307701	0.1536653532204053	282	1287940	1
7113	285.00180673654046	268.0508038585197	0.30642284046519885	341	1288281	3
7114	283.23752992791634	108.5741258741263	0.11165761947631836	172	1288453	10
7115	283.16522582604813	276.00711974109925	0.6650723494668872	281	1288734	4
7116	281.67539626282314	134.18226950354673	0.30792246808062546	182	1288916	7
7117	282.21935416460167	336.07118644067504	0.5909000311111868	401	1289317	5
7118	280.48990188169694	109.27412587412626	0.1226615790164832	165	1289482	14
7119	279.9588531622812	227.3850299401212	0.2661504364013672	300	1289782	12
7120	280.5976159820097	343.8351351351329	0.46135545008390855	412	1290194	9
7121	280.55106839361815	275.9428571428556	0.2700644980672855	311	1290505	8
7122	281.8859990052285	414.04412955465256	0.37024730291122043	312	1290817	6
7123	282.18940520222657	312.2266187050347	0.7341356342341624	294	1291111	11
7124	282.403208744706	303.5697594501705	0.9063608221417108	331	1291442	2
7125	282.95888473179303	337.97080745341316	0.25538924112485323	346	1291788	13
7126	282.884001766828	275.4705882352936	0.12713094291539725	259	1292047	10
7127	285.7095504131273	565.4388663967553	0.5108530059733505	377	1292424	1
7128	287.0488290097154	419.63741007193926	0.29188687908115674	335	1292759	3
7129	287.59058806944154	341.22473498233103	0.42879373055917247	297	1293056	4
7130	287.7481107601757	303.34285714285613	0.32201260556742706	287	1293343	14
7131	287.3555870993825	248.4957446808524	0.36061014447893414	280	1293623	5
7132	286.77662889602715	229.45976676384925	0.4785528677481192	270	1293893	8
7133	287.45251172987383	354.3649122806991	0.24887564522879466	315	1294208	9
7134	288.99259530822724	441.46086956521515	0.3794109541973561	367	1294575	7
7135	288.05403299150856	195.13636363636405	0.26096557534259296	184	1294759	10
7136	289.54359022256904	437.00975609755926	0.31083794135551945	385	1295144	12
7137	287.9134172685505	126.5262948207176	0.201343263898577	168	1295312	4
7138	286.79180483499545	175.75217391304386	0.43228403727213544	198	1295510	3
7139	287.70409433381525	378.02075471697793	0.4610379690147308	332	1295842	6
7140	287.56257632625693	273.5522935779814	0.2013643009146464	291	1296133	13
7141	288.15321477704117	346.62642140468114	0.26814675942445415	312	1296445	2
7142	290.06572138896064	479.4038759689905	0.3599407196044922	360	1296805	11
7143	288.23461577649454	106.95516014234926	0.11054047720772879	175	1296980	7
7144	288.9841596530938	363.1890034364243	0.38348876570459445	319	1297299	1
7145	289.22440896565377	313.0090909090896	0.43244187608897255	278	1297577	14
7146	287.4871001277958	115.49352517985652	0.12608350481305802	175	1297752	6
7147	287.99085926350415	337.8630136986285	0.2482689884389082	319	1298071	5
7148	287.37959583215945	226.86451612903303	0.5060075962275171	311	1298382	8
7149	286.0239714909996	151.81716171617217	0.18258744447969544	197	1298579	7
7150	284.5452317760896	138.15000000000063	0.17468407948811848	180	1298759	1
7151	284.38045193219637	268.0672473867588	0.25506578172956196	280	1299039	2
7152	286.9502088163831	541.3561403508713	0.3507581385170541	410	1299449	10
7153	287.39685045910613	331.6143730886841	0.19766728182016693	322	1299771	3
7154	288.0524113662798	352.95294117646944	0.2463529931807274	293	1300064	11
7155	287.78763373149025	261.5746478873231	0.8094664990377566	341	1300405	12
7156	290.228065086483	531.8307692307665	0.881397318903946	373	1300778	4
7157	288.76743749684266	144.16530612244935	0.2654726128829153	190	1300968	8
7158	291.28225607962065	540.2492957746422	0.6183678507804871	512	1301480	9
7159	292.44242320954606	407.2989690721623	0.2909091110016974	359	1301839	14
7160	293.06664810025757	354.864912280699	0.2305873009466356	310	1302149	6
7161	294.3147799385827	417.87983193277176	0.24660223948804638	316	1302465	5
7162	292.52096547253024	114.93333333333386	0.18479064774643528	183	1302648	11
7163	294.1855132142546	458.9757396449675	0.8554913011420683	498	1303146	13
7164	294.00414084073276	276.0482758620676	0.17222296187292524	273	1303419	4
7165	293.6548357667305	259.07363344051356	0.2551929050021701	270	1303689	12
7166	294.1104006166103	339.21132075471473	0.32393263519787396	305	1303994	10
7167	295.14725067404845	397.7954063604226	0.19228125193032874	332	1304326	1
7168	296.35256267909244	415.678451178448	0.25301470998990333	354	1304680	7
7169	296.38651865765263	299.74816053511535	0.19913169552136017	346	1305026	2
7170	295.75551012636623	233.28566552901125	0.2941280364990234	260	1305286	9
7171	296.85254943069697	405.45944055943886	0.1549090358189174	350	1305636	3
7172	296.8510172023833	296.6993265993255	0.25109136184589975	298	1305934	8
7173	295.04576932544137	116.32622950819724	0.08056180212232801	180	1306114	13
7174	295.36321622582653	326.7904593639564	0.32228492736816405	300	1306414	6
7175	294.99466582457455	258.5081761006285	0.16030084815009799	307	1306721	14
7176	293.2272681859367	118.2549019607849	0.08360945989215185	189	1306910	12
7177	293.36883509452093	307.3839590443667	0.31506724106638057	304	1307214	5
7178	294.5639777294912	412.8830985915476	0.29402336879083285	342	1307556	11
7179	294.8341430063479	321.58050541516064	0.29895172119140623	285	1307841	10
7180	295.7269992047429	384.1197628458483	0.1884200975492403	308	1308149	1
7181	295.7990817306811	302.93525179855993	0.32647871885675683	279	1308428	7
7182	297.01058042386376	416.9489510489495	0.26874793557559745	340	1308768	4
7183	297.727148949127	368.6674329501891	0.32615304555154406	297	1309065	9
7184	296.00700454993677	125.71270903010094	0.11626661088731553	180	1309245	5
7185	296.0739684027425	302.703389830507	0.8894635674093856	294	1309539	8
7186	296.23772871871506	312.4499999999987	0.2938646169809195	312	1309851	3
7187	296.16302710720356	288.7675675675668	0.18363443567362397	287	1310138	13
7188	297.69316864821207	449.17718120805137	0.3105383865315537	373	1310511	2
7189	298.70289797867906	398.66610169491395	0.3265056610107422	292	1310803	6
7190	298.8378155637778	312.1946564885489	0.15870141634975907	274	1311077	14
7191	298.1552447475895	230.58073394495543	0.3457757789670056	262	1311339	12
7192	296.0167933102146	84.3101010101014	0.11339045145425451	166	1311505	1
7193	295.78815894601706	273.15335689045844	0.13691949316496338	271	1311776	11
7194	296.081875869568	325.1598513011138	0.404166491655466	279	1312055	10
7195	294.3206061304802	119.95490196078478	0.15601252400597862	172	1312227	6
7196	292.82201630533774	144.46162361623666	0.1939589682589756	178	1312405	12
7197	293.57179614228437	367.79999999999694	0.3506654163015966	321	1312726	7
7198	291.8516935654769	121.5615384615388	0.33614549182710196	168	1312894	1
7199	292.9651532835186	403.1976653696475	0.33074286827674276	325	1313219	9
7200	293.7670755211752	373.1573770491784	0.3950781836524024	333	1313552	4
7201	293.63711491089094	280.77101449275244	0.2949851342232905	271	1313823	5
7202	293.69633436580887	299.5590604026833	0.17390436668918557	292	1314115	3
7203	293.4323458649181	267.2974842767288	0.43010627800691215	282	1314397	13
7204	293.6650483802949	316.7025974025966	0.24672584284364787	306	1314703	8
7205	294.16566163275564	343.726373626372	0.34971554647356073	298	1315001	14
7206	295.0875313322175	386.3526315789444	0.44538958775514814	346	1315347	2
7207	293.58301965525897	144.63636363636417	0.11913379285701368	189	1315536	6
7208	294.1778025973925	353.0613138686113	0.228232499753686	337	1315873	11
7209	294.8531947841845	361.7170212765944	0.24013190599357556	318	1316191	10
7210	294.19861816280314	229.3955326460486	0.3659379712996944	248	1316439	5
7211	292.0820292414491	82.53972602739778	0.7933698056349113	201	1316640	8
7212	292.81269732112764	365.1488372093013	0.19903904100589181	301	1316941	12
7213	293.0006229794953	311.6052631578929	0.23948265376843905	304	1317245	1
7214	292.9065048615884	283.58881118881027	0.689283613725142	275	1317520	9
7215	293.8215220047533	384.40821917808023	0.18053562290317662	333	1317853	7
7216	294.64030678470573	375.6999999999973	0.29342243127655565	342	1318195	4
7217	295.3946806952759	370.07769784172433	0.20862560680517728	327	1318522	3
7218	294.32043583818387	187.97019498607344	0.2029822101331737	292	1318814	13
7219	294.03352520917497	265.6293729372928	0.261710820879255	280	1319094	14
7220	293.8207259047956	272.7535947712411	0.26465145632517423	278	1319372	6
7221	294.1281853124143	324.5666666666657	0.21678515935348253	295	1319667	2
7222	291.910470338271	72.35668789808963	0.677403972376531	199	1319866	5
7223	292.09648328194714	310.51176470588166	0.4958660381670577	313	1320179	11
7224	293.1067635853144	393.124513618675	0.3591842157555244	309	1320488	10
7225	291.80560598406333	162.99100346020805	0.21624381906293297	203	1320691	9
7226	291.80095572132416	291.34057971014374	0.14287927725019245	274	1320965	12
7227	290.04527949744426	116.23333333333376	0.11009451922248392	170	1321135	13
7228	290.7146116854049	356.97849829351287	0.23478949069976807	320	1321455	8
7229	290.57379040931517	276.6324840764321	0.2723579143655711	290	1321745	1
7230	290.8677360069055	319.9683501683488	0.4192205283332901	301	1322046	4
7231	289.19197756575534	123.29189189189225	0.3121360985008446	185	1322231	5
7232	287.42505779009775	112.50000000000038	0.0816797278393274	174	1322405	9
7233	289.1392617576513	458.8454545454506	0.18285065554500965	356	1322761	7
7234	289.90450034574854	365.66312056737445	0.2133862683727483	314	1323075	14
7235	291.1335698204055	412.8114478114447	0.34145453597891295	349	1323424	3
7236	289.79897814950516	157.67440273037607	0.3075842300647406	197	1323621	13
7237	290.0690143420361	316.8025974025966	0.3225494885053791	305	1323926	2
7238	290.9670170313802	379.8692832764475	0.14857459790778882	330	1324256	6
7239	289.614924180654	155.75773195876334	0.20879501657387645	194	1324450	1
7240	289.5843063041611	286.55313653136415	0.3416472258391204	270	1324720	12
7241	290.1445070121632	345.6043771043752	0.22846717591498308	314	1325034	11
7242	288.38292336526257	113.98614232209783	0.13778520471909467	170	1325204	4
7243	289.917613295373	441.85191637630356	0.5041866841289283	354	1325558	10
7244	288.1175604500905	109.91232876712373	0.23895309356872194	167	1325725	3
7245	287.418629070012	218.22442244224487	0.7510125001885256	259	1325984	5
7246	285.8509292657984	130.64864864864902	0.26640204743966045	179	1326163	2
7247	288.09111808634793	509.86981132075005	0.5706782597367481	372	1326535	8
7248	286.60915427390546	139.89473684210586	0.13881112210577426	179	1326714	10
7249	287.58810924279425	384.50465116278815	0.3100167442770565	340	1327054	9
7250	289.07854020710386	436.63120567375677	0.38768381375637984	349	1327403	7
7251	288.4873373876154	229.95825825825966	0.5006797736418163	282	1327685	13
7252	288.01587671215196	241.3412698412704	0.9320087701501981	284	1327969	6
7253	289.74488292819535	460.91649831649437	0.27138662466095215	373	1328342	14
7254	289.423899852338	257.64657534246476	0.7547168083910673	265	1328607	11
7255	287.42330468943106	89.36438356164426	0.1759650407437079	167	1328774	5
7256	287.83337769235885	328.4306049822052	0.279898189803929	309	1329083	12
7257	286.3650020903402	140.99581749049491	0.21340690120573966	186	1329269	2
7258	287.3586500826819	385.7298013245017	0.3314407304659357	347	1329616	1
7259	288.9002083629998	441.5144781144745	0.22054972191379496	365	1329981	4
7260	289.7731153702789	376.1909090909077	0.34982918529975704	328	1330309	3
7261	291.36549932448975	449.0115107913629	0.45895603127675516	365	1330674	8
7262	291.0358194202128	258.39750889679664	0.442071492435368	262	1330936	6
7263	292.17354059109005	404.8079365079348	0.24402777756316751	316	1331252	10
7264	292.69592847285037	344.4123287671217	0.3054638738217561	322	1331574	13
7265	293.64639163036605	387.7422442244207	0.5914259894045791	346	1331920	9
7266	295.018238668126	430.8310954063588	0.3131047423456756	355	1332275	7
7267	294.9822816335574	291.4225352112669	0.44624318053565637	289	1332564	5
7268	294.5907584687898	255.82996515679366	0.26761708422758734	263	1332827	1
7269	295.3745175507685	372.9666666666641	0.21589880897885277	336	1333163	11
7270	296.35353668502506	393.27643097642743	0.6942812331179355	376	1333539	2
7271	296.4886446302767	309.86433121018933	0.23176188283152394	308	1333847	4
7272	294.39814707286286	87.43888888888942	0.41876736920864427	201	1334048	6
7273	294.33887897793034	288.4713375796165	0.29811336045281145	299	1334347	3
7274	294.5786806643415	318.31904761904605	0.9312117688661571	417	1334764	12
7275	295.07738566097674	344.4491803278672	0.19788905217097355	325	1335089	10
7276	294.7445024796081	261.7890675241148	0.4842850008877841	275	1335364	9
7277	300.2335172249269	843.6459770114886	0.820581700160381	643	1336007	14
7278	302.3052931637887	507.41111111110786	0.452493263857208	411	1336418	8
7279	300.672267900135	139.00276679841943	0.20395642330772	190	1336608	3
7280	301.4214543120427	375.5909090909078	0.27926446149449147	334	1336942	7
7281	301.4074927809705	300.0253012048185	0.30656552926087993	312	1337254	11
7282	303.0238394559482	463.04216027874196	0.4054280019177056	386	1337640	13
7283	303.3730976600281	337.94965986394305	0.12413041809589248	361	1338001	1
7284	303.7786304196916	343.9263736263719	0.3732959386464712	296	1338297	2
7285	306.6613618459911	592.0517730496418	0.35821257398721756	426	1338723	5
7286	308.6752190446518	508.04708171205937	0.3126439370744215	366	1339089	6
7287	308.70803828277667	311.95714285714143	0.2899633878237241	308	1339397	12
7288	306.8769032375695	125.59453376205829	0.14991111755371095	190	1339587	14
7289	304.8994110218028	109.1276816609001	0.0929048923735923	188	1339775	9
7290	302.57214418431204	72.17272727272758	0.2215960439046224	150	1339925	11
7291	300.52926889631505	98.28461538461578	0.0922211254344267	170	1340095	13
7292	299.99781831261504	247.3842105263161	0.4609607376215112	262	1340357	10
7293	302.47411285676156	547.6272727272666	0.5402130805121528	450	1340807	4
7294	300.1384355579812	68.9063829787237	0.13944396024905376	161	1340968	1
7295	298.6398204331706	150.27692307692368	0.12200910089299542	227	1341195	7
7296	298.3793521181378	272.59298892988824	0.33799507781749466	262	1341457	8
7297	297.1699005882984	177.43419913420001	0.10140283902486165	216	1341673	2
7298	295.3778379460517	117.96363636363674	0.21545376803705601	183	1341856	10
7299	295.5332550063306	310.9195439739405	0.3260493863013483	310	1342166	12
7300	295.983295393561	340.5372937293715	0.3677055902156298	323	1342489	6
7301	296.2890988032617	326.56363636363443	0.18950663351450706	297	1342786	13
7302	296.19265225967354	286.6444444444431	0.567016974866208	327	1343113	14
7303	296.14457383834264	291.38481012658156	0.3211550240318615	313	1343426	11
7304	295.2984492008767	211.53211009174436	0.15880736453825656	269	1343695	4
7305	297.0867550314485	474.1290322580615	1.0403008290293108	419	1344114	5
7306	302.84011825036464	872.4230769230672	0.667201042175293	544	1344658	3
7307	303.3028425158896	349.11254480286465	0.2408590288968545	343	1345001	1
7308	305.13137800050515	486.15639097743906	0.34493058049645964	363	1345364	7
7309	305.99477850621435	391.47142857142654	0.3426221486684438	370	1345734	8
7310	304.3123307211522	137.75000000000063	0.14605810331261676	184	1345918	12
7311	302.6027171415671	133.35097276264642	0.20718200350068305	183	1346101	11
7312	302.4776094332387	290.0919463087237	0.22169127831092247	286	1346387	6
7313	304.6293070231167	517.6473684210429	0.44098134757646545	612	1346999	9
7314	306.8182540962547	523.5240143369138	0.39501391164482097	391	1347390	10
7315	312.47277194439715	872.2700389105004	0.6252281146342528	537	1347927	2
7316	312.30148084467146	295.3436619718303	0.40925373278166116	285	1348212	3
7317	312.1919477637995	301.3481727574729	0.49752780768878296	341	1348553	14
7318	312.41007553025594	334.00472440944793	0.22808941063931829	281	1348834	1
7319	314.0142496890427	472.8274914089319	0.6641986973755195	391	1349225	4
7320	315.81258431633523	493.847712418297	0.37888982863653276	420	1349645	13
7321	315.1619154268143	250.74569536423905	0.3205802554175967	273	1349918	8
7322	317.0894923509775	507.9196078431337	0.4480593053306021	410	1350328	5
7323	315.4253483299948	150.67509025270797	0.16651619805230033	189	1350517	6
7324	316.08425203733026	381.3157190635436	0.33476999643686656	333	1350850	7
7325	315.67571314732	275.2303630363026	0.2806056531495003	283	1351133	11
7326	316.0860911509819	356.71351351351217	0.21680142375573	317	1351450	12
7327	315.5331191283609	260.7888888888878	0.35107977730887274	280	1351730	10
7328	315.53717569217935	315.93877551020245	0.2801999089015726	309	1352039	9
7329	313.5576252280332	117.58212927756719	0.19990448156992593	192	1352231	5
7330	313.1310619627659	270.90129870129834	0.23482805382904162	277	1352508	1
7331	311.1630649962748	116.33136531365383	0.15569791271911926	201	1352709	6
7332	311.76947895597743	371.8044609665403	0.2589797286299972	333	1353042	3
7333	312.3358686734599	368.4084507042239	0.22851388577632267	329	1353371	14
7334	311.9852012618931	277.2691275167775	0.22386816569737025	280	1353651	13
7335	311.61626028130263	275.0911032028463	0.257429688841432	273	1353924	7
7336	310.87390498745975	237.38073089701126	0.40013944807827684	283	1354207	11
7337	312.6827808444174	491.76149068322434	0.3127322005323766	423	1354630	2
7338	313.3506197026398	379.4666666666632	0.42208998029765415	371	1355001	4
7339	315.0787997801232	486.1686274509776	0.24602495577112474	353	1355354	8
7340	315.3653880199457	343.73762376237465	0.15083482530381945	324	1355678	12
7341	314.1667030838457	195.49689440993848	0.9515358798475151	249	1355927	10
7342	312.031831751932	100.67956989247355	0.0920426504952567	175	1356102	3
7343	310.10449215781694	119.29787234042617	0.24174190702892484	189	1356291	13
7344	309.56330008909157	255.98528528528536	0.20936751692262415	292	1356583	9
7345	309.68657322538473	321.8906137184099	0.30594673396656347	318	1356901	6
7346	307.44634627640085	85.66387832699688	0.19230130329224224	207	1357108	2
7347	306.7583007240846	238.64179104477705	0.3190410579229198	329	1357437	1
7348	304.57371771684376	88.30000000000078	0.04774600143749189	241	1357678	4
7349	303.01330221799697	148.5321678321683	0.2579214374224345	192	1357870	3
7350	304.31910467968794	433.5935483870944	0.481456916714892	405	1358275	5
7351	304.2467597867372	297.0846153846145	0.48340906273008016	382	1358657	14
7352	303.97123739434926	276.694520547944	0.571263667515346	280	1358937	12
7353	303.609294251175	267.776923076922	0.24284514370343543	302	1359239	8
7354	304.7886753571062	421.5474048442889	0.25652361051988737	351	1359590	11
7355	306.3780896415974	463.7301038062265	0.33435775233447396	379	1359969	7
7356	306.4911184337628	317.6809688581302	0.28901217487708253	317	1360286	10
7357	304.33428272112326	90.8075471698119	0.613470034748984	223	1360509	2
7358	305.07780369319516	378.6863799283133	0.2558080935906507	334	1360843	13
7359	303.2755711108087	124.85454545454601	0.13928887902236567	205	1361048	4
7360	303.67405739258317	343.12419928825506	0.8913742963005514	340	1361388	9
7361	301.79134498767144	115.40281690140891	0.20127024416063652	183	1361571	14
7362	302.18384309014124	341.0411552346548	0.29104017823060874	307	1361878	6
7363	303.2125667030354	405.05620437956065	0.39449426604480275	328	1362206	1
7364	303.48601428441265	330.557324840762	0.5552116676613137	324	1362530	3
7365	304.2660903117813	381.4936170212748	0.48665341672238643	333	1362863	5
7366	304.422922915157	319.94935064934975	0.445677962957644	306	1363169	12
7367	304.6255109617529	324.6817275747493	0.23569349357281913	307	1363476	11
7368	302.7322840211495	115.30281690140892	0.22152799108754034	184	1363660	9
7369	302.8321687933947	312.72076124567246	0.3759892704975174	332	1363992	8
7370	301.1098745968697	130.60274914089408	0.1346472112143912	205	1364197	14
7371	301.22022930435446	312.1453453453448	0.41204188597526437	331	1364528	7
7372	302.08670625659386	387.8679245282991	0.2163122232677867	309	1364837	2
7373	303.04441714079593	397.8577946768043	0.21500815502852672	317	1365154	13
7374	302.70215664285735	268.81836734693775	0.3909515380859375	270	1365424	6
7375	300.75629297116564	108.11578947368469	0.2020324791333952	181	1365605	3
7376	300.4302062319302	268.1476190476191	0.3412361244619982	383	1365988	10
7377	300.1838636711685	275.79595015576257	0.27834950661172675	294	1366282	1
7378	301.7935049106178	461.1479876160969	0.4555224851698201	403	1366685	4
7379	299.95385705874344	117.82871972318426	0.3013520345200587	274	1366959	11
7380	300.3665537822736	341.22352941176365	0.2947704060872396	300	1367259	5
7381	300.29547960657715	293.2591362126237	0.29026007734780496	289	1367548	12
7382	298.6747277090621	138.22028985507296	0.4317915134520327	211	1367759	7
7383	298.62722367521474	293.92432432432315	0.13190471535862083	303	1368062	8
7384	297.6748363942148	203.38849557522192	0.6262201294863134	266	1368328	14
7385	298.83381530299994	413.572727272724	0.2657997721717471	336	1368664	9
7386	297.367443592923	152.1966442953027	0.30191675821940106	222	1368886	13
7387	295.700240105006	130.6470948012239	0.16135052985545853	191	1369077	10
7388	296.5979445312651	385.4706827309221	0.4180100105261877	321	1369398	2
7389	295.43478861536425	180.2823529411771	0.3522991704005821	255	1369653	3
7390	294.2364637177164	175.6022988505751	0.17235652323301673	197	1369850	5
7391	295.9862788558201	469.2179775280871	0.27837998151122373	363	1370213	6
7392	294.18769964935143	116.12835820895577	0.16603916652953427	181	1370394	8
7393	294.8245594949631	357.8736842105233	0.3888938540504092	315	1370709	1
7394	295.4833573782743	360.70434782608555	0.2664456727074795	305	1371014	4
7395	293.6182510772188	108.97272727272782	0.2144979959005838	182	1371196	13
7396	293.6143542807323	293.2285714285705	0.4544923992767877	281	1371477	7
7397	294.0423328753296	336.41221374045705	0.33829710076883884	299	1371776	12
7398	294.45004069411726	334.8131147540969	0.26453269745912344	323	1372099	11
7399	292.5711510254311	106.56107382550384	0.1828476061139788	175	1372274	3
7400	292.3306231886462	268.51836734693774	0.16401478135105454	273	1372547	9
7401	291.9547137821566	254.73968253968192	0.23563608107584047	277	1372824	14
7402	292.4011363413047	336.5969696969672	0.19654517896247634	330	1373154	10
7403	293.2761978255738	379.9072847682102	0.3723355408615067	339	1373493	2
7404	292.898424611363	255.4988764044934	0.19056716738011054	253	1373746	8
7405	291.2267157275682	125.72753623188447	0.19375272820757322	191	1373937	7
7406	291.3632284445064	304.877987421382	0.42848646375868055	315	1374252	5
7407	290.72188729930184	227.22911392405206	0.2857865958378233	290	1374542	13
7408	292.0238318250016	420.9163398692786	0.49254886156892125	365	1374907	6
7409	291.58469154596725	248.1098039215697	0.2851828803580977	263	1375170	11
7410	292.7908343915997	412.19897610921134	0.33307340775413075	348	1375518	4
7411	292.88440161771626	302.1475570032564	0.18746939341227215	300	1375818	12
7412	292.88413780631726	292.85802047781493	0.9682057298074557	381	1376199	1
7413	292.95088703228095	299.55906040268326	0.12359591706158364	292	1376491	3
7414	292.900312802481	287.8934640522866	0.1667682910787648	290	1376781	9
7415	293.38678179341525	341.5472118959091	0.22389008278070494	301	1377082	14
7416	291.9890444102637	153.61304347826166	0.22865142444572825	202	1377284	7
7417	292.6115607458221	354.24067796609967	0.3785608119310991	321	1377605	10
7418	293.30927967073796	362.38345323740793	0.2567605857389519	332	1377937	2
7419	291.40006922697177	102.38823529411802	0.21369670636087493	181	1378118	12
7420	291.90440186803534	341.83333333333206	0.2454971788663765	289	1378407	5
7421	292.32374141099876	333.838356164382	0.38881305401141825	325	1378732	8
7422	290.51102100369155	111.05170068027249	0.09218476226975246	181	1378913	3
7423	288.70321896975526	109.73081761006345	0.17532502419037344	191	1379104	7
7424	289.57988169531194	376.3694915254213	0.3654434928554456	337	1379441	13
7425	290.12234661462253	343.82637362637183	0.20544260198419745	297	1379738	1
7426	290.9643453706985	374.32222222222043	1.1298867028428206	353	1380091	11
7427	291.1760760666514	312.13741496598476	0.15143187891561002	313	1380404	14
7428	292.0499623648084	378.5647058823514	0.16844450383027876	331	1380735	9
7429	290.79692785743936	166.74651162790755	0.570688525835673	192	1380927	2
7430	292.1341213695626	424.51627906976313	0.25635635941116897	405	1381332	6
7431	292.29595578310705	308.31756272401304	0.29549209862424614	285	1381617	12
7432	292.70131201474965	332.8315789473664	0.3583529691518464	322	1381939	10
7433	292.34464788789074	257.03489932885816	0.43128326524619104	281	1382220	5
7434	291.04753474234514	162.63333333333398	0.14261792007001858	206	1382426	13
7435	291.6472412131035	351.01818181817947	0.20146592975827693	307	1382733	3
7436	292.25868966428175	352.7920863309333	0.2728791475296021	320	1383053	8
7437	297.0749619225684	773.8859154929474	0.5878647118283992	570	1383623	4
7438	295.42021230334274	131.60000000000042	0.13919017353995902	183	1383806	14
7439	294.4897374530366	202.3727272727282	0.37394815875637916	248	1384054	11
7440	293.9486475319224	240.38074534161564	0.2794218135059328	266	1384320	7
7441	293.98682772326987	297.7666666666655	0.5148810810512967	288	1384608	1
7442	293.70614717166893	265.91877256317576	0.18746915008082535	264	1384872	2
7443	293.88788280140153	311.8797101449262	0.26392092404665646	286	1385158	6
7444	292.29442770220106	134.5423728813564	0.1041230889006034	179	1385337	5
7445	293.5127775428261	414.129411764704	0.25137860712435084	343	1385680	9
7446	292.5976910045112	202.00412371134075	0.3352397347268788	247	1385927	12
7447	290.86557710816476	119.3863013698635	0.15237425667898996	175	1386102	1
7448	290.37608075737296	241.91594202898602	0.30191767900839617	261	1386363	3
7449	290.12865328313256	265.63333333333276	0.3001204780910326	276	1386639	13
7450	290.2720714482878	304.47046979865615	0.1445478254748929	310	1386949	10
7451	290.37202226665164	300.267153284671	0.1382215099402594	281	1387230	14
7452	290.3332413411097	286.4939297124594	0.17585498796970356	297	1387527	8
7453	289.6406623523562	221.07534246575392	0.30048427431602176	254	1387781	7
7454	288.14747606781566	140.32203389830553	0.18656158447265625	189	1387970	9
7455	289.1268594631659	386.0858156028346	0.4904725485007856	358	1388328	4
7456	290.0249242018676	378.9333333333308	0.2628184059966062	343	1388671	11
7457	289.7316194042933	260.6944444444441	0.5336632276103445	274	1388945	6
7458	289.07964063356326	224.53374233128886	0.1739330079032586	269	1389214	5
7459	288.98630934350666	279.7465116279057	0.20421467071924454	312	1389526	2
7460	289.1387795834049	304.23333333333255	0.2037237233129041	290	1389816	12
7461	287.26621441754025	101.88226299694273	0.1167958985027085	234	1390050	3
7462	287.1141637841562	272.061151079136	0.2790718367605498	264	1390314	1
7463	286.78241705077323	253.93949044586012	0.39258315936237775	294	1390608	13
7464	285.22311139878406	130.8518518518526	0.11025125786448209	209	1390817	4
7465	285.1628033617193	279.1923076923072	0.24907630598041372	284	1391101	14
7466	287.67244398481847	536.1268656716367	0.3517675797144572	384	1391485	10
7467	287.80505287830357	300.9333333333326	0.3531084798806961	323	1391808	7
7468	287.9516860555908	302.4683706070279	0.29483897918803925	297	1392105	11
7469	290.70511834757724	563.2949152542345	0.6906010002753753	383	1392488	8
7470	289.0482210102553	125.01538461538524	0.19958699544270833	195	1392683	3
7471	289.3818704727506	322.4131672597853	0.16551085606517407	298	1392981	6
7472	290.1160907290621	362.8038961038949	0.22269421313182416	332	1393313	9
7473	288.88339493805057	166.84651162790755	0.16895761539798757	191	1393504	13
7474	289.58813241724147	359.3571428571415	0.19703057568944143	334	1393838	5
7475	290.8079189131382	411.56678200691874	0.27513239088250857	347	1394185	2
7476	291.2055293791792	330.568965517239	0.22102569774457603	314	1394499	12
7477	290.87976121410026	258.62871287128627	0.41342018019985144	284	1394783	4
7478	289.2952049812696	132.42413793103503	0.20325414339701334	192	1394975	8
7479	287.5942056873624	119.19527559055172	0.17126830848487648	185	1395160	3
7480	286.38332423654936	166.506060606061	0.37291709498355263	190	1395350	6
7481	287.8965893548396	437.70983606557104	0.3228343598386075	376	1395726	1
7482	289.4093642020319	439.1740740740707	0.31649315494230423	348	1396074	14
7483	289.66954642208054	315.42758620689443	0.21619028605698726	293	1396367	10
7484	288.98169944270825	220.8848484848495	0.2641629583185369	275	1396642	7
7485	287.29621578161453	120.43333333333399	0.07628717757107918	228	1396870	13
7486	288.52348805603276	410.02344322344095	0.2385614170408681	331	1397201	11
7487	286.6242830262187	98.60298507462755	0.1360579873052772	207	1397408	12
7488	286.2923207240093	253.42805280528046	0.23642726474338108	270	1397678	5
7489	284.23099260879377	80.1595092024544	0.2012549032712116	179	1397857	6
7490	282.8831673243441	149.44846416382325	0.3136538826458827	211	1398068	4
7491	284.13535204454325	408.10163934426	0.322305573076405	377	1398445	9
7492	285.5152869136109	422.1288389513084	0.4193911153919759	347	1398792	2
7493	283.88057376078683	122.04397163120638	0.0899045237429856	197	1398989	7
7494	282.25461748554454	121.28494623655962	0.18936646502950918	184	1399173	11
7495	283.047110271728	361.5038961038946	0.3340117523635643	345	1399518	3
7496	283.41476820126877	319.81290322580514	0.485236808704653	317	1399835	14
7497	285.94004387692024	535.9423357664205	0.8552576826123769	406	1400241	8
7498	285.11393035798227	203.32869198312284	0.2365804615587291	202	1400443	9
7499	284.97679105440244	271.3999999999989	0.40632297448944626	285	1400728	12
7500	285.2114108989604	308.4387755102018	0.19924344619115195	384	1401112	1
7501	288.5687477703629	620.9450980392102	0.20942528813862973	417	1401529	10
7502	288.5597269593259	287.66666666666583	0.3679852337160737	289	1401818	6
7503	289.3366243133886	366.24946236558935	0.34829518151661704	315	1402133	5
7504	289.1143901457264	267.113207547168	0.24563675173663785	309	1402442	4
7505	286.9208818127823	69.76355685131229	0.1542752439325506	176	1402618	14
7506	286.77150632798777	271.9833333333329	0.4304429117838542	300	1402918	2
7507	286.58360189593714	267.98106312292316	0.22795031727224158	276	1403194	11
7508	284.37024496443024	65.24790874524741	0.35892191919787175	145	1403339	6
7509	284.09499987912704	256.84573643410783	0.5490165710449219	260	1403599	9
7510	283.842272102558	258.82222222222185	0.49100441156431684	258	1403857	10
7511	285.91581352495865	491.1964143426253	0.23630678033553107	346	1404203	8
7512	292.1811055615303	912.4450171821173	0.730870821498546	634	1404837	13
7513	292.81810610011786	355.8811594202883	0.32683192593066096	317	1405154	12
7514	296.1486637150748	625.8738675958132	0.8817462880124328	465	1405619	7
7515	294.5526186363656	136.5441558441563	0.3568979899088542	192	1405811	14
7516	295.7051367304447	409.80442804427855	0.11055163119701629	329	1406140	1
7517	294.12984588093957	138.17605177993596	0.15536056480971464	203	1406343	2
7518	294.94996980480164	376.14223826714544	0.22121193581951154	317	1406660	5
7519	295.81348891553097	381.30188087773746	0.6605450510978699	512	1407172	3
7520	294.28578880898436	143.04347826087	0.1541756577228182	199	1407371	8
7521	295.1344580526774	379.15271317829365	0.22170870817160304	316	1407687	6
7522	296.6460742564643	446.29607843137	0.6376978904689283	438	1408125	4
7523	298.13778833907446	445.81748251748076	0.20242826534750682	366	1408491	11
7524	299.44776010603334	429.1349650349635	0.2734573406880128	358	1408849	9
7525	299.99845469040343	354.51721854304475	0.3145700082546327	328	1409177	10
7526	299.98675219478145	298.8282051282042	0.4066129586635492	312	1409489	7
7527	299.7371003591081	275.02156862745034	0.21911855538686117	288	1409777	2
7528	299.5888866588878	284.91573033707834	0.2977226163134163	324	1410101	12
7529	301.04769282775993	445.46950354609703	0.5574174927755663	367	1410468	13
7530	300.36013653440295	232.29206349206427	0.47358953837796425	311	1410779	1
7531	299.42921418140463	207.2679012345691	0.3720131481395048	272	1411051	5
7532	300.9909769846455	455.60549450549115	0.7335778462518122	388	1411439	14
7533	300.7341221976169	275.3054982817858	0.3915260880081742	270	1411709	3
7534	301.8694779453377	414.26969696969513	0.28519945203160946	326	1412035	8
7535	299.9163347673078	106.55516014234925	0.11339266473354574	179	1412214	2
7536	300.45232526578855	353.5153846153834	0.273132570328251	310	1412524	11
7537	300.95786758690116	351.0065573770476	0.41357881986177886	325	1412849	6
7538	301.4539371195012	350.5648208469042	0.46028956744366656	337	1413186	4
7539	301.076150644059	263.67528957528896	0.22265069059623305	258	1413444	12
7540	301.8157362166562	375.0347079037779	0.24193466908832978	338	1413782	9
7541	302.2307316784099	343.31528239202476	0.17028838396072388	320	1414102	10
7542	301.855600832214	264.7176470588232	0.2576130160699525	293	1414395	7
7543	302.04769445892833	321.0649635036488	0.4692874020093108	292	1414687	5
7544	302.2535433929333	322.63258785942384	0.4894827241807896	319	1415006	1
7545	300.77513839378656	154.41304347826124	0.186485152883628	194	1415200	8
7546	302.31613608733943	454.87490774907525	0.5383786249427156	358	1415558	13
7547	301.068996704488	177.60219780219825	0.23872570967792872	201	1415759	2
7548	300.97659245172883	291.8285714285708	0.15481054015078788	295	1416054	3
7549	299.06884539513607	110.20188679245325	0.19749796125623914	180	1416234	12
7550	300.7553821067476	467.72251655628907	0.32410668835197526	388	1416622	14
7551	301.04287590472774	329.50476190476024	0.43610096273038407	323	1416945	11
7552	302.4302892509436	439.7842105263121	0.2220967761158238	338	1417283	6
7553	303.6497999785058	424.38136200716576	0.25740269252232145	343	1417626	4
7554	302.33201016377416	171.87081850533878	0.26547711438471727	202	1417828	13
7555	300.5115082439546	120.28181818181869	0.20015699408027562	178	1418006	3
7556	299.99417093929287	248.77777777777897	0.23900633287264814	289	1418295	10
7557	299.30708865482006	231.28594249201396	0.43266936810347284	274	1418569	7
7558	299.88614753926424	357.2129770992355	0.3378240346908569	320	1418889	5
7559	300.6886801159162	380.13940520445897	0.2383364689202956	324	1419213	1
7560	301.8994322923928	421.76389776357587	0.2785485152798797	382	1419595	9
7561	302.8530159162369	397.2577946768043	0.27916377395299197	323	1419918	2
7562	303.8590474009102	403.4561643835596	0.4112331785004714	348	1420266	8
7563	302.2461465820735	142.5689655172419	0.25320377546487394	194	1420460	6
7564	301.6779158854835	245.42307692307767	0.306190782291874	314	1420774	12
7565	302.16971643677357	350.8579710144912	0.3078284133957232	331	1421105	14
7566	302.3805377909243	323.25185185185	0.1917363217002467	285	1421390	11
7567	302.6829504060946	332.62179930795713	0.22645346946965636	306	1421696	4
7568	302.72646784080916	307.03469387754984	0.32427602200894745	296	1421992	13
7569	300.9200392279749	122.0836065573776	0.28805671854222076	188	1422180	9
7570	300.88110749241156	297.02686567164017	0.443758017800071	275	1422455	7
7571	301.24357158527266	337.1275167785219	0.2998172915467648	319	1422774	3
7572	299.48820209458546	125.70662251655705	0.38914617998846646	232	1423006	1
7573	299.4609867403063	296.76666666666557	0.38408788898647234	298	1423304	10
7574	298.6993700701821	223.2993197278917	0.15180978430322853	249	1423553	2
7575	299.0995925856965	338.72162162162033	0.21611125294755146	328	1423881	5
7576	299.4914716598395	338.28749999999843	0.24601954883999294	288	1424169	6
7577	299.8802121156549	338.365517241377	0.2270235155449539	305	1424474	8
7578	297.83200550011634	95.0595505617982	0.13798000646191974	172	1424646	13
7579	297.7245385919683	287.0853146853138	0.139072959206321	275	1424921	12
7580	297.5560389687605	280.87457627118533	0.3363770918412642	275	1425196	11
7581	295.9508766981952	137.03981191222633	0.10500851455999881	196	1425392	7
7582	296.6127240955968	362.13561643835436	0.27097887932499753	316	1425708	14
7583	296.4402692095896	279.3672354948796	0.41985433970978114	277	1425985	4
7584	295.74754905717623	227.16825396825453	0.6068801022647472	267	1426252	9
7585	293.4831439891397	69.30704225352146	0.2501069125750207	151	1426403	6
7586	291.9558612857104	140.75487364620994	0.14804294374254015	216	1426619	2
7587	292.5366504989403	350.0347826086941	0.2371581175146323	303	1426922	1
7588	293.3229982796651	371.1714285714263	0.3031881940623186	323	1427245	3
7589	294.17847963707464	378.87113402061647	0.24724999159396052	334	1427579	10
7590	291.9374822161192	70.07873754152854	0.11909376544716918	162	1427741	14
7591	291.26704390189445	224.89365079365135	0.2618567000987918	258	1427999	5
7592	291.34110828715666	298.6734824281142	0.3609805720867497	303	1428302	8
7593	290.7692761516535	234.15789473684333	0.26349542215208693	289	1428591	11
7594	291.9213137655635	405.9730375426586	0.33371560615405704	342	1428933	13
7595	291.613728880696	261.16282527880935	0.1882571044283877	287	1429220	7
7596	293.6319469032443	493.43553113552827	0.24587789494940576	376	1429596	12
7597	294.06134385212226	336.5716417910425	0.5528098796976024	290	1429886	4
7598	293.71725691536784	259.65265017667775	0.27932238260904946	300	1430186	2
7599	294.0952029902819	331.5118644067779	0.21983231915538334	311	1430497	6
7600	292.3212833490431	116.70323886639726	0.091256959097726	168	1430665	11
7601	292.64294106571447	324.4870550161794	0.3007605728829742	314	1430979	1
7602	294.16994874115005	445.3437086092693	0.33117868523848687	380	1431359	9
7603	293.56493346426487	233.6684210526321	0.4381541401947138	261	1431620	14
7604	294.38870651229365	375.9422382671455	0.2562826031054075	319	1431939	3
7605	293.6380462512944	219.3226804123718	0.21953762599400112	280	1432219	5
7606	294.5509540450092	384.9288256227734	0.14127412156594174	349	1432568	10
7607	293.0967302188448	149.1285714285721	0.34555710113800325	222	1432790	13
7608	293.6979167628102	353.2153846153834	0.3594551695802341	313	1433103	8
7609	292.05808199951423	129.71444043321338	0.26793456863570997	182	1433285	6
7610	291.79867765010727	266.11764705882297	0.3502500253766241	279	1433564	12
7611	290.45514298088585	157.4452107279697	0.35852691323999414	187	1433751	5
7612	290.053359717167	250.2768166089973	0.2937311791257316	299	1434050	2
7613	288.49728765845686	134.44615384615454	0.34076872514319545	193	1434243	10
7614	289.9428532434107	433.0538461538448	0.29696332028037625	380	1434623	4
7615	289.86751012022927	282.40854092526615	0.32565014828615085	271	1434894	9
7616	291.08959707690474	412.07620578777704	0.15428410687492888	412	1435306	7
7617	291.5121568884486	333.3455782312912	0.22875421242635757	305	1435611	11
7618	292.2094326705575	361.23973509933614	0.26988047561878825	327	1435938	1
7619	290.5450003156829	125.76619718309905	0.16045905448294975	185	1436123	6
7620	292.24060115998367	460.10508474575926	0.47547980681491964	381	1436504	14
7621	293.21801566120433	389.98205128205007	0.5497251900520114	362	1436866	3
7622	293.7201017161964	343.4266211604072	0.2205299449191198	319	1437185	13
7623	291.6082451806398	82.53444816053562	0.14971324683582715	177	1437362	7
7624	290.691369725918	199.9206997084558	0.2252679705226382	303	1437665	12
7625	289.3879266168941	160.34705882353006	0.36708680748334394	197	1437862	9
7626	288.90761110911444	241.35637583892674	0.3930944937246817	270	1438132	5
7627	290.9746476740796	495.6112676056313	0.22868916958193236	395	1438527	8
7628	290.5218650527605	245.69638554216993	0.3256254971237991	283	1438810	10
7629	291.16624506444026	354.9598662207345	0.19329673975796685	329	1439139	2
7630	290.2209672291805	196.6384615384621	0.3107509305400233	248	1439387	6
7631	290.61645115958225	329.7693602693587	0.2324413500334087	304	1439691	11
7632	289.89564107836617	218.53544303797602	0.2767313693432098	282	1439973	1
7633	292.0684458616123	507.1761194029805	0.32013323974609376	375	1440348	4
7634	290.32211275434753	117.43513513513568	0.10463969274000688	176	1440524	7
7635	291.2054557293681	378.6564102564082	0.34277474539620534	315	1440839	3
7636	291.6090908272468	331.5689655172392	0.33384124856246145	304	1441143	13
7637	291.7839632889377	309.09633699633554	0.32585747808003596	278	1441421	9
7638	290.46583794176263	159.97142857142927	0.3378503541688661	185	1441606	6
7639	288.884306903169	132.31273408239744	0.21770672414494657	174	1441780	1
7640	286.678965735278	68.35019011406875	0.1299539616233424	152	1441932	7
7641	285.19723700982485	138.50609318996467	0.21812646676108474	191	1442123	11
7642	285.5318543833164	318.6589743589735	0.2719210207072738	306	1442429	5
7643	285.0029384368858	232.640259740261	0.1965198799415871	270	1442699	10
7644	283.21710454123877	106.41954887218118	0.15942148199663475	213	1442912	4
7645	284.6704677424017	428.55342465753165	0.6067459229831746	371	1443283	12
7646	285.70518730740184	388.14242424242116	0.26577188703748916	360	1443643	8
7647	291.6380729343278	878.9937499999924	0.4232916595738962	545	1444188	14
7648	292.26986439041497	354.8172185430449	0.19023999727689303	325	1444513	2
7649	290.686266791807	133.9101045296172	0.29737093040980206	193	1444706	6
7650	288.8337984900861	105.43943661971875	0.2580785374183439	177	1444883	12
7651	289.4672131184256	352.17526132403975	0.2571376185263357	310	1445193	3
7652	290.55040004764396	397.78590604026647	0.24491816929408483	350	1445543	13
7653	292.5829735665473	493.8077519379832	0.6401138922596235	371	1445914	9
7654	293.4477654525034	379.06216216216046	0.9689952503551137	330	1446244	7
7655	294.27879484023185	376.55070422535084	0.5185700902399027	318	1446562	4
7656	293.78728020372665	245.1273311897115	0.31420228123283994	313	1446875	5
7657	295.4824074016894	463.29999999999757	0.35750279661084783	366	1447241	1
7658	293.1027499943392	57.516666666666524	0.5633742388556985	153	1447394	12
7659	292.89091977330736	271.9197278911554	0.29275275150061525	273	1447667	14
7660	294.4760593560621	451.40487804877716	0.39845822336916753	363	1448030	10
7661	294.77842043550527	324.7121673003791	0.18643980556064182	288	1448318	2
7662	296.666402188597	483.57659574467823	0.2565994465604742	376	1448694	11
7663	297.1347453609556	343.5007194244584	0.31086558357613986	305	1448999	8
7664	294.92102930666346	75.76313993174114	0.6715424048719068	197	1449196	3
7665	294.0355225966587	206.37035830618998	0.18616353311846334	248	1449444	6
7666	291.77423503986506	67.90676691729351	0.20873206002371653	147	1449591	14
7667	291.0282015502259	217.17088607595068	0.3767983407685251	264	1449855	13
7668	289.335970167635	121.80506329113969	0.27331963515863184	205	1450060	5
7669	287.4627292778399	102.01188118811925	0.14812231920436472	167	1450227	11
7670	285.78899087395035	120.0888888888893	0.2110282571558009	187	1450414	12
7671	284.07166853277846	114.0567567567571	0.14512248472733932	176	1450590	3
7672	284.1429160051568	291.19641577060827	0.2187445878121827	277	1450867	9
7673	284.2699605293157	296.8473684210505	0.4141398429870605	320	1451187	4
7674	284.8036011302081	337.63402061855436	0.3067531699905852	334	1451521	7
7675	285.19508401924963	323.9518900343628	0.6606911751737563	299	1451820	2
7676	285.9906504204364	364.7517241379283	0.5258496883163692	317	1452137	10
7677	286.58278768727575	345.20437710437517	0.29792735261737174	318	1452455	8
7678	288.5180161484312	480.1056338028146	0.348704373772769	374	1452829	1
7679	290.23654744939745	460.3711462450574	0.3397873696826753	336	1453165	6
7680	288.27829308601457	94.41111111111157	0.2554474566356245	166	1453331	3
7681	286.7071720768626	131.16619217081904	0.7421495207063444	182	1453513	9
7682	286.5974592411114	275.73588850174104	0.19636398706680688	273	1453786	14
7683	286.0985322677479	236.70476190476245	0.19107634707751028	251	1454037	11
7684	283.9637402536206	72.61933085501886	1.5965748180042614	165	1454202	1
7685	284.95951664418783	383.5413793103417	0.24302314576648532	336	1454538	5
7686	286.3019285699445	419.20070921985615	0.27951693672665284	346	1454884	12
7687	284.47973206905516	104.08227848101322	0.8308508055550712	224	1455108	2
7688	284.5571054800719	292.21707317073157	0.4361403274536133	400	1455508	13
7689	284.2594038410788	254.78694158075533	0.2704709985442321	269	1455777	7
7690	284.1952290466543	277.8419243986242	0.3703843256905942	279	1456056	10
7691	282.410178395532	105.69016393442678	0.17711907244743186	188	1456244	14
7692	282.62840994491	304.23333333333204	0.3115526133570178	290	1456534	8
7693	284.5335088241843	473.138297872338	0.2658657951150986	374	1456908	4
7694	282.85862828139705	117.04545454545506	0.20260837160307785	174	1457082	1
7695	283.43932771286876	340.9285714285697	0.7428347437005294	304	1457386	9
7696	283.0415721168995	243.66376811594338	0.24113097506533102	287	1457673	3
7697	282.675642882217	246.44864864864968	0.29769179565880133	271	1457944	11
7698	284.1902269551869	434.13405017920866	0.25691445758592646	353	1458297	6
7699	283.1379446118343	178.96199261992675	0.348132331772606	202	1458499	12
7700	281.69444639176965	138.78812260536438	0.16503965985643995	182	1458681	7
7701	280.9357329509543	205.82310231023166	0.3273555254081331	251	1458932	2
7702	280.2519259570152	212.55503355704758	0.3001527488231659	256	1459188	13
7703	278.25055738237654	80.11506849315116	0.8982895456683573	191	1459379	8
7704	276.932951462532	146.4899653979243	1.2925850892678286	195	1459574	3
7705	277.8802409955257	371.66190476190314	0.47557724461410983	330	1459904	10
7706	276.37766246616746	127.62238805970202	0.4624027295059033	178	1460082	7
7707	275.0765525081725	146.26666666666722	0.4605187101317157	203	1460285	12
7708	275.5621434187343	323.6356435643548	0.24480165254085437	327	1460612	14
7709	279.80972118773417	700.319920318721	0.3106362381323571	446	1461058	5
7710	280.0816731561847	307.0049180327857	0.27019470813227636	306	1461364	4
7711	278.0353966545079	75.45402298850603	0.8294538172279916	164	1461528	13
7712	276.91879098728253	166.3748299319732	0.2911680832649898	206	1461734	2
7713	277.7510004284031	360.1397350993361	0.29232916747324567	338	1462072	1
7714	278.1536751374948	318.01847133757747	0.34136304203767953	322	1462394	6
7715	279.94067461800387	456.8536231884038	0.35173769902916596	358	1462752	11
7716	279.9708427847157	282.9574912891952	0.3448990478515625	375	1463127	9
7717	277.82480648801607	65.36721311475438	0.867103437943892	165	1463292	10
7718	276.45998191068037	141.34234875444898	0.15617439963600852	187	1463479	12
7719	276.49750395537285	280.21218637992774	0.944083971854968	351	1463830	8
7720	276.4073395470483	267.48106312292316	0.2907524516149772	281	1464111	3
7721	274.96146287288934	131.8196721311481	0.1808013916015625	189	1464300	1
7722	273.3131708248056	110.13225806451663	0.1384613463219176	188	1464488	2
7723	273.60871743823583	302.8678321678312	0.25751578971131206	292	1464780	4
7724	274.8911923076491	401.85620437956084	0.5001786549886068	360	1465140	7
7725	275.82321393938986	368.0933554817253	0.40715717563967735	338	1465478	13
7726	277.7377465058783	467.2764705882332	0.2228843962193849	363	1465841	14
7727	277.4399922292253	247.96231884058028	0.3277158352918241	273	1466114	6
7728	279.2735417654168	460.79494584837164	0.2847258948768432	373	1466487	5
7729	279.6450437578345	316.42374100719275	0.23274069362216526	288	1466775	11
7730	277.7111959692628	86.26026490066275	0.3729167860381457	196	1466971	3
7731	277.95653855502474	302.24545454545336	0.5964398103601792	272	1467243	12
7732	279.99471834321963	481.774517374513	0.2978980910610145	355	1467598	9
7733	279.7036908922289	250.8919732441484	0.3776266341818903	266	1467864	8
7734	281.7676288937009	486.0974910394231	0.24298180017188553	371	1468235	10
7735	281.46360339841465	251.36507936507977	0.31853055783070117	279	1468514	1
7736	279.92855559972463	127.95882352941234	0.23577109888980263	190	1468704	6
7737	278.3718414722988	124.2571428571433	0.1551926999478727	185	1468889	5
7738	277.74076161179266	215.26385542168785	0.3789272904396057	256	1469145	7
7739	276.18759641991716	122.42424242424298	0.4531564377061087	199	1469344	11
7740	274.59471662430036	116.8996168582379	0.2745180408857022	171	1469515	12
7741	275.5145345826125	366.5765124555143	0.467311608006588	319	1469834	4
7742	276.57666823365156	381.7278996865185	0.3484328832381811	351	1470185	2
7743	275.1915467126054	138.06451612903265	0.16364953505932986	199	1470384	3
7744	274.27333239490457	183.3701149425296	0.6247031788408983	263	1470647	14
7745	275.5854562138126	405.48571428571154	0.2908488876388052	337	1470984	13
7746	274.236908841217	140.73071895424897	0.2078543351721887	193	1471177	8
7747	272.7880212342863	129.34814814814862	0.19522208963485962	187	1471364	10
7748	272.94503455806506	288.48935361216644	0.36210496690538196	270	1471634	9
7749	270.8514319633495	63.584775086505395	0.2560995809687009	159	1471793	11
7750	268.68513294116644	54.221529745042325	0.6292516534978693	165	1471958	5
7751	267.5260951710768	152.7813559322039	0.24325405120849608	200	1472158	7
7752	265.83972895620815	98.88947368421094	0.12372341610136486	168	1472326	3
7753	264.34764483390586	116.63131672597919	0.13167235915725295	185	1472511	2
7754	262.6702335321466	96.60651465798092	0.08201929875191925	173	1472684	14
7755	260.6973160069517	65.37848101265848	1.133241744268508	168	1472852	13
7756	261.4780991192836	338.7756272401418	0.44473090344923166	303	1473155	6
7757	262.11474669951934	325.1428571428563	0.21118364961917124	319	1473474	1
7758	260.5897670177591	109.61677852349044	0.10754121287485187	178	1473652	9
7759	258.8242138291869	84.03444816053553	0.08203794338085034	162	1473814	11
7760	259.49578606215243	325.9814371257468	0.40303526728986255	332	1474146	4
7761	259.77766526223377	287.6837060702871	0.7060689844169726	349	1474495	12
7762	259.8474340641569	266.75454545454505	0.5028970358255026	286	1474781	10
7763	259.8656935638195	261.6733840304176	0.3481285431805779	272	1475053	5
7764	258.8241670629639	155.71304347826128	0.1822999985837146	181	1475234	13
7765	259.8556887992743	361.97634069400306	0.23209947920114982	354	1475588	8
7766	259.6923039542923	243.51720430107608	0.31331558833046563	252	1475840	2
7767	260.6103024833768	351.49215686274334	0.2211993137995402	288	1476128	3
7768	259.1618158968992	115.76164383561692	0.2921573617364054	177	1476305	11
7769	259.4542591713773	288.40614334470877	0.3007066192098967	289	1476594	14
7770	260.8272972248248	396.7580645161273	0.342779364289537	354	1476948	7
7771	259.4424202257309	122.3395973154368	0.2081350378088049	185	1477133	10
7772	259.80196987968276	295.39738562091355	0.17179252697636907	313	1477446	1
7773	259.63820267258035	243.42524916943665	0.1527906635640814	289	1477735	9
7774	257.6615197054157	61.96990595611293	0.7735915856858704	163	1477898	13
7775	256.8558900156079	177.09855072463864	0.26750405753169076	257	1478155	12
7776	258.21894949001006	393.161837455829	0.2272922526990707	343	1478498	4
7777	261.1318159391659	549.5055944055907	0.46846355710710796	448	1478946	6
7778	259.67977965896887	115.92818791946361	0.13686756511310955	182	1479128	14
7779	260.37540291501074	329.24210526315585	0.678395761343149	325	1479453	5
7780	261.95248409185314	418.0835205992487	0.33598743983677454	350	1479803	2
7781	261.9022925842679	256.933333333333	0.29661754419595115	263	1480066	10
7782	264.56018438710737	527.6914728682154	0.22611206535279282	381	1480447	3
7783	264.4718821948042	255.72996515679372	0.3991694016890092	264	1480711	1
7784	266.2070931974175	437.99298245613534	0.5688114410166241	391	1481102	11
7785	266.58632190443245	304.12996389891543	0.17674698368195566	279	1481381	13
7786	265.4514586853881	153.10000000000053	0.12877005719124002	188	1481569	14
7787	268.93948545191756	614.254135338339	0.3015782233272496	473	1482042	8
7788	269.71169623120124	346.1605633802806	0.23491761254482582	305	1482347	12
7789	271.13156902998134	411.69897610921123	0.32640112425720386	353	1482700	9
7790	270.9628126617154	254.25593220338965	0.237317544442636	270	1482970	4
7791	272.3368288304003	408.3644295301982	0.23995555025859944	412	1483382	7
7792	270.8273897456361	121.39292035398276	0.1305238809158553	201	1483583	5
7793	268.96406029262414	84.49444444444484	0.0670262212338655	161	1483744	10
7794	267.6317730731565	135.73533834586524	0.12312961015544954	183	1483927	3
7795	268.5480950185383	359.26396761133367	0.1967277266466577	293	1484220	2
7796	269.33475692549575	347.2142857142839	0.43866872787475586	384	1484604	6
7797	267.32216019799165	68.07508417508447	0.940587043762207	160	1484764	7
7798	267.57852995813795	292.95913621262366	0.23915209835522797	292	1485056	11
7799	268.0340880929	313.13434343434204	0.2648391471003855	302	1485358	13
7800	270.53191588666976	517.8168674698769	0.2793744510198756	363	1485721	1
7801	271.4523396996906	362.5742971887538	0.23931353917785447	309	1486030	8
7802	270.18679729128684	144.8980988593162	0.21323359721415752	185	1486215	3
7803	270.5412626517073	305.633333333332	0.15842969866766446	276	1486491	9
7804	268.68295103529124	84.71010101010137	0.10246756047378351	162	1486653	2
7805	269.71456443151266	371.8442906574378	0.3062806752677384	329	1486982	12
7806	270.0004490902278	298.3030303030287	0.25241746573612606	319	1487301	4
7807	271.9699083674414	466.9463768115912	0.60360607697596	402	1487703	14
7808	272.7791376326766	352.8928348909642	0.38365920241530593	333	1488036	10
7809	270.5559509075126	50.460465116278925	0.62079550152176	163	1488199	13
7810	268.97911623065227	112.87248322147703	0.14807625456229268	179	1488378	11
7811	271.0531690399769	476.384397163118	0.22084551338175565	377	1488755	5
7812	269.5922087781486	124.9571428571434	0.21862000026059955	178	1488933	4
7813	270.1902432121062	329.3956521739117	0.18390681645641588	292	1489225	1
7814	272.2718967366638	478.3555956678651	0.4895900413034043	414	1489639	6
7815	270.7502235708239	120.1045801526722	0.15100745267646257	172	1489811	13
7816	269.1309805943749	108.82592592592643	0.1992727840647978	170	1489981	11
7817	271.3463561031164	490.66853146852935	0.35477685576867707	407	1490388	7
7818	273.2997264291284	466.683388704315	0.317743391266668	382	1490770	3
7819	275.24105339691897	467.43242320818564	0.8753784924018674	410	1491180	8
7820	276.6313610760082	414.2718213058397	0.4869211719022783	358	1491538	12
7821	279.28863570054216	542.3588235294078	0.5287714434915937	421	1491959	9
7822	279.35618350723774	286.0434163701052	0.7000026551102454	377	1492336	14
7823	280.1714849815179	360.88633093524953	0.2393691624092519	311	1492647	10
7824	282.62234108879835	525.2570957095676	0.3737354278564453	456	1493103	2
7825	280.3605913621209	56.44736842105241	0.9113646234784808	224	1493327	1
7826	281.5528241581771	399.58387096774	0.2872171242143855	358	1493685	5
7827	281.6763911546905	293.90952380952257	0.27791132062873586	298	1493983	4
7828	280.2409655331065	138.133828996283	0.2512497715443872	179	1494162	12
7829	280.2991128398007	286.05569620253107	0.28398834832824105	303	1494465	13
7830	278.92624035547055	143.01186440678015	0.22651100158691406	196	1494661	9
7831	279.4312182346014	329.42402826854993	0.5208495797462833	309	1494970	7
7832	281.2558555107391	461.8949458483717	0.3479257657383028	362	1495332	11
7833	281.1284806291011	268.51836734693774	0.7009930732922677	273	1495605	8
7834	279.8758766738739	155.86808510638346	0.23987074156065244	185	1495790	1
7835	280.3055151674091	322.8397260273958	0.29951087900456164	298	1496088	3
7836	280.8768950610522	337.4435045317194	0.5378403889568072	401	1496489	6
7837	281.22260346235805	315.447735191636	0.2110851054288903	294	1496783	10
7838	279.4836147158701	107.32372881355973	0.21019287109375	180	1496963	12
7839	279.9493330858453	326.0554517133944	0.2570787471402843	321	1497284	14
7840	280.17517308832015	302.5333333333319	0.27038666169107545	307	1497591	2
7841	278.7081991352147	133.47777777777844	0.22966994841893515	192	1497783	9
7842	279.9791940669395	405.80769230769107	0.44312567239279277	364	1498147	5
7843	279.82903370521746	264.9631578947357	0.4245544047992582	277	1498424	13
7844	280.2483611156056	321.7617747440248	0.44695497277664814	365	1498789	4
7845	279.5798146113678	213.39371069182482	0.32852950750612747	255	1499044	11
7846	277.72212757636527	93.81111111111152	0.07580157213432845	172	1499216	14
7847	276.92577276944434	198.0866468842741	0.34143620355687915	303	1499519	8
7848	275.8225150417499	166.60000000000042	0.2822169523972731	208	1499727	2
7849	276.9315182377891	386.72283464566794	0.1701843011574667	305	1500032	6
7850	278.1058604948575	394.3657439446351	0.26649126703339504	346	1500378	3
7851	278.25510801235794	293.03061224489727	0.5248740647367375	334	1500712	1
7852	280.55232886205886	507.97719298245056	1.0894210672824183	428	1501140	7
7853	281.15820982875744	341.1404255319137	0.2071600665616836	311	1501451	10
7854	281.6995813984235	335.2953667953644	0.24210435417807027	314	1501765	9
7855	283.08674898313205	420.4163398692784	0.2821631354254645	370	1502135	12
7856	283.5710201794321	331.5138686131379	0.49551571418942025	297	1502432	4
7857	283.7829463412741	304.76363636363465	0.27536785791790674	315	1502747	13
7858	282.20248529891404	125.73684210526355	0.358328279364046	189	1502936	3
7859	283.69146044592486	431.0999999999974	0.3413623018962581	328	1503264	11
7860	285.0340408580769	417.94950166112625	0.3310586769947145	371	1503635	5
7861	284.64495294119047	246.12524916943656	0.3670370378567062	262	1503897	6
7862	284.55878736239583	276.0283950617284	0.6775691000263343	356	1504253	14
7863	284.6109311960889	289.77317073170616	0.3005983969744514	272	1504525	1
7864	285.0200287806797	325.5206896551695	0.32090581258138023	330	1504855	8
7865	285.24020349287287	307.03749999999815	0.2190320226881239	288	1505143	10
7866	286.19459250272024	380.6791044776086	0.3004980715448985	334	1505477	7
7867	284.8373974802201	150.475090252708	0.3435758021489488	191	1505668	3
7868	286.36423542594764	437.5211920529774	0.6073896447006537	392	1506060	2
7869	284.90230893884683	140.17158671586773	0.27183530641638715	184	1506244	5
7870	283.2069571781297	115.36713286713328	0.3457539437831133	174	1506418	14
7871	285.0672381598539	469.23505535055136	0.249160366163728	362	1506780	9
7872	286.28418989173053	406.76241134751524	0.2649329468444154	364	1507144	12
7873	285.1995407638976	177.81927710843482	0.39729697642273176	269	1507413	11
7874	285.77504195489803	342.74965986394415	0.26961032270242613	313	1507726	13
7875	286.2849008068722	336.7609271523161	0.2709734972785501	340	1508066	4
7876	286.4100200527717	298.7968253968247	0.2924043763358638	265	1508331	6
7877	286.7556917820685	320.9771929824538	0.41335555211009595	298	1508629	1
7878	285.17167332578623	128.35384615384655	0.17737223738330907	177	1508806	5
7879	286.43348600429306	411.3529411764689	0.568063656013169	334	1509140	8
7880	284.9642423494618	139.50912052117332	0.5475735473632812	200	1509340	14
7881	283.79651874515537	168.19188191881977	0.35831041192289576	199	1509539	11
7882	284.22545815134333	326.69045936395634	0.6058676583426339	301	1509840	3
7883	284.94682101949434	356.3617449664413	0.3161771355605707	328	1510168	7
7884	283.66330587789145	156.59530685920623	0.2369551705841971	202	1510370	4
7885	283.8740061524458	304.73333333333204	0.3351039953399123	285	1510655	9
7886	284.0419196856926	300.6653594771232	0.2951437263358575	293	1510948	12
7887	283.92067246335796	271.91719745222883	0.8242099834328421	369	1511317	2
7888	282.21419171737205	113.27259786476921	0.23346193240639943	183	1511500	5
7889	282.39086061100915	299.88108108108014	0.29144176716206543	311	1511811	13
7890	282.5534256891096	298.6473684210509	0.19940519017099545	302	1512113	6
7891	288.4889107372377	876.1019305019194	0.43838767935118844	543	1512656	10
7892	287.90295669480037	229.89350649350763	0.3483103338277565	265	1512921	1
7893	286.2897412542464	126.5814126394057	0.15097036518034387	183	1513104	4
7894	284.75363534749545	132.67915057915116	0.18869749347815354	178	1513282	12
7895	283.50020244229637	159.4103448275867	0.3890156601414536	198	1513480	9
7896	283.3522004178734	268.6999999999985	0.31568038157927686	312	1513792	8
7897	281.87418038997924	135.55019762845893	0.1688083030082084	185	1513977	13
7898	281.1156693553102	206.02307692307775	0.2843966545996728	308	1514285	3
7899	280.6435738862469	233.90612244898043	0.355041016405002	313	1514598	7
7900	281.832373441502	399.52352941176304	0.16524237917180648	342	1514940	14
7901	281.86086788890515	284.6818181818171	0.606143700148531	334	1515274	11
7902	281.83697850826167	279.4719298245597	0.3707846027531036	292	1515566	5
7903	282.6532058963239	363.4597173144863	0.21464351393421244	322	1515888	2
7904	280.83679504948185	101.01212121212168	0.6166170414407455	201	1516089	9
7905	282.29697322444827	426.8546125461234	0.34672432946741755	343	1516432	6
7906	283.32608378417456	385.20802919707916	0.4942893094794695	344	1516776	10
7907	282.43103100002406	193.82080536912807	2.18705409026343	242	1517018	12
7908	282.4056517245065	279.89310344827425	0.37348766439765163	338	1517356	4
7909	282.18384938786346	260.2254180602004	0.1355623238252633	273	1517629	8
7910	280.41891390401827	105.69030100334507	0.27929737646255137	213	1517842	11
7911	280.43181017423075	281.70854092526605	0.13012364613924096	278	1518120	13
7912	280.6573893534552	302.9897280966754	0.3994435442334367	383	1518503	1
7913	280.7097501004435	285.89346405228633	0.3338750531596522	310	1518813	7
7914	280.8254218302083	292.2769230769219	0.27801558404481375	307	1519120	3
7915	282.3911499440617	437.39823321554616	0.3520671632554796	360	1519480	14
7916	282.79695273033536	322.971428571427	0.16642916319800205	305	1519785	2
7917	281.33115301435276	136.21698113207592	0.21288591882456903	184	1519969	4
7918	279.6704866454995	115.26451612903273	0.13619973565225546	177	1520146	13
7919	279.5037149097436	262.9933130699085	0.29587036558144597	287	1520433	10
7920	280.6027720367404	389.40942760942494	0.3220803768928908	381	1520814	5
7921	280.2254634174966	242.87191011236095	0.20353447865631621	295	1521109	12
7922	281.50949863839406	408.6289855072445	0.7773275289449606	333	1521442	6
7923	281.42116040876687	272.675675675675	0.18216155677713375	279	1521721	1
7924	281.40533608791617	279.8387283236985	0.3667511318040931	322	1522043	11
7925	282.5490722007212	395.77894736841705	0.2593132681539413	357	1522400	8
7926	286.30637709915186	658.2795620437897	0.41533674157184103	460	1522860	9
7927	285.44111718668125	199.7803858520906	0.3482905493842231	252	1523112	4
7928	285.1421908632993	255.54848484848443	0.30388764159320153	292	1523404	14
7929	283.1132617082895	82.24927536231925	0.665532816142936	191	1523595	12
7930	284.7123388814164	443.0209790209774	0.34878812062043	359	1523954	3
7931	284.94475572248723	307.95402298850485	0.5417669065582366	339	1524293	7
7932	283.4852312421854	138.9923076923081	0.1660646520635133	186	1524479	1
7933	284.1569027392874	350.6523809523792	0.15199872200062733	302	1524781	13
7934	282.001390248997	68.6056537102476	0.2458460079216809	161	1524942	11
7935	280.3609917311224	117.9615384615391	0.3046266892377068	204	1525146	9
7936	281.9652865757159	440.79047619047356	0.5210927039300416	353	1525499	5
7937	282.35572521322666	321.0091503267963	0.5790274856436965	351	1525850	6
7938	281.24128032064493	170.91123595505658	0.3903606414794922	200	1526050	12
7939	281.12599450156546	269.7126984126974	0.4808527806422094	286	1526336	8
7940	282.98470252808	466.99679715302113	0.3527931687934547	418	1526754	10
7941	282.48888951640464	233.40340136054476	0.39545895385742186	250	1527004	4
7942	283.14165733765844	347.76567164178863	0.20566696956239897	290	1527294	7
7943	287.6185458490275	730.8305084745679	0.5249038463132694	589	1527883	2
7944	289.170591159768	442.82307692307495	0.46130644854377295	340	1528223	14
7945	288.7012717512378	242.23865030674895	0.3862311321756114	276	1528499	13
7946	289.8986664411328	408.4407407407378	0.43761017603903823	322	1528821	3
7947	289.656717751405	265.7037974683542	0.2316582663017407	285	1529106	1
7948	289.2597362436729	249.95856697819428	0.26667244294110465	272	1529378	11
7949	287.9018279568664	153.46890756302577	0.1509167778300729	187	1529565	10
7950	286.56651555965067	154.37058823529466	0.2585979288274592	220	1529785	8
7951	286.6790255865359	297.8175182481746	0.3272242209282063	269	1530054	5
7952	284.92270368510094	111.04683544303842	0.5177720592867944	186	1530240	11
7953	286.33386126363456	426.03846153845984	0.36355414094224486	354	1530594	6
7954	288.1447171902473	467.41945392491004	0.36108877303752496	376	1530970	12
7955	287.4411765604009	217.7906542056085	0.4028693879268084	251	1531221	1
7956	289.22254857858064	465.57837837837576	0.2338102831448421	377	1531598	4
7957	289.4251140335614	309.47909407665367	0.286621523575044	284	1531882	13
7958	290.1100433443536	357.91804511277974	0.18085909542972095	292	1532174	14
7959	289.63990754113513	243.09646302250863	0.2775329816740242	269	1532443	10
7960	290.4118453832865	366.83369175627064	0.8376110132189765	345	1532788	3
7961	291.75178248500913	424.40555555555324	0.5379245543288161	373	1533161	2
7962	297.8115979934922	897.7333333333196	0.4254014700897469	605	1533766	9
7963	298.2518862688765	341.84042553191375	0.28842436639886154	304	1534070	8
7964	300.74573475312644	547.6367346938745	0.4109146567969636	441	1534511	7
7965	298.5666766988814	82.83992932862222	0.21523540019989013	160	1534671	14
7966	296.2067307799491	62.57208480565378	0.8883635818317372	186	1534857	1
7967	294.0694003142549	82.47368421052674	0.7464458032981637	194	1535051	12
7968	293.4255566105136	229.685029940121	0.20347066390385266	277	1535328	11
7969	294.47762536873273	398.63243243243056	0.21389080013648692	337	1535665	6
7970	293.4416862485959	190.88371335504976	0.4009165445963542	240	1535905	10
7971	291.8695607768384	136.22913907284826	0.3796490684074441	193	1536098	8
7972	291.5184880646929	256.76228956228954	0.3913199981782779	327	1536425	13
7973	292.1815595943024	357.8256410256399	0.3318627579334639	331	1536756	4
7974	290.32801797096215	106.8273972602743	0.1947116152778346	191	1536947	14
7975	289.4690603718977	204.4322580645166	0.6851176359215562	245	1537192	7
7976	289.97150628695005	339.713651877131	0.5699522598930027	322	1537514	3
7977	291.1197561363612	404.7964912280666	0.4224326023362157	337	1537851	2
7978	296.20513101316004	799.6572438162458	0.5664918442938243	589	1538440	5
7979	295.73607970302845	249.3000000000013	0.4598569869995117	256	1538696	1
7980	295.89388106816034	311.5162162162152	0.13772284018026815	296	1538992	9
7981	294.37292638446286	143.7984126984134	0.1423520230232401	188	1539180	6
7982	292.72530070627556	129.61035856573758	0.20407447168382548	177	1539357	13
7983	293.5603947782506	376.23470790377814	0.19538180813467576	326	1539683	12
7984	294.4451322938827	382.03414634146105	0.5725293438251202	325	1540008	11
7985	293.0652708990014	156.458992805756	0.4743931959123176	197	1540205	14
7986	293.923765730995	378.9147540983586	0.2583287258651599	341	1540546	10
7987	294.094803935754	311.0275862068938	0.7209333651851122	337	1540883	8
7988	294.6806764944031	352.6820598006625	0.27516413027523484	326	1541209	4
7989	294.83839211751877	310.4522388059683	0.420660426698882	290	1541499	1
7990	295.29909910543444	340.9090909090887	0.20451144470418975	299	1541798	5
7991	295.19239843696073	284.6290322580629	0.36482911808475565	314	1542112	7
7992	295.5333705564872	329.2896103896095	0.3324001927529612	310	1542422	2
7993	296.62763900145995	404.9602150537605	0.2950336307120723	358	1542780	3
7994	296.99666860513616	333.53059936908295	0.16470965217141545	323	1543103	6
7995	298.09251013826287	406.580821917806	0.13344713086076612	351	1543454	9
7996	298.65865400239744	354.7068965517215	0.31082768045413267	314	1543768	13
7997	298.82769458101757	315.56271186440523	0.4705053183723526	301	1544069	11
7998	299.26341763520736	342.3999999999985	0.2182092754657452	325	1544394	12
7999	297.46759505305823	119.68115942029021	0.22601305572680255	179	1544573	10
8000	295.6046001656506	111.16810631229278	0.10586216410652535	183	1544756	8
8001	297.2205614632642	457.20072992700545	0.19830184333068504	354	1545110	14
8002	295.4032911004301	115.4935251798565	0.7201599993024553	175	1545285	13
8003	295.627100294689	317.78421052631387	0.27864723700981636	308	1545593	4
8004	295.39102657065365	272.0197278911554	0.1360013064216165	272	1545865	5
8005	295.28952666351285	285.2410358565724	0.6183411474941539	294	1546159	7
8006	294.64521802301755	230.85866261398297	0.3613351696599139	274	1546433	2
8007	294.60176584278736	290.2999999999988	0.17649068059148015	296	1546729	3
8008	295.44065727526856	378.4909090909075	0.20511026851466443	305	1547034	9
8009	294.4838880651532	199.7637362637379	0.4526189447759272	364	1547398	1
8010	294.3193174771846	278.0268292682924	0.49235816289914536	298	1547696	11
8011	294.9467862742437	357.06619718309616	0.2955936719012517	372	1548068	6
8012	294.5036180630692	250.62996515679546	0.15339830186631945	315	1548383	10
8013	293.0175818824385	145.9000000000005	0.16489339404635958	180	1548563	7
8014	293.34642963263764	325.9023569023553	0.32838175752016335	309	1548872	14
8015	291.54388647195793	113.09211356466933	0.23647964556600146	193	1549065	2
8016	293.4094476072383	478.0999999999956	0.657747405567808	418	1549483	12
8017	291.44889411477243	97.3540983606562	0.24569669073027683	173	1549656	9
8018	291.59088690119944	305.6481727574739	0.392395736387112	298	1549954	13
8019	292.51126485389284	383.62868217054165	0.17200847748787174	310	1550264	4
8020	293.2454163562973	365.92641509433736	0.3145710774604848	302	1550566	5
8021	294.0352579673822	372.22957746478727	0.3091760179016488	326	1550892	3
8022	291.7544107257867	65.95053380782943	0.3093394267408154	158	1551050	2
8023	291.3767510950631	253.9884476534294	0.34670548872514206	275	1551325	11
8024	290.79544037423597	233.24567901234704	0.4735706723969558	290	1551615	1
8025	296.8033950614026	891.5909090908988	0.40296085370957646	574	1552189	8
8026	297.3071326463691	347.17715355805046	0.24499915338331654	310	1552499	10
8027	295.5133554375525	117.92941176470633	0.11921126047770182	180	1552679	5
8028	295.98410067105567	342.5878787878757	0.24620681720427198	361	1553040	6
8029	297.34917270782336	432.4913043478241	0.3186689135672032	348	1553388	7
8030	296.8524171770641	247.67361963190228	0.36965052736100373	283	1553671	9
8031	297.34650672370503	346.2613718411526	1.1661977972094801	327	1553998	14
8032	295.6711860608001	129.8144404332134	0.3943420747367058	181	1554179	1
8033	293.96280753352545	124.83333333333374	0.34862713191820227	184	1554363	8
8034	294.6475212303421	362.4341772151876	0.4777919284546573	362	1554725	4
8035	294.757379351372	305.6333333333317	0.4529532833375793	276	1555001	3
8036	297.02618011616215	521.6374558303864	0.31761559464985	401	1555402	13
8037	297.96653235008824	391.06140350876854	0.22747859840621493	334	1555736	11
8038	299.08049114006246	409.36241134751583	0.29531722661306165	338	1556074	2
8039	299.37857663962075	328.8890410958889	0.27986910452250563	306	1556380	10
8040	297.42830306834645	104.35121951219553	0.19767094203404018	175	1556555	8
8041	296.4791633398437	202.51433021806946	0.44446551415228075	248	1556803	7
8042	296.9241379402115	340.9766233766223	0.4682882208573191	323	1557126	5
8043	295.5417883357012	158.68917748917818	0.36723821303423715	187	1557313	3
8044	301.18737045234406	860.0999999999901	0.3902289604263561	598	1557911	12
8045	301.64387628577435	346.8379537953779	0.4389597886910468	326	1558237	9
8046	302.1465702090007	351.91326860841195	0.2622608980023249	331	1558568	1
8047	300.4719552531794	134.6850746268662	0.395110832465874	182	1558750	10
8048	302.37594793086333	490.8712230215766	0.44227250840928817	450	1559200	6
8049	301.3065237116703	195.4335260115619	0.44604257436899036	299	1559499	4
8050	304.42688704598214	613.342857142851	0.31367723128888375	437	1559936	14
8051	302.5998469336923	121.72287581699403	0.23655105019635694	187	1560123	7
8052	302.2290249349436	265.517647058823	0.24138004236054003	285	1560408	8
8053	303.2300055886042	402.3270903010013	0.6058803526293329	357	1560765	11
8054	303.6337055327181	343.5999999999983	0.3110143978267171	283	1561048	12
8055	305.66020833504217	506.28398576512143	0.3455428876901862	381	1561429	2
8056	309.99120167153905	738.7595419847291	0.5535591865893658	474	1561903	13
8057	308.3084513709953	141.7161716171623	0.3911323355669951	199	1562102	1
8058	308.11469472613777	288.932786885245	0.42942189183728446	290	1562392	3
8059	307.9799554221885	294.64076433120863	0.5934738209873339	301	1562693	5
8060	306.3483772420124	144.8221374045808	0.2611198623975118	192	1562885	10
8061	306.0029416623634	271.804819277108	0.22608867033349775	293	1563178	9
8062	303.9225486093761	97.9636363636369	0.07251219410713905	183	1563361	8
8063	304.2832533558405	339.9930232558122	0.26500306129455564	320	1563681	6
8064	302.44464958045205	120.42287581699411	0.14517866134643553	200	1563881	11
8065	302.7738697513142	335.3666666666648	0.22412412594526243	312	1564193	14
8066	301.03364112091515	128.75100671140996	0.1821522002524518	188	1564381	3
8067	303.04679076548285	502.34860557768485	0.24243511049087438	354	1564735	7
8068	302.5829874346305	256.6664576802505	0.23197323983175713	285	1565020	1
8069	302.97715756028424	341.9999999999989	0.8049741240620251	329	1565349	12
8070	301.3151563027026	136.77703180212055	0.4861507210680234	186	1565535	8
8071	301.77105427527925	346.90495356037025	0.3433533392008945	338	1565873	5
8072	302.3750057043574	362.16619718309744	0.5681768399532711	321	1566194	9
8073	306.62807654283614	727.6820895522309	0.6605970047708053	558	1566752	4
8074	304.5976923291319	103.58965517241424	0.34587023117963006	170	1566922	7
8075	306.5383624646641	498.6647058823504	0.19069412632992394	380	1567302	10
8076	306.1015305641554	262.85517241379193	0.45351361335440077	267	1567569	6
8077	309.12483104798747	608.4315789473616	0.4552697075737847	441	1568010	13
8078	308.5965682970743	256.29855595667794	0.20275849766201443	288	1568298	11
8079	308.0561365946861	254.5533980582521	0.2149930478914963	269	1568567	14
8080	305.8095752287392	83.40000000000035	0.25616408839370264	165	1568732	1
8081	304.1243858309669	137.29063545150575	0.34916174532187105	198	1568930	8
8082	307.6662848298	658.3142857142777	0.7511607766379362	523	1569453	2
8083	309.147836540889	455.82145593869365	0.19586845066236414	345	1569798	3
8084	307.4217047458772	136.53465703971162	0.3967532906481015	186	1569984	7
8085	307.50811152286985	316.0623824451399	0.28620013350960594	318	1570302	12
8086	305.44350099587643	101.04705882352977	0.17188546151825876	165	1570467	8
8087	304.95583049103715	256.67645051194495	0.3735624205391362	265	1570732	6
8088	305.44056630377383	353.4294117647044	0.4323998553936298	325	1571057	4
8089	306.39029060463497	400.41299638988886	0.3856669901343296	327	1571384	5
8090	306.58132887505917	325.49411764705656	0.21766609829509637	347	1571731	9
8091	305.6955155863086	218.0000000000015	0.29017801793017733	319	1572050	10
8092	305.5195435954287	288.0983164983157	0.1718489576144269	283	1572333	11
8093	304.8876157651082	242.32676056338164	0.21213391932045542	287	1572620	14
8094	304.6454406041348	280.67009966777334	0.20192948469878935	282	1572902	1
8095	304.302499875905	270.35136778115356	0.14688125154865322	335	1573237	13
8096	304.5360926245862	327.6617747440253	0.2129669937432981	306	1573543	2
8097	304.0826845602932	259.19528619528586	0.2650591201498606	269	1573812	7
8098	304.3326179670562	329.07602523659085	0.4238274892171224	336	1574148	3
8099	302.1942148643087	90.49230769230815	0.28506188643606084	171	1574319	14
8100	300.1696512017214	99.7378486055781	0.23181538672963525	157	1574476	13
8101	300.23805146389776	307.00967741935335	0.7209983053086679	316	1574792	12
8102	300.29474137179403	305.90704225352044	0.29777494731702303	285	1575077	9
8103	300.735659206303	344.3865248226938	0.25098079025365744	314	1575391	6
8104	299.0750168999543	134.6714285714291	0.7956157440834857	188	1575579	2
8105	299.90967849566056	382.5411764705865	0.2673491501226658	328	1575907	8
8106	300.83950950853784	392.8927797833907	0.6869322343306108	330	1576237	5
8107	300.5624070963793	273.1292682926828	0.44969561383440776	286	1576523	1
8108	300.7446426745383	318.78596491227773	0.7690117634518046	355	1576878	10
8109	300.83002675626744	309.28305084745614	0.5328101596316775	296	1577174	7
8110	298.7203302622897	89.8603773584909	0.22427941583524083	157	1577331	6
8111	297.04725430049075	131.4127340823975	0.10518211614890177	183	1577514	5
8112	296.3851943448984	230.84125874125954	0.3222176805674601	278	1577792	12
8113	300.5976953426258	717.635294117637	0.7497829568797144	580	1578372	4
8114	301.68233810750934	409.0619718309842	0.2979083296181499	345	1578717	13
8115	299.4502756691952	78.47609427609461	0.5036778541127588	157	1578874	10
8116	298.89980301283776	244.40301003344607	0.5019322019634824	264	1579138	2
8117	304.7225696885917	881.1764705882309	0.4643092593286989	599	1579737	11
8118	302.83467732503914	115.93333333333386	0.16277780698213964	173	1579910	6
8119	301.86837160750724	206.20410557184866	0.5208549364716762	283	1580193	8
8120	303.8868933708842	503.7205479452024	0.5455381126310082	407	1580600	14
8121	306.1795702247211	533.1545787545746	0.5860377049708104	455	1581055	3
8122	307.3487036004881	423.0929078014157	0.35217995618386244	378	1581433	9
8123	307.0697147851237	279.4498220640562	0.1322819115980616	265	1581698	7
8124	307.22389661816413	322.4878980891691	0.17619506075235405	341	1582039	1
8125	305.07380782263095	92.21501706484685	0.18346057417830067	169	1582208	2
8126	302.86601418884914	84.29444444444482	0.1669119384391176	163	1582371	6
8127	303.1444623502097	330.71083032490776	0.2269767862282052	302	1582673	12
8128	301.3318537922814	121.88360655737762	0.1579219416568154	190	1582863	9
8129	299.4845314229409	116.59961685823791	0.23663683047239809	174	1583037	7
8130	300.8346052025626	434.49190938510964	0.3035887665358571	379	1583416	5
8131	301.35078005085853	352.45209003215194	0.4817791271496106	333	1583749	10
8132	301.40332780590546	306.60555555555436	0.15331654849638574	301	1584050	11
8133	301.2891898347056	289.98953068591914	0.3102300892705503	276	1584326	3
8134	301.625980784255	334.9682847896409	0.983913616992714	371	1584697	4
8135	301.98110076735315	337.1379790940745	0.3275684582481503	321	1585018	14
8136	303.7092300581871	474.79402985074194	0.18590947090758436	363	1585381	8
8137	303.74106417900987	306.8926421404671	0.45190667486810066	308	1585689	1
8138	307.29765353721973	659.3999999999947	0.3716568144241182	505	1586194	13
8139	307.09590777107826	287.12307692307576	0.2686147721929582	297	1586491	2
8140	305.2353913163183	121.04426229508253	0.25528893103966344	182	1586673	8
8141	306.6964822430128	451.3444839857625	0.2739318044562089	361	1587034	6
8142	306.4750384561813	284.55210355986844	0.12018174391526443	325	1587359	12
8143	305.75885950019097	234.857142857144	0.19349234249429464	279	1587638	7
8144	306.35788380841484	365.66129032257953	0.5365475505387702	294	1587932	11
8145	306.36151075811205	306.7205787781332	0.62675936810382	308	1588240	9
8146	307.1832448568801	388.53492063491916	0.23042752742767333	320	1588560	5
8147	307.2075033174022	309.6090909090902	0.3411971850272937	312	1588872	10
8148	307.8253618390454	368.9933554817253	0.16177466720070882	329	1589201	3
8149	308.36835658666797	362.12483660130545	0.22924944866134458	332	1589533	14
8150	309.9046730208013	461.99999999999784	0.3106445070936057	379	1589912	4
8151	310.7370505330175	393.14242424242263	0.21441502724924394	310	1590222	1
8152	309.1448930861066	151.5213058419249	0.36539485667011523	202	1590424	12
8153	307.5070691552455	145.36250000000055	0.16597825737409694	186	1590610	5
8154	308.08628705429703	365.4288590604011	0.42338868993273854	338	1590948	13
8155	308.04850354883337	304.30793650793487	0.48473408066223717	321	1591269	2
8156	308.5895468152318	362.15283018867694	0.313228657703526	302	1591571	8
8157	306.65018195932436	114.65306122449016	0.4818330477069876	179	1591750	14
8158	304.9307811850273	134.71010452961715	0.2529753607672614	185	1591935	4
8159	305.7654652430957	388.39918699186757	0.19811178043188638	302	1592237	9
8160	306.34291228558	363.5101694915232	0.20045653834487454	330	1592567	11
8161	305.87074206240055	259.1258899676368	0.5168380737304688	288	1592855	3
8162	307.27247172786923	446.04370860926934	0.3685205781747445	373	1593228	7
8163	307.6796940304581	347.9947019867534	0.23351992452545633	327	1593555	1
8164	306.9752304234869	237.23333333333443	0.6180514408991887	260	1593815	13
8165	307.4386319654058	353.31538461538344	0.2022730998503856	312	1594127	12
8166	304.91560988416234	55.13642384105946	0.1483669547767906	143	1594270	3
8167	303.24509014895705	137.86363636363689	0.7782970926036006	184	1594454	11
8168	303.13031807958424	291.7678832116779	0.13347392684363668	293	1594747	8
8169	305.93559451662276	583.6579617834307	0.2548298187255859	500	1595247	10
8170	304.9439877877575	206.77492163009504	0.32592812952292394	251	1595498	4
8171	309.16796371744	727.3415807560044	0.7424187668231355	595	1596093	6
8172	308.60258701186166	252.63029315960983	0.19417746049644302	274	1596367	14
8173	310.6481166972985	513.1555555555511	0.5040504690039525	423	1596790	5
8174	311.7829520770881	424.13165467625515	0.38814477235572775	362	1597152	9
8175	313.55006176604365	488.4939209726414	0.534058605611083	494	1597646	2
8176	312.83315938885244	241.85982404692237	0.30920344502706554	337	1597983	7
8177	312.533276070826	282.84482758620544	0.1975923802730811	274	1598257	12
8178	310.5992536549453	119.13103448275918	0.27850278558578084	187	1598444	14
8179	310.80062475475944	330.73636363636274	0.3378330556357779	328	1598772	13
8180	310.32847471636217	263.5856209150324	0.44084556873898834	337	1599109	1
8181	310.2322267584962	300.7036789297652	0.36637999279664296	303	1599412	11
8182	309.7499272922142	262.0022801302928	0.21851259684391158	278	1599690	10
8183	309.20917801929204	255.67499999999956	0.2529158959021935	286	1599976	4
8184	309.4364703450594	331.9384105960251	0.2462679466105396	322	1600298	8
8185	310.34610564160874	400.3999999999974	0.38610736743823904	370	1600668	3
8186	310.1698357114725	292.71911262798517	0.529315676007952	280	1600948	5
8187	308.46558500778735	139.74476534296073	0.40473628797029193	190	1601138	7
8188	309.1987558725109	381.78267148013987	0.7387901777102623	405	1601543	6
8189	309.93339918626896	382.6630872483197	0.19984918329306453	367	1601910	9
8190	308.23141636497485	139.73511705685698	0.3082941764794686	207	1602117	1
8191	308.7153280077767	356.62258064515964	0.25362030665079754	336	1602453	2
8192	306.8335739371851	120.53992094861702	0.28078355088745804	177	1602630	6
8193	306.5931213146964	282.7883116883112	0.26122623019748265	288	1602918	10
8194	305.5637875858262	203.6597484276739	0.3327569000480711	258	1603176	8
8195	305.4927416832121	298.45919732441394	0.39519456314713985	292	1603468	4
8196	307.4318756382211	499.4061371841113	0.2050175666809082	384	1603852	14
8197	306.5698346596166	221.22777777777887	0.23476173764183408	252	1604104	5
8198	305.7242127461415	222.00764331210277	0.36650442261206334	263	1604367	3
8199	307.093967182254	442.6996563573855	0.25469038442905517	383	1604750	13
8200	307.85032259239864	382.72950819671723	0.4300157045988443	434	1605184	12
8201	307.3323042149595	256.0484848484843	0.2569444237685785	287	1605471	7
8202	308.61615383468035	435.7172661870451	0.4489201290506712	426	1605897	11
8203	306.3316225214139	80.1630225080389	0.23037969330210745	162	1606059	10
8204	306.55286657988773	328.45602836879317	0.17207667634293838	296	1606355	1
8205	304.8466599479872	135.93220338983102	0.539509068781407	199	1606554	6
8206	303.39870947753957	160.05161290322647	0.24546747700149465	213	1606767	4
8207	303.7872189814036	342.2496598639441	0.24956970694679884	318	1607085	9
8208	303.39547852811654	264.61317365269434	0.2433929443359375	287	1607372	2
8209	302.2947563009749	193.32325581395392	0.501067432930799	246	1607618	3
8210	300.3827996194241	111.09908814589723	0.32302527794471153	195	1607813	7
8211	300.994253853195	361.5282229965136	0.31630038917993086	321	1608134	8
8212	301.44495815481173	346.06468401486825	0.3012770564889745	293	1608427	13
8213	300.3710278610975	194.05192878338377	0.30046051992496975	284	1608711	12
8214	301.9418538143706	457.45362318840375	0.28169391371987085	352	1609063	5
8215	301.7073583531499	278.4923076923066	0.268893369694346	291	1609354	11
8216	301.06601449934817	237.57297297297472	0.265222716939348	353	1609707	14
8217	299.09431876716604	103.89644128113926	0.3615053962258732	170	1609877	7
8218	297.0346663596362	93.12907801418486	0.20883923376391747	167	1610044	3
8219	297.0800229927431	301.57032967032825	0.3489126477922712	280	1610324	9
8220	297.563274044867	345.40512820512726	0.330934367048631	327	1610651	10
8221	296.84356386334093	225.5922558922573	0.22013551825719163	302	1610953	4
8222	297.6025616718065	372.74334470989464	0.27790028340107686	333	1611286	6
8223	299.24461490813496	461.80788530465634	0.3283361639858277	363	1611649	1
8224	298.40559221182235	215.34234527687403	0.2564835250377655	256	1611905	8
8225	298.955925728648	353.43894389438725	0.34716543978635317	359	1612264	2
8226	299.4718920686311	350.55255972696006	0.3148141933392875	316	1612580	13
8227	300.07069892114066	359.35257731958575	0.20403896839626065	323	1612903	12
8228	300.376110575997	330.61186440677767	0.18712897300720216	320	1613223	5
8229	299.951887464158	257.95379939209715	0.6260818829365584	307	1613530	11
8230	300.0101484637302	305.7779874213819	0.30446933920866526	306	1613836	14
8231	299.3824834611776	237.2436482084702	0.3798200787238355	265	1614101	3
8232	298.70256185237236	231.39032258064586	0.24115709650436504	298	1614399	9
8233	298.93794799855453	322.24117647058694	0.1613717297323389	306	1614705	7
8234	299.14005000005045	319.1481481481464	0.3972373619211586	289	1614994	1
8235	299.6816185402976	353.2969040247667	0.16396225066412062	336	1615330	4
8236	299.84995387004614	316.5151515151489	0.20656100385168563	349	1615679	10
8237	299.56511671076686	271.3662379421206	0.20541996675379137	340	1616019	6
8238	300.4199041401504	385.0438596491195	0.27646651091399016	324	1616343	2
8239	303.3173974064411	590.1692307692269	0.3611308910228588	405	1616748	8
8240	303.2343900990433	295.0166666666659	0.21693878722705429	278	1617026	12
8241	303.9141339173511	371.2087719298215	0.4453083772837005	322	1617348	13
8242	303.9213259115109	304.63333333333213	0.1618486150995001	286	1617634	11
8243	302.17917887756136	129.70662251655688	0.17427456378936768	192	1617826	1
8244	301.2354358692736	207.80487804878192	0.381802868284908	299	1618125	5
8245	301.0074465899459	278.43650793650676	0.15136740807773305	294	1618419	3
8246	298.9801628217209	98.27906976744228	0.2219595882479705	179	1618598	6
8247	298.984694526837	299.43333333333095	0.333776214419032	338	1618936	14
8248	299.4493602169477	345.451263537904	0.23406229688969743	299	1619235	9
8249	299.2550385893005	280.0171974522282	0.22965259022182888	288	1619523	7
8250	298.94867187687686	268.61836734693776	0.2104328520157758	272	1619795	10
8251	297.26121302188517	130.20278637770963	0.3006428870085244	214	1620009	2
8252	295.3126008916663	102.40000000000046	0.1388296835763114	175	1620184	11
8253	296.72578474190453	436.63098591549107	0.27373343791037885	351	1620535	4
8254	295.3253113467823	156.67844522968244	0.4044440954773869	199	1620734	1
8255	293.10973794861695	73.76797153024943	0.32814121877910285	151	1620885	10
8256	293.5328510954465	335.42105263157674	0.5147536721273034	329	1621214	12
8257	295.1498896256905	455.2367041198477	0.25395079442529433	353	1621567	13
8258	294.75528169516565	255.68909657320847	0.23670598660135098	277	1621844	6
8259	295.9642735936611	415.6544715447128	0.28276671877332554	314	1622158	5
8260	299.05581412465676	605.1183266932229	0.4155442346980916	402	1622560	8
8261	298.618093821248	255.2837837837837	0.30251524481974856	284	1622844	14
8262	299.9495821743741	431.76692913385665	0.33090893573352687	327	1623171	9
8263	301.2099588358518	425.9872483221454	0.5299779943517736	370	1623541	3
8264	303.261930113635	506.4070866141709	0.4064285444176715	368	1623909	7
8265	304.01905517340083	378.9744360902229	0.3711947711360571	307	1624216	2
8266	304.601146851632	362.22822299651364	0.1377918097623594	314	1624530	11
8267	304.97290161688187	341.7766233766223	0.269127449156746	315	1624845	4
8268	303.4422097754342	151.90371747211952	0.28781320672286187	190	1625035	5
8269	303.9573666250482	354.9578947368396	0.3490702464861452	331	1625366	1
8270	304.31479295879774	339.69999999999845	0.329915851565963	282	1625648	12
8271	304.36208092664566	309.04358974358894	0.4429086922040952	306	1625954	10
8272	304.1950302108371	287.6570093457936	0.17769205729166668	300	1626254	13
8273	304.48291324206207	332.98333333333187	0.1287519787985181	315	1626569	6
8274	305.06073643939055	362.2652329749083	0.5319232522133376	319	1626888	14
8275	305.6713678293219	366.12387543252447	0.2560946106534651	317	1627205	8
8276	304.84727403406964	223.26198830409442	0.2088436927659656	281	1627486	9
8277	303.43425712411766	163.54558303886972	0.40860213094682835	201	1627687	5
8278	304.1136966540438	371.37821011672963	0.2834007862078045	293	1627980	2
8279	302.25074740081396	117.81877133105858	0.22306807323168681	186	1628166	12
8280	300.5610626218413	133.2822695035468	0.9126884899838432	191	1628357	10
8281	301.85665461000195	430.1202614379058	0.5470408313679245	371	1628728	3
8282	304.0186436194574	518.0555555555512	0.29756337946111505	374	1629102	7
8283	305.10094669375235	412.24895104894966	0.7748147338551761	387	1629489	11
8284	305.3429848458625	329.3047619047602	0.28090127798227166	325	1629814	1
8285	305.89646967317174	360.69146757678925	0.46787745719452384	317	1630131	13
8286	305.4227470146566	258.5242038216554	0.2023043360028948	280	1630411	8
8287	306.03062173429106	366.2102189781009	0.3497008550734747	315	1630726	14
8288	304.46070482992525	149.03893129771055	0.2464500995392495	188	1630914	7
8289	304.81823571266045	340.2137931034455	0.16939683718102	321	1631235	9
8290	304.33090847920874	256.08551236749037	0.3015912613778744	265	1631500	2
8291	308.1405993944166	685.2999999999939	0.4650677411984175	546	1632046	4
8292	309.58101831629733	452.1824915824873	0.33346771162581507	393	1632439	6
8293	309.93607338136127	345.0865248226939	0.25069362876469614	307	1632746	12
8294	311.37799334930196	454.12807017543395	0.6392828451620566	370	1633116	5
8295	311.86416754424926	359.9954128440354	0.20478190932162973	344	1633460	10
8296	312.10343984730133	335.79139784946074	0.20870153510610664	297	1633757	11
8297	310.0750939734185	109.26885245901693	0.1831904849490604	185	1633942	14
8298	309.96720017654144	299.28571428571297	0.5718892706840975	349	1634291	3
8299	308.5028059525538	163.52777777777857	0.15230893153770297	204	1634495	9
8300	308.0190650217411	260.12871287128627	0.27396940210051696	269	1634764	8
8301	306.3428743715237	140.40000000000052	0.20780385335286458	195	1634959	12
8302	307.54302457517684	426.35789473683786	0.39897899991485014	367	1635326	1
8303	307.088617130728	262.10228013029274	0.2249546119882742	277	1635603	7
8304	307.6269343492512	360.9203389830487	0.2264930061672045	322	1635925	13
8305	305.413532930287	86.2867924528305	0.21218394617880545	155	1636080	11
8306	306.79584164430537	443.6444043321263	0.4538397736601777	364	1636444	2
8307	305.460181735325	173.2298507462692	0.2509600321451823	207	1636651	3
8308	306.68890052865873	428.3320610687008	0.3363151778717955	334	1636985	6
8309	305.79383174809124	217.18202247191132	0.5549006726029174	271	1637256	5
8310	305.35278410585147	261.68906752411476	0.2677496205205503	276	1637532	10
8311	303.7219459199654	142.26896551724192	0.1933401659660533	197	1637729	8
8312	301.64787460891387	96.31481481481532	0.5643730163574219	184	1637913	1
8313	301.8308196546463	319.9423791821546	0.1305494503099091	294	1638207	14
8314	300.18584974806265	137.33382899628307	0.27302763423817683	187	1638394	11
8315	299.67935113258795	249.53598820059085	0.3206160052929049	306	1638700	9
8316	297.59135455612795	90.87969348659037	0.2710568714726922	163	1638863	3
8317	302.16304238513703	754.7601374570356	0.4156307097404234	527	1639390	4
8318	302.3418133218299	320.04013605442054	0.29376473332082986	302	1639692	12
8319	300.60796920673846	128.95740181268943	0.7030675714666194	220	1639912	2
8320	298.78875252836974	118.68630136986353	0.3722087734348171	182	1640094	1
8321	300.088255074008	428.73900709219646	0.20790179169812456	357	1640451	13
8322	301.72704036779083	463.96678445229486	0.5875849230536099	377	1640828	7
8323	301.3280045320142	261.8234567901233	0.3107089861064938	282	1641110	6
8324	299.73375957441334	141.90350877193032	0.5141366781647673	194	1641304	11
8325	300.62587619112344	388.94542124541914	0.361228468995657	322	1641626	5
8326	300.325360100222	270.57426710097667	0.4231280359728583	290	1641916	14
8327	301.5607555058423	423.86490066224974	0.24031775188183324	363	1642279	10
8328	299.7622067743133	121.7058823529416	0.34389340278156644	179	1642458	13
8329	300.1174986850648	335.2913978494607	0.4077265152078591	302	1642760	9
8330	300.27935554534787	316.3031847133735	0.4217232346856048	371	1643131	8
8331	301.12574665888394	384.91846689895226	0.48837109706913234	331	1643462	3
8332	302.4797114145173	436.52222222221997	0.22609089197737448	356	1643818	4
8333	300.38592672273234	93.10124223602531	0.34373919169108075	186	1644004	5
8334	301.9853531697907	460.3285714285677	0.2585492663913303	360	1644364	12
8335	303.0559752935235	409.0475655430689	0.3248859963765958	328	1644692	2
8336	303.03354838191666	300.8132841328401	0.4928519509055398	275	1644967	11
8337	303.28476219387215	328.1549295774635	0.1969058829989634	309	1645276	7
8338	301.4811645719334	122.9250000000005	0.17409356073899704	176	1645452	10
8339	302.1690880255518	370.273509933773	0.1584428492046538	336	1645788	1
8340	302.50721721450043	335.9820069204139	0.45934392574944016	307	1646095	6
8341	300.7534260340909	127.12809917355415	0.15858238044826464	174	1646269	12
8342	300.5020637482723	275.6171974522272	0.2872378108013107	332	1646601	14
8343	300.06049359002276	256.3450479233224	0.3565392169473846	279	1646880	8
8344	300.41827221576636	335.838356164382	0.2758089159355789	305	1647185	9
8345	298.9680622562546	155.39727626459194	0.1541935667699697	196	1647381	10
8346	299.18361484923975	320.5233215547692	0.24405646650758508	292	1647673	3
8347	301.5274756704443	533.5696969696943	0.30098477356116393	383	1648056	13
8348	300.94153424707315	242.93333333333464	0.3754980238221532	278	1648334	5
8349	300.0383361569986	210.62172523961766	0.3278850154654061	257	1648591	7
8350	300.7660704424874	372.811764705881	0.32458559066530257	315	1648906	11
8351	300.60768948082773	284.92797427652494	0.350965161939283	333	1649239	2
8352	300.949821972301	334.82093862815685	0.1405320087265888	297	1649536	6
8353	299.61211620540814	167.17924528301955	0.21540937691091377	214	1649750	12
8354	301.73286683822585	511.68717948717756	0.3183209957506953	427	1650177	4
8355	301.18441439134193	246.88762214983885	0.3074193681989397	364	1650541	1
8356	298.8284141135995	65.5843866171006	1.0705510488948466	161	1650702	11
8357	296.95586245653993	111.57324840764379	0.3673847339771412	189	1650891	5
8358	297.60190967139056	361.5605839416048	0.34540358323317305	325	1651216	10
8359	297.2870068537464	266.1116279069756	0.3607877221437964	303	1651519	3
8360	297.74340662647876	342.9269841269818	0.4370327691962249	411	1651930	14
8361	295.4083058935473	64.23333333333356	1.3922536749588816	190	1652120	4
8362	295.01433955385477	256.0116719242897	0.31631785331012535	278	1652398	7
8363	295.8992803334004	383.50841750841494	0.36939766132726076	339	1652737	13
8364	300.08191715969593	714.1629629629557	0.4505137731407213	487	1653224	9
8365	303.82046162446255	673.9363636363558	0.44645577092324534	496	1653720	8
8366	304.26881841172667	348.65614035087384	0.24686732985499352	337	1654057	12
8367	305.6036049750841	437.7474747474712	0.2629587643837864	369	1654426	6
8368	308.11171817906455	556.4149253731289	0.4626949734157986	405	1654831	2
8369	308.2237516822054	319.3150684931492	0.5227663684449467	299	1655130	11
8370	306.2005205551597	105.90063897763632	0.2844229667417465	186	1655316	14
8371	307.90350075106795	476.49854014598316	0.3390925357216283	380	1655696	1
8372	306.15956678885345	133.51010452961722	0.3334213489203284	197	1655893	7
8373	305.62317861376033	252.52074927953984	0.3035063519573852	298	1656191	5
8374	306.25355226979957	368.6605442176856	0.2809362821052411	326	1656517	10
8375	304.4463292471016	125.53125000000054	0.09177184735656416	189	1656706	9
8376	304.7734215101861	337.1555555555544	0.439382181539164	308	1657014	3
8377	304.5303303927273	280.46430976430884	0.2708436626277558	292	1657306	13
8378	304.18798483527894	270.29577464788696	0.5164123323961938	289	1657595	6
8379	303.00644582293904	186.03408360128697	0.4104229923808127	293	1657888	12
8380	302.6249879220867	264.8606557377031	0.27687237219896144	334	1658222	8
8381	301.8003973488595	220.16593059937037	0.18563505273741726	321	1658543	2
8382	300.27404854778473	149.16551724137983	0.19501965905204038	197	1658740	9
8383	306.09364139564013	882.2333333333238	0.3707072837679994	510	1659250	4
8384	305.24814869029296	221.54437086092784	0.7957093313838659	267	1659517	5
8385	306.0133270673356	381.76598639455625	0.26245838637798574	331	1659848	11
8386	305.9865271299955	303.3333333333321	0.187575018126829	299	1660147	7
8387	305.1686374684517	224.1975609756113	0.2856560233254103	318	1660465	1
8388	306.2212479135552	410.42968197879696	0.24591367869968028	347	1660812	14
8389	306.2371286021215	307.80931677018447	0.37283965964722476	306	1661118	10
8390	306.86236275827713	368.7605442176855	0.22219073955829327	325	1661443	3
8391	307.32012526930816	352.63861386138444	0.22285986803248972	334	1661777	13
8392	307.1471064270385	290.0182410423445	0.19203280419418492	291	1662068	12
8393	306.5562626690412	248.06273062730688	0.4426815844922659	249	1662317	5
8394	306.66792871129275	317.72286689419616	0.19974687784024986	303	1662620	9
8395	307.06135287245564	346.0103448275848	0.18377253520919615	332	1662952	8
8396	307.54327808911853	355.25387453874345	0.2606382043190834	321	1663273	4
8397	308.09914301815104	363.12977099236537	0.1302231881132094	299	1663572	7
8398	308.7980606788786	377.99090909090756	0.17546122151036417	310	1663882	11
8399	308.5481807010206	283.8100628930796	0.370222844426639	337	1664219	2
8400	310.49215279471963	502.9453900709174	0.7445628284896392	466	1664685	6
8401	310.7706287431131	338.3397476340667	0.3391270835018722	338	1665023	1
8402	312.9724796512539	530.955719557193	0.27568097102904376	409	1665432	14
8403	312.5411085524905	269.8353697749184	0.27822569227710214	291	1665723	13
8404	312.048048499414	263.2351032448372	0.6142042303360955	346	1666069	10
8405	312.7832936461888	385.5725631768926	0.39060900362596773	331	1666400	12
8406	315.6256744501849	597.0213740457981	0.2403244918165834	441	1666841	3
8407	315.63263992790525	316.322222222221	0.2888233382980545	308	1667149	5
8408	314.91879298068096	244.24794520547994	0.2139557408922501	262	1667411	8
8409	314.7372134651136	296.76084142394683	0.15566691080729167	300	1667711	9
8410	314.97613957607643	338.62982456140037	0.36237236390630884	332	1668043	7
8411	314.98471575993347	315.83375796178143	0.4052877670679337	312	1668355	11
8412	315.0285742879529	319.370568561872	0.21308910959526567	317	1668672	2
8413	313.6355487681217	175.7260223048334	0.3825269015330189	212	1668884	10
8414	314.02711219935935	352.79189189188895	0.20503023587740385	390	1669274	4
8415	312.8203362542147	193.349517684888	0.22790671151781838	252	1669526	14
8416	312.4726417674122	278.0508875739643	0.35269258939302883	325	1669851	6
8417	310.5460504848732	119.8135135135139	0.16807786880000944	186	1670037	8
8418	312.52787176696603	508.72817869415496	0.22103974877334223	410	1670447	1
8419	310.20911029067565	80.6517241379314	0.19346372387077235	158	1670605	7
8420	308.5218586038273	141.48394160584	0.13638790532162315	190	1670795	2
8421	306.32997804595806	89.33380281690177	0.32883726520302853	162	1670957	4
8422	309.21753540835556	595.0857142857083	0.5941945463081065	441	1671398	13
8423	309.3238785727905	319.85185185185117	0.37289823334792566	319	1671717	5
8424	309.0844867621515	285.3846975088961	0.2986230740601989	348	1672065	3
8425	311.16619927157916	517.255737704914	0.5559102822671587	433	1672498	12
8426	310.5857360366274	253.1198757763979	0.4096954431426659	356	1672854	9
8427	310.1353072476897	265.5428571428566	0.4177754235646081	315	1673169	10
8428	311.8613454795606	482.73913043478007	0.18796447126295387	389	1673558	11
8429	309.7888907549237	104.6158730158736	0.1979996102755187	183	1673741	2
8430	309.3385235865049	264.75217391304324	0.19740878761588754	308	1674049	14
8431	309.7434081919096	349.82698412698227	0.1460704357303374	342	1674391	6
8432	310.4208832008996	377.49090909090745	0.2111479744078621	315	1674706	8
8433	310.9062566982078	358.9582329317258	0.2469208263960041	305	1675011	1
8434	308.4118551481749	61.46610169491527	1.1039344043266484	164	1675175	12
8435	308.914129335967	358.6392739273911	0.42153436997357535	340	1675515	7
8436	309.14411084962484	331.9122807017516	0.3328707384845768	329	1675844	4
8437	309.0435498909413	299.08801498127207	0.3832195934496428	304	1676148	3
8438	310.7284105293709	477.52961373390184	0.3881944270292438	331	1676479	5
8439	309.24268782758594	162.15614035087762	0.4710606490031327	202	1676681	1
8440	311.2621196853695	511.1858736059444	0.2499918018331258	389	1677070	13
8441	309.25163408173614	110.21355932203433	0.20589391347524283	185	1677255	12
8442	310.23272239208154	407.3604651162775	0.1965086293774982	344	1677599	9
8443	311.2955841445386	416.5188976377937	0.3798859400778824	322	1677921	2
8444	311.5974418624152	341.4813559322015	0.2882604141966603	313	1678234	14
8445	311.94907761328255	346.7610169491504	0.5602668669165635	328	1678562	11
8446	313.2018615624244	437.2274725274701	0.21441177888350052	352	1678914	10
8447	312.63919987895355	256.9356932153386	0.2964121762829548	291	1679205	6
8448	312.78453399481367	327.17261146496594	0.2112986558785468	326	1679531	8
8449	312.3472772836281	269.0588628762537	0.4501418799684759	285	1679816	4
8450	312.21945810556304	299.5653594771231	0.1868128400099905	304	1680120	7
8451	311.39911382390864	230.18502994012098	0.76849224988152	272	1680392	3
8452	310.854581702063	256.9459016393438	0.2188628988063082	282	1680674	5
8453	308.92645693767395	118.0421052631584	0.20309921509441844	187	1680861	11
8454	307.3116940517989	147.450168350169	0.20099826959463266	208	1681069	2
8455	306.3654875590421	212.6910447761202	0.4205957346949084	290	1681359	1
8456	305.1632356685263	186.14029850746334	0.24335181388409685	257	1681616	8
8457	305.66527855299853	355.3675241157531	0.24074036734444754	336	1681952	14
8458	306.29151291480395	368.28871473354036	0.37945336235894095	360	1682312	12
8459	304.3818877484812	115.3289962825284	0.1460539258044699	184	1682496	5
8460	305.97161273064546	463.35438596490735	0.24926182121894377	383	1682879	9
8461	306.63949971617944	372.7603112840438	1.183874477525385	357	1683236	10
8462	308.8981317460446	532.5027027026983	0.38298941398671354	451	1683687	13
8463	306.41962411279474	61.047368421052624	1.6955268088351474	178	1683865	11
8464	306.62785644309537	327.2428571428554	0.4131184264317455	298	1684163	4
8465	309.0500511882729	548.8473309608504	0.4539437179930472	418	1684581	6
8466	308.0925030573425	213.2952380952386	0.15644286615163208	247	1684828	2
8467	310.74572148668466	573.4143459915583	0.4041174348278394	383	1685211	7
8468	308.466025363968	82.77610921501746	0.12885874398746847	161	1685372	12
8469	308.70167557964237	332.0310469314052	0.2986035122435509	361	1685733	3
8470	306.5277923978532	91.3133574007225	0.631405937380907	205	1685938	9
8471	304.6507033283638	118.81888544891699	0.2026680965049594	204	1686142	14
8472	304.6658092981761	306.16130030959664	0.20351183720124075	312	1686454	1
8473	302.9634469798422	134.42957746478933	0.1298038445267023	204	1686658	13
8474	302.4060864374365	247.22739273927453	0.19413839067731584	266	1686924	8
8475	303.1475031850024	376.54776119402663	0.2514244847043732	338	1687262	5
8476	303.5290353473969	341.3007194244587	0.363460389116853	327	1687589	10
8477	301.5294571710447	103.57121771217767	0.33962327735858727	181	1687770	14
8478	301.34759073389085	283.3428134556571	0.8369922968693552	346	1688116	4
8479	304.2949475261717	596.0832699619718	0.28946612362570606	426	1688542	11
8480	305.0146929661642	376.26949152542124	0.22601564396062546	338	1688880	2
8481	307.10711438182625	514.2568345323691	0.1941488054063585	396	1689276	6
8482	306.47164593161074	243.56026936027058	0.33791817394212065	257	1689533	9
8483	307.91319931356446	450.62698412698205	0.26325557046307774	334	1689867	12
8484	308.96123398709545	412.71666666666465	0.13608739043233062	351	1690218	3
8485	308.6314519055271	275.98302583025725	0.1962955690779776	265	1690483	8
8486	308.034507013979	248.93696275071775	0.3297058158267328	289	1690772	13
8487	307.4778265206417	252.36645768025184	0.21396937021395054	328	1691100	1
8488	307.93922231686867	353.61740614333905	0.42620163633112323	456	1691556	7
8489	305.81563711124386	95.58070175438637	0.07782019764544015	166	1691722	11
8490	303.8149929352534	105.7512195121955	0.24746888912982823	161	1691883	2
8491	301.8848070346778	110.79640287769831	0.15931673972837387	186	1692069	6
8492	299.86559532796736	99.9636363636368	0.17668736931736484	163	1692232	8
8493	299.8658871098793	299.8947735191611	0.24069724704908288	345	1692577	5
8494	299.9785887829982	311.13605442176754	0.21457606120918035	289	1692866	14
8495	298.6643530959714	168.55502008032215	0.2711773772737873	201	1693067	3
8496	298.07500314299335	239.72935779816694	0.35834046272234726	354	1693421	10
8497	296.1847910177006	109.05379061371879	0.13109900230585142	172	1693593	13
8498	297.39032512999546	416.7382022471887	0.3122916192364839	326	1693919	12
8499	295.3529137353731	93.64918566775287	0.18952165491440717	170	1694089	11
8500	293.05271684557636	65.3332247557006	0.9760400772094726	160	1694249	5
8501	291.1412426572531	101.90529801324548	0.18608507999154025	172	1694421	8
8502	290.9348302306805	270.4999999999993	0.4286988446501648	294	1694715	7
8503	290.4857450862685	246.02631578947424	0.19181232381487426	269	1694984	2
8504	290.92071880423697	333.9831168831159	0.34461472674113947	328	1695312	1
8505	293.4234613017291	541.1949685534527	0.6110031341980837	499	1695811	4
8506	296.23596047710765	574.6733788395821	0.7646204324132467	498	1696309	9
8507	296.11672074615365	284.3119873817024	0.49930532355057566	342	1696651	6
8508	296.16845064480145	301.2897106109308	0.23539997587267986	298	1696949	14
8509	296.11364963349905	290.6883495145617	0.186934368030445	296	1697245	3
8510	297.3442279660614	419.1714828897318	0.4141120910644531	332	1697577	10
8511	295.24813096327375	87.73452768729682	0.36860724193293876	164	1697741	7
8512	295.55925571424706	326.3606060606045	0.23283620782800624	296	1698037	11
8513	293.94976420240073	134.6101045296172	0.3657870138845136	186	1698223	2
8514	294.2052665603767	319.49999999999847	0.2596420488859478	304	1698527	12
8515	296.31075934931835	504.7545454545431	0.3146385982118804	406	1698933	13
8516	296.0087146928881	266.10629370629266	0.12715684370561078	275	1699208	8
8517	297.71194256427424	466.3315018314993	0.7704610016386387	354	1699562	5
8518	296.39089210414875	165.60689655172465	0.5360463584341654	205	1699767	6
8519	296.81511456996856	338.81313868613046	0.530599523473669	297	1700064	4
8520	299.26408739121104	541.7123966942128	0.19445520135947078	367	1700431	1
8521	298.318528484512	204.70819672131236	0.19507804283728966	247	1700678	3
8522	298.87819565868324	354.2852459016376	0.43665888859675484	325	1701003	14
8523	299.0547557216404	316.5342019543962	0.20923320327806622	319	1701322	10
8524	297.1187293999452	105.4521235521241	0.21717533535427516	180	1701502	6
8525	297.3582477915645	321.07056856187205	0.2407689921061198	300	1701802	2
8526	297.6944345444181	330.9769230769216	0.14405063390731812	320	1702122	7
8527	295.4688572875815	75.13670886075992	0.34936887479675605	197	1702319	5
8528	297.1200161723328	460.5847457627068	0.6028219686972128	444	1702763	9
8529	297.6710251609362	352.22091503267785	0.1994397045971753	333	1703096	11
8530	297.1039525904863	240.96376811594357	0.35483363935142564	314	1703410	13
8531	299.29946862013696	516.6555555555518	0.18886560263092986	388	1703798	12
8532	300.6377768384999	433.1302904564301	0.3725889417860243	315	1704113	4
8533	298.9753864118871	134.3987341772157	0.2974248644949376	174	1704287	7
8534	298.0128939856767	202.7261437908508	0.5094633755618578	292	1704579	3
8535	301.0569115659664	602.414652014647	0.40397021361071656	495	1705074	8
8536	300.89765558161986	285.1313131313123	0.251916017156348	279	1705353	10
8537	298.4777130815312	58.90340557275528	1.2803566128599877	153	1705506	12
8538	297.3522494303397	185.93134796238334	0.28776639302571616	240	1705746	9
8539	295.1425170594931	76.37901234567941	0.5916296641031901	192	1705938	13
8540	293.0453022210015	85.42103321033262	0.2771934766447946	178	1706116	4
8541	294.4918765025457	437.70273037542233	0.3337364613684149	366	1706482	14
8542	296.62248326304575	507.55255255254997	0.2626671907896454	449	1706931	1
8543	298.3895093529245	473.3250922509203	0.27996122903664017	358	1707289	6
8544	298.4851941966993	307.95799373040654	0.22871503986296107	305	1707594	11
8545	298.93884388339677	343.8501628664478	0.2605133731808283	339	1707933	2
8546	299.7493988407891	379.9943396226382	0.28321990966796873	350	1708283	5
8547	297.83380681316555	108.19019607843181	0.20569131540697674	172	1708455	8
8548	298.75255065629665	389.7081911262767	0.5882507598328733	334	1708789	7
8549	298.7332938064501	296.8268656716402	0.774323666569128	277	1709066	9
8550	298.57784398526866	283.1883116883112	0.44508439722195475	284	1709350	10
8551	298.8256211009715	323.3555555555539	0.2893310974691516	321	1709671	12
8552	299.79913953784904	396.1774647887308	0.3996503217084272	333	1710004	13
8553	301.0674728177952	426.6324675324647	0.18181305305630552	408	1710412	3
8554	300.57825453561026	252.1456445993036	0.4185129993366745	265	1710677	2
8555	301.17739791618004	360.4925925925899	0.25443058013916015	320	1710997	1
8556	300.0928777596482	192.725382262998	0.4338267448017136	243	1711240	5
8557	301.08757162356113	399.5622641509399	0.18637956891741073	343	1711583	14
8558	302.37498367710964	429.8287769784139	0.37738489055913216	341	1711924	11
8559	302.454583675322	310.3349834983484	0.39785832438977237	394	1712318	4
8560	301.9300688944694	250.00310559006294	0.34342998063483204	294	1712612	8
8561	300.44821994297644	153.74517374517447	0.3095999291194743	199	1712811	9
8562	302.8209335477424	537.7195804195775	0.3006379749853286	426	1713237	6
8563	300.9661838395942	117.34596273291977	0.3044583797454834	192	1713429	12
8564	299.3955382613608	143.90162601626068	0.2893580364924605	186	1713615	2
8565	299.16418893935327	276.260606060605	0.3730807834201389	297	1713912	10
8566	299.72346401746876	355.09169675089936	0.3108131122863945	347	1714259	7
8567	300.56783138398305	384.16020066889473	0.3823245799047707	338	1714597	13
8568	300.8715560552178	330.94029850746045	0.6858839016516232	309	1714906	1
8569	301.59382331253505	373.09828178693976	0.17197249326912611	323	1715229	3
8570	299.8326965272212	125.48114478114528	0.1345138649145762	192	1715421	6
8571	299.970869561949	313.64999999999895	0.2822727203369141	300	1715721	14
8572	299.05378178136215	208.26209150326918	0.3404119883152033	302	1716023	11
8573	297.8038095066197	174.05655430711656	0.2879881812530814	206	1716229	12
8574	298.8687445659159	404.29731543623956	0.3570028001611883	352	1716581	4
8575	299.6623474428374	378.2290322580623	0.410649092739852	378	1716959	5
8576	300.47197310335713	380.62491349480797	0.2695263627646626	345	1717304	8
8577	298.81220074074463	134.494736842106	0.1032908607450166	233	1717537	7
8578	296.5211852625468	69.7106529209625	0.49399945750740004	161	1717698	1
8579	296.45234767892714	289.6374269005838	0.32340814476850266	319	1718017	2
8580	298.6692625583022	518.1438356164344	0.37909033990675406	434	1718451	9
8581	298.76721324482105	308.46433121018913	0.2663275677224864	322	1718773	10
8582	298.3655088543083	258.5967741935474	0.3909401154853928	284	1719057	14
8583	297.6919143718259	231.00606060606165	0.570523640260858	295	1719352	6
8584	297.80056044549895	308.55652173912915	0.18483618207196886	283	1719635	12
8585	296.6815203582853	185.8965517241384	0.38632530686957983	209	1719844	7
8586	296.51177257043275	279.70674157303154	0.3315088337865369	348	1720192	11
8587	298.8981093901829	535.1454545454494	0.2578137618591464	393	1720585	3
8588	299.0391352649222	313.0006968641087	0.4377978169326241	423	1721008	13
8589	300.43859239712145	438.98484848484657	0.20176195543865824	344	1721352	4
8590	300.1077078659079	267.35013927576534	0.33668438281888274	306	1721658	5
8591	300.321123540872	321.44927536231745	0.17694711844657973	299	1721957	1
8592	300.677789017792	335.9876712328736	0.25523122151692706	372	1722329	8
8593	300.43092215964253	275.99110320284626	0.2429021199544271	264	1722593	9
8594	301.44490269069627	401.8289752650162	0.24231108685881356	327	1722920	2
8595	299.7428040287528	131.2350364963509	0.18779614974892206	183	1723103	12
8596	297.78601398129683	104.06379928315457	0.15556363466769288	177	1723280	7
8597	296.940180419557	213.20265780731006	0.4581808436331141	259	1723539	6
8598	295.6339104834933	166.31318681318731	0.3048700257843616	204	1723743	13
8599	294.8458138029008	216.82424242424347	0.275897216796875	255	1723998	11
8600	294.4874448368463	259.00891719745175	0.4736539859336828	307	1724305	14
8601	292.8048457507967	126.22753623188444	0.3226473818543137	186	1724491	5
8602	290.8972107208506	102.04134275618415	0.2395504421657986	180	1724671	1
8603	288.9892915937745	100.10529801324559	0.08400836241872688	190	1724861	12
8604	290.05342755870316	395.40288808663956	0.15074001099706744	341	1725202	3
8605	288.7488116504631	159.59183673469454	0.28661398192745957	199	1725401	7
8606	289.4012853660195	353.9961832061055	0.2169807093917944	314	1725715	4
8607	295.2465418726286	873.9269360269242	0.5075235674458165	620	1726335	10
8608	294.89738701290855	260.3310559006203	0.5519549419425126	346	1726681	9
8609	293.02854932954995	108.01361867704323	0.3978263110649295	164	1726845	3
8610	291.08008962022654	98.18257839721291	0.1277777848843329	167	1727012	7
8611	289.62322879893065	145.3940074906372	0.14242671314298797	193	1727205	12
8612	289.14752110110527	242.05245901639447	0.48578029446834037	267	1727472	14
8613	287.1313496875626	87.5303797468358	0.361918086097354	168	1727640	4
8614	287.3825686984269	312.2532507739931	0.2217245863649411	313	1727953	6
8615	287.0203139893606	251.15709779179915	0.20183686078605007	295	1728248	13
8616	289.8108057647212	566.0694915254189	0.42106652693314983	440	1728688	8
8617	290.5171815780417	360.44838709677265	0.3518890612053149	330	1729018	11
8618	288.593821083016	98.18113207547209	0.6405826507405163	187	1729205	10
8619	291.0751263178787	536.7243445692842	0.46710372680384726	437	1729642	1
8620	297.0021369594618	883.776190476184	0.5823347543237909	566	1730208	2
8621	295.0773933676449	104.52777777777828	0.4476663262181028	169	1730377	13
8622	293.36744296338026	124.08235294117699	0.1109591821829478	192	1730569	4
8623	291.56918181787927	113.54132841328472	0.8616516590118408	192	1730761	14
8624	289.5927564356866	93.92664359861625	0.30265385519244714	167	1730928	11
8625	292.2901446608033	559.3315789473604	0.6005103832087354	557	1731485	5
8626	291.84347398342607	247.62307692307758	0.7741841877976509	292	1731777	12
8627	292.6212973081079	369.6258064516113	0.3294241378556437	335	1732112	9
8628	293.92053594793003	422.5451612903212	0.6081547592625474	330	1732442	7
8629	297.11263770455554	613.1307116104832	0.44387773992890994	422	1732864	3
8630	295.9733838374702	183.18725099601642	0.1979944430403973	199	1733063	14
8631	296.94396914803167	393.03191489361535	0.2728883248788339	324	1733387	10
8632	295.2511423597772	127.66129032258112	0.41530056657462283	174	1733561	12
8633	294.429389972324	213.0759036144592	0.6128386460341416	308	1733869	2
8634	294.5529865319647	306.7890459363947	0.2665127648247613	288	1734157	4
8635	294.96723842560266	335.9781758957642	0.3186366558074951	320	1734477	13
8636	298.55376454321924	653.6198501872606	0.7501922486320375	504	1734981	8
8637	296.79822689778706	123.00000000000045	0.21571952774679873	169	1735150	14
8638	296.8276200934932	299.7375464684003	0.40642338008671014	273	1735423	7
8639	297.597690971596	373.83470790377834	0.7199649047851563	350	1735773	11
8640	300.78404739521335	616.2333333333281	0.5171224715861868	470	1736243	1
8641	304.991664437601	721.5457516339764	0.6289610686125578	594	1736837	6
8642	307.2761844129433	533.4436619718277	0.318400505745765	404	1737241	9
8643	307.92372659811787	372.030402930401	0.41210650159167006	308	1737549	3
8644	309.2937899456336	444.9300613496898	0.6147420914446722	427	1737976	5
8645	308.84692996825515	264.6077922077919	0.3004576249556108	275	1738251	4
8646	308.27312168552174	251.4661016949159	0.27455688245368726	264	1738515	13
8647	308.6751799423507	348.4789473684184	0.2602648879542495	330	1738845	10
8648	306.93524969174877	134.68215488215546	0.2767861779056378	201	1739046	6
8649	307.59183669661064	372.59395017793395	0.34785479921283147	330	1739376	8
8650	306.9902119076262	247.42935779816654	0.4996866715083484	277	1739653	14
8651	307.30734668891887	338.70369003689893	0.4133346254462438	302	1739955	11
8652	307.16301396277044	292.8740740740735	0.2708636219478497	311	1740266	7
8653	307.94470297207886	385.3319148936143	0.5037487914734647	401	1740667	2
8654	310.79313239023446	592.7876447876358	0.452113127662497	519	1741186	12
8655	311.432893673336	374.76926070038724	0.7377821135040897	298	1741484	3
8656	313.8176556456935	549.909090909088	0.7908650517172219	409	1741893	1
8657	313.5656622394197	288.61831501831375	0.22810191165358396	263	1742156	4
8658	313.69015669616215	326.0151079136673	0.15813940684000652	300	1742456	5
8659	311.88052785647324	132.72727272727334	0.15237270527748606	199	1742655	8
8660	311.470413299558	270.8690721649473	0.25289966038295203	280	1742935	10
8661	311.64754249989574	329.18333333333106	0.35214334979611145	353	1743288	13
8662	312.04475938258906	351.3692307692293	0.19086757047998212	293	1743581	11
8663	313.51054834790295	458.62365591397526	0.5803957543333261	359	1743940	6
8664	314.87559779400135	450.01549295774447	0.39659723889228354	358	1744298	14
8665	313.05802062400835	133.11788079470256	0.2785308997668521	191	1744489	3
8666	313.7261587276274	379.87183098591413	0.546389389038086	320	1744809	7
8667	312.0495638070178	146.06666666666734	0.5447830572360899	205	1745014	5
8668	312.65147740987175	372.24092409240683	0.3730015121501313	369	1745383	2
8669	312.0067716972617	248.18090614886808	0.5303552542159806	268	1745651	1
8670	311.99093012869895	310.4226148409883	0.4886260348329976	287	1745938	4
8671	312.7076874940786	383.66666666666504	0.20650431160506508	329	1746267	8
8672	312.34911061913783	276.8499999999991	0.2405423369423928	293	1746560	10
8673	316.66166252369896	743.604301075257	0.8740975100977891	735	1747295	9
8674	316.47463320004925	297.95873015872905	0.7609093686873296	321	1747616	13
8675	317.11630100946286	380.64141414141153	0.28628631409056887	334	1747950	11
8676	316.4457586890234	250.06206896551774	0.18221092966280095	257	1748207	7
8677	316.07772967356175	279.6428571428565	0.1698501336313512	274	1748481	3
8678	316.5689963328701	365.20439560439377	0.1546023655252488	303	1748784	6
8679	317.10228539052036	369.89790209790084	0.21473384869061526	321	1749105	14
8680	321.62491613138627	769.3653594771116	0.5345139708062603	606	1749711	12
8681	321.29992449515606	289.12575250836056	0.25463679798862393	285	1749996	2
8682	320.96365695752155	287.67317073170574	0.25557708740234375	293	1750289	4
8683	318.6992232349214	94.52028469750927	0.1509989234292583	157	1750446	11
8684	317.0887544925051	157.65234899328914	0.4463266401148554	201	1750647	9
8685	314.7456557674558	82.778881987578	0.10579260623816288	165	1750812	3
8686	316.6285880986701	503.03888888888554	0.2548216865176246	420	1751232	5
8687	318.58254859449494	512.0246376811568	0.3051604631651251	386	1751618	1
8688	318.61142879416866	321.470568561872	0.3128397142564928	296	1751914	8
8689	316.61596597202504	119.06514657980529	0.17970197394704135	209	1752123	14
8690	314.87442793392637	142.46216216216266	0.27115167890276226	196	1752319	12
8691	316.44179166852433	471.6108013937247	0.31164818841057856	370	1752689	10
8692	316.5542569133511	327.68831615120115	0.18637154553387617	296	1752985	13
8693	315.7043540957704	231.56397515528016	0.24326811165645204	261	1753246	6
8694	316.1696789758653	362.2368421052606	0.4251977896984713	324	1753570	7
8695	314.51933429878267	151.13521126760637	0.3606407989358678	213	1753783	9
8696	314.1411004573524	276.6959501557626	0.3683650769685444	285	1754068	4
8697	313.3953921554816	239.57027027027186	0.275686999551611	306	1754374	2
8698	313.7319119181373	347.04736842104967	0.21349308325809502	318	1754692	11
8699	313.1784021635044	258.38093645484923	0.21753759162370548	258	1754950	8
8700	311.02945764804224	98.28395061728439	0.18606335271603217	189	1755139	12
8701	311.8058501463917	388.6687074829916	0.30237417510061554	330	1755469	3
8702	311.8268825540187	313.9090909090897	0.3231689282952631	269	1755738	14
8703	310.4058385346801	169.72248062015566	0.23559027524729867	201	1755939	7
8704	310.63137500463876	332.95948553054393	0.570446139663013	335	1756274	5
8705	312.0930577210234	456.7996466431073	0.33356713996362436	378	1756652	1
8706	312.0758199542707	310.3692810457505	0.3917378795390226	294	1756946	13
8707	310.60604767022096	165.09859154929623	0.45525539121148306	179	1757125	11
8708	311.3586141527664	385.86269592476305	0.2996798876093979	341	1757466	6
8709	310.4543658951978	220.9337883959054	0.22214311916335874	247	1757713	4
8710	308.59615556957914	124.63333333333375	0.2711774559431179	186	1757899	12
8711	307.8368499624364	232.66559485530632	0.3426066525159916	309	1758208	9
8712	309.29055814012827	453.20766773162603	0.2589226770514805	419	1758627	10
8713	307.3298213898958	113.2168831168836	0.19072536507038154	198	1758825	14
8714	305.82223065899007	156.57074829932014	0.34869086388314124	202	1759027	1
8715	305.43487054321287	267.0862190812712	0.3706332970396312	261	1759288	3
8716	307.9865218377807	560.599999999995	0.3779329100941277	393	1759681	2
8717	307.18011116485746	227.34545454545548	1.0760859528150946	271	1759952	13
8718	305.8828372498616	177.45271966527267	0.20646635524889562	191	1760143	9
8719	306.8917885383799	406.77796610169224	0.24704137497399686	338	1760481	7
8720	306.9387681794978	311.5897526501745	0.4495523265331467	346	1760827	5
8721	306.39326574360445	252.38852459016456	0.22310425853001253	262	1761089	6
8722	306.25379254562785	292.44594594594514	0.4533231493452905	284	1761373	11
8723	306.1620028719198	297.0748251748242	0.25488597324916296	280	1761653	4
8724	309.8378634085716	673.748056537097	0.4726531008456616	470	1762123	8
8725	308.112432142907	137.29473684210572	0.27616227312785824	205	1762328	3
8726	307.570979463269	253.96716417910457	0.22262955885667068	325	1762653	10
8727	307.86097730983226	336.5707641195995	0.35289044246495327	321	1762974	14
8728	306.36730911749	158.4941580756019	0.48651149616905703	201	1763175	13
8729	304.7940253392922	149.03893129771055	0.4854800041685713	188	1763363	11
8730	304.411810161428	266.57250755286924	0.25293923721832484	294	1763657	2
8731	302.89562754368467	152.79354838709725	0.3855656726819249	213	1763870	5
8732	304.04663946612766	417.99681978798424	0.30944159435249907	342	1764212	1
8733	307.7165602768535	671.0387205387126	0.324441237970885	494	1764706	12
8734	307.72209226858666	308.26975945017034	0.30566545943139306	284	1764990	7
8735	306.7055029248482	206.06315789473734	0.8187288782903268	241	1765231	4
8736	306.3472750560935	270.88271604938245	0.2281467813841054	284	1765515	6
8737	305.87858212204634	259.47798165137635	0.7003425598144531	340	1765855	9
8738	306.67246296749255	385.266666666665	0.36644601060178716	313	1766168	8
8739	304.9775892694947	137.18509316770252	0.5415139944067499	211	1766379	10
8740	305.07652968885645	314.8716312056729	0.113659694277007	290	1766669	3
8741	306.1327807854105	410.70163934425995	0.4749276359536369	351	1767020	14
8742	305.1425653694872	207.11123919308486	0.2752756597250188	291	1767311	11
8743	305.324708620386	323.3568904593628	0.3991796180954745	299	1767610	2
8744	304.8861983762874	261.47368421052516	0.5380788276699708	279	1767889	7
8745	305.2298344469992	339.2498054474691	0.34960612684193226	303	1768192	12
8746	307.404221034036	522.6684931506813	0.535776990525266	423	1768615	13
8747	307.5215286586792	319.1349834983485	0.5024113374597886	306	1768921	6
8748	306.6474648872439	220.1151515151527	0.5385072848286492	313	1769234	4
8749	306.6430033102669	306.20130718954124	0.2780270214521452	303	1769537	9
8750	310.4123279941453	683.5754716981078	0.40864603972632035	484	1770021	1
8751	312.67323019191076	536.5025477706932	0.23304452937402767	462	1770483	5
8752	312.95671410620787	341.02162162162034	0.3525811867635758	305	1770788	3
8753	314.4869090469301	465.97620817843483	0.2603724805614616	395	1771183	10
8754	314.1447857191727	280.27457627118525	0.1822124494776607	281	1771464	11
8755	313.05565735079887	205.23194888179012	0.2867761835878195	247	1771711	7
8756	313.9611007772909	403.59999999999746	0.23473171553006483	323	1772034	14
8757	313.8212030562313	299.97132867132757	0.32660987160422583	286	1772320	2
8758	313.46420155198473	278.12105263157764	0.5485322587326545	277	1772597	13
8759	311.73751771136983	140.79581749049495	0.18896447851302775	188	1772785	1
8760	311.6227576946059	300.2615160349847	0.26029675006866454	320	1773105	12
8761	312.0053592991545	349.88291814946473	0.41277419746696176	308	1773413	4
8762	311.3976655881689	251.23598820059067	0.6561259233415333	289	1773702	6
8763	315.3395590621572	705.5870129870041	0.5990281562738602	573	1774275	8
8764	315.18205026398846	299.5886792452814	0.4672702476626537	305	1774580	9
8765	314.40766624343325	237.7436482084702	0.2494748042179988	260	1774840	3
8766	312.15301134970645	88.94217687074864	0.15490248145126714	164	1775004	7
8767	310.13579083373264	110.43095975232251	0.3348606207431891	195	1775199	14
8768	308.1905682389267	115.61353135313593	0.20056150397475886	196	1775395	2
8769	306.04253278554506	93.38702290076381	0.3591435011043105	172	1775567	1
8770	306.9985081545537	401.6400696864085	0.5475318502392289	338	1775905	5
8771	306.96357451995345	303.5051446945321	0.27492671817928166	308	1776213	10
8772	305.06245650525034	116.85177304964596	0.1728794440794527	178	1776391	4
8773	303.0719666919709	106.01347517730552	0.13238052792019314	180	1776571	3
8774	302.6934234956394	265.2176470588231	0.3199731508890788	288	1776859	13
8775	301.7769103133146	211.04210526315842	0.4124399623054475	257	1777116	8
8776	304.3309209935749	557.1779783393458	0.38701182774135046	420	1777536	11
8777	304.68067939929756	339.30676156583473	0.5341192984813976	307	1777843	6
8778	305.6877673421467	405.3894736842073	0.3300191863062699	353	1778196	12
8779	304.7260960179316	209.52063492063547	1.6755973001713809	253	1778449	2
8780	305.1901864091036	351.13513513513357	0.18066235207526732	339	1778788	9
8781	305.92699588521873	378.8711340206165	0.42636560679909713	334	1779122	1
8782	306.0192032782829	315.147735191636	0.18661525996044429	297	1779419	10
8783	308.33946285840324	538.0451612903206	0.49858236873851103	425	1779844	7
8784	308.63813851735915	338.2070287539923	0.2211573219889827	323	1780167	5
8785	309.92416889689144	437.241176470585	0.3684339852168642	406	1780573	14
8786	307.86489162073394	103.99644128113924	0.3394111543012089	169	1780742	12
8787	307.7192547527194	293.30120481927634	0.34612168936893856	319	1781061	4
8788	307.7132679929735	307.12057877813334	0.4145592137386924	304	1781365	3
8789	306.9180640964266	228.19287833827994	0.6003320403258596	269	1781634	11
8790	305.963504370495	211.46209150326902	0.26514050519024884	270	1781904	6
8791	306.93830827068444	403.4438943894371	0.22607432650980977	354	1782258	13
8792	309.21299739014364	534.4072202166024	0.4144951929019976	395	1782653	8
8793	307.0868392472281	96.5971830985921	0.09604632059733073	195	1782848	4
8794	308.0577259567966	404.1755102040799	0.263913671521173	345	1783193	9
8795	308.23906267572323	326.1913978494586	0.19672079304702408	393	1783586	2
8796	308.6611216613691	350.4449612403091	0.3631284798371507	293	1783879	5
8797	308.2408913971364	266.63809523809414	0.6266330652069627	285	1784164	7
8798	306.3798313203743	122.13488372093069	0.30650827926018337	173	1784337	6
8799	306.86408687922443	354.80538720538516	0.5143599849736359	323	1784660	10
8800	305.0149196946427	121.94736842105304	0.4133034538976925	194	1784854	11
8801	305.51336915990356	354.85986622073426	0.31755334102746213	330	1785184	1
8802	304.5331043207635	207.48688524590253	0.1739924748738607	252	1785436	3
8803	305.90011623784466	441.23429602887745	0.24054956436157227	352	1785788	14
8804	307.2743491180194	443.3234042553169	0.2481397677413465	353	1786141	12
8805	306.9331391957438	273.1533568904585	0.270310461741092	271	1786412	13
8806	304.65269015672754	78.88823529411806	0.1377086869205337	166	1786578	2
8807	304.81656461570446	321.04013605442054	0.2677775605084145	292	1786870	8
8808	302.6620050301535	89.36060606060644	0.4404212308217244	166	1787036	12
8809	301.5092164405262	187.3831460674167	0.23853338681734526	260	1787296	11
8810	301.3828376519171	288.87133757961647	0.1646093594825874	295	1787591	6
8811	301.8765330849217	350.7523809523792	0.3335873676692925	301	1787892	10
8812	301.0930395987327	223.52718446602034	0.2990209526485867	288	1788180	1
8813	301.6771931188293	359.5083916083903	0.3062335968017578	320	1788500	5
8814	301.5076728883212	284.725170068026	0.22977374202416037	281	1788781	3
8815	304.8829597958016	639.036363636357	0.3459464083896594	445	1789226	4
8816	305.57384153804975	373.97113402061535	0.5424423815376143	383	1789609	7
8817	305.7565148873751	323.8411764705871	0.45510469633957434	290	1789899	13
8818	307.8656176085374	516.6667870036049	0.5643616079170013	428	1790327	9
8819	306.1555888834324	136.86274509803985	0.21222316799451357	199	1790526	8
8820	307.35472264977045	426.06896551723764	0.30776554628335	359	1790885	14
8821	307.27520572630306	299.40303030302863	0.19654226922369622	308	1791193	2
8822	305.3688050203914	116.6351351351355	0.14767074584960938	184	1791377	11
8823	303.8806087734662	156.54918032786952	0.39994269726323145	204	1791581	4
8824	303.6312509615936	278.9448275862056	0.47448008966902955	313	1791894	6
8825	304.26944569835445	367.4507246376794	0.2550957956621724	310	1792204	5
8826	303.828463570138	260.1712328767113	0.4056760690508098	274	1792478	7
8827	303.0748955468145	228.47166123778612	0.3020021027209712	255	1792733	9
8828	303.1364282814872	309.2281690140836	0.2276290202390026	287	1793020	8
8829	304.8730494001322	476.7985401459833	0.2687027625126927	377	1793397	3
8830	304.71141386162043	288.70949554896094	0.6597156930477062	376	1793773	10
8831	308.3098577754386	664.5558052434402	0.3497266299155572	507	1794280	12
8832	309.60400107494047	437.72418772562827	0.22001317559484063	351	1794631	14
8833	308.9784520821552	247.04910179640856	0.2628254165919004	283	1794914	2
8834	309.36361387005843	347.49463087248165	0.19195654422421998	316	1795230	11
8835	310.1674562589652	389.7478527607333	0.18789383859345407	396	1795626	13
8836	308.4817193910796	141.59376947040568	0.5415744499619959	203	1795829	5
8837	310.80913707261357	541.2234875444764	0.47973526178699566	601	1796430	1
8838	311.01449668227957	331.34509803921424	0.47874011932470545	313	1796743	9
8839	309.36948128356306	146.51295681063183	0.3858154296875	195	1796938	13
8840	312.1740591980001	589.8272727272669	0.5276260732490325	428	1797366	4
8841	312.59520749490895	354.288888888887	0.6953568610592165	345	1797711	7
8842	312.6526711502969	318.34157303370716	0.5138221521601665	383	1798094	6
8843	314.21731237772525	469.116793893128	0.593894473390083	346	1798440	3
8844	314.11222586812124	303.7086614173222	0.3376336079990997	269	1798709	2
8845	316.3596856989922	538.8582089552186	0.5258007920938095	394	1799103	8
8846	316.981755508669	378.56666666666473	0.24271509270918998	380	1799483	10
8847	316.192374435667	238.04364820847024	0.43433267318784957	257	1799740	5
8848	316.78417011577073	375.37194244603995	0.23649663318788386	346	1800086	14
8849	319.67080989609445	605.4481481481424	0.4350494957865684	426	1800512	12
8850	320.49537270014355	402.1270903010013	0.46552504005538387	359	1800871	11
8851	318.4485439731421	115.81250000000045	0.2859956414036497	169	1801040	6
8852	318.170979063212	290.6920529801309	0.40121477528622274	304	1801344	1
8853	316.7099554650485	172.06861924686268	0.7258353397764009	203	1801547	2
8854	314.64902954383854	110.61736334405182	0.4570022242029286	179	1801726	10
8855	314.6593224199211	315.67831715210184	0.46377773597592215	305	1802031	9
8856	315.04825009604343	353.55209003215197	0.5485519977830211	322	1802353	13
8857	314.7965570687672	289.8789473684195	0.28317011672606585	291	1802644	8
8858	315.33319694025636	368.46054421768537	0.22833226366740902	328	1802972	7
8859	314.85005416004293	267.01891891891836	0.6286377408611241	268	1803240	14
8860	316.68891464080673	498.73610223641856	0.35249714723758746	411	1803651	4
8861	318.9294771073018	540.7451612903185	0.27981408277348657	398	1804049	3
8862	318.71743711329884	297.72547770700476	0.4402010582930205	302	1804351	12
8863	318.431285908189	290.1023166023155	0.24841262354995264	264	1804615	6
8864	319.27594740808144	402.8974358974336	0.15341461320778518	329	1804944	11
8865	321.5269621275489	544.3774193548359	0.2558881845047225	402	1805346	5
8866	321.2365394813624	292.4846975088959	0.27852137596598603	277	1805623	2
8867	321.40655387748956	338.2379790940748	0.2931305669969128	310	1805933	1
8868	321.0408014700278	284.83131313131236	0.3003601723528923	282	1806215	10
8869	321.2426917009415	341.2298245614009	0.38595638399809795	306	1806521	9
8870	321.4041764447095	337.3911660777373	0.22605135599772136	300	1806821	13
8871	320.925668249167	273.5533568904585	0.20138286919183052	267	1807088	8
8872	318.91858785846864	120.21762917933191	0.23060249915489783	195	1807283	3
8873	318.1088384619687	237.94364820847022	0.3054729136385659	258	1807541	7
8874	315.93930563290456	101.15555555555602	0.13799651463826498	168	1807709	5
8875	315.9468216674846	316.6909090909064	0.27308961850570823	323	1808032	14
8876	314.0869520902655	129.9598639455787	0.26732925492890025	196	1808228	1
8877	313.6056786605681	265.95960912052084	0.11898097076979071	271	1808499	12
8878	314.3295740923924	385.99522184300037	0.29447617799662695	337	1808836	4
8879	315.325264116593	413.89857651245313	0.36479843494504	344	1809180	6
8880	313.7965728137171	162.45613382899688	0.23802940212950416	196	1809376	7
8881	313.46704436156557	280.8437275985653	0.5164766416444884	273	1809649	9
8882	313.158283008859	282.59090909090776	0.2786469893022017	264	1809913	8
8883	313.11007601769654	308.33758389261624	0.5163218590521044	372	1810285	2
8884	310.9560907690707	97.71155115511598	0.2298792176327463	177	1810462	1
8885	310.81552986138	296.899999999999	0.2964348384312221	280	1810742	3
8886	314.50810183549345	680.0727272727199	0.3568255187599522	471	1811213	11
8887	314.21995185162126	285.6931034482744	0.16706301825387138	280	1811493	5
8888	314.66641367495805	358.86613418530135	0.26849730296801494	372	1811865	10
8889	315.9889382174537	446.9188679245244	0.33469039069281686	360	1812225	13
8890	313.96635004009846	113.73012048192825	0.1488371150378875	187	1812412	4
8891	314.5758369156373	374.91503759398245	0.2988078209661668	310	1812722	12
8892	315.7487326818192	431.8654135338309	0.22445892869380482	342	1813064	14
8893	316.8619107825103	427.0665427509268	0.17670299597745817	338	1813402	6
8894	314.3581062442216	66.48145695364265	0.6111531198760609	162	1813564	10
8895	315.42033470558886	420.58095238095063	0.127393487876146	317	1813881	9
8896	314.9792424696441	271.3111111111107	0.36865871092852426	272	1814153	8
8897	312.6712393426065	84.17892976588668	0.21856416132032258	194	1814347	4
8898	311.879349379087	233.4822429906554	0.22498020158543705	281	1814628	1
8899	312.8051813269922	404.4625441696098	0.18436143511817568	336	1814964	2
8900	313.27921342980625	360.2083916083903	0.4626445831201328	313	1815277	3
8901	314.412408050475	426.5986754966851	0.43654641337778377	435	1815712	7
8902	316.49939681043713	523.1112840466895	0.2269447923027923	371	1816083	13
8903	314.60009155828607	126.56887159533119	0.13360546090010272	173	1816256	9
8904	312.700311616486	124.62209737827763	0.22281310775063254	176	1816432	4
8905	310.88865886528464	131.53503649635087	0.16921461953057182	180	1816612	8
8906	313.39739727663175	561.7624999999958	0.21985005491626652	397	1817009	5
8907	314.8180582245003	455.46349206348924	0.5650986762895976	365	1817374	12
8908	317.745655420033	607.577777777772	0.7439103560014204	451	1817825	11
8909	316.0384396685083	147.0240802675593	0.09890043913428463	201	1818026	1
8910	317.16843988720785	429.0384615384597	0.7663913773901668	324	1818350	6
8911	314.9118295624099	91.50740740740783	0.21675117106377323	158	1818508	9
8912	315.71182068927817	394.91094224923813	0.3343101251320761	366	1818874	10
8913	315.6182907176795	306.35882352941104	0.6329712239872942	281	1819155	3
8914	313.2003883860423	73.82805755395714	0.6341533660888672	160	1819315	1
8915	313.2009299567273	313.2545454545436	0.500104815046364	321	1819636	2
8916	312.50597003987605	243.70493827160632	0.34021514782802664	278	1819914	7
8917	312.77054047646357	338.96301369862846	0.5176436684348367	308	1820222	13
8918	312.2461222004118	260.32871287128626	0.340077689524447	267	1820489	5
8919	318.2358443694111	911.2183391003416	0.4427127525454662	610	1821099	14
8920	316.458485925717	140.50000000000057	0.48433583053116946	194	1821293	3
8921	317.8487869725001	455.4885906040245	0.22922250762858504	377	1821670	8
8922	317.4948009615111	282.450185873605	0.16260845477764424	260	1821930	9
8923	315.7027883131127	138.29353612167358	0.2731738717215402	175	1822105	2
8924	317.2132087058436	466.7448275862029	0.46193686298940373	435	1822540	4
8925	317.39219802453596	335.11214057507857	0.5366303343210161	322	1822862	6
8926	315.474847472862	125.65714285714344	0.216674492373104	171	1823033	14
8927	315.61194917234934	329.18501742160106	0.44406004209776184	296	1823329	10
8928	315.2183702211664	276.25405405405326	0.12496820167513961	277	1823606	7
8929	320.27412579020967	820.7939271254952	0.6972710338991079	536	1824142	11
8930	318.6084956434187	153.71111111111188	0.21796783293136443	198	1824340	8
8931	320.52308560958505	510.06749226005707	0.5011398000520345	533	1824873	12
8932	320.7658547534892	344.7999999999983	0.2117313752538738	301	1825174	13
8933	321.30849972033127	375.0303514376978	0.7645267890895018	434	1825608	1
8934	324.96708138979454	687.166666666661	0.34027281695163336	419	1826027	5
8935	324.4090772425633	269.166666666666	0.38940571694478504	274	1826301	4
8936	323.66553424083827	250.05477707006483	0.4489349669396283	301	1826602	2
8937	322.9116266187947	248.2747720364758	0.3704479428839058	343	1826945	3
8938	323.74551035260674	406.2999999999967	0.5370026997157505	336	1827281	6
8939	321.8170315336656	130.89762845849853	0.23789270718892416	192	1827473	13
8940	321.4326632661105	283.380204778156	0.36440890829501554	271	1827744	11
8941	322.71230236553663	449.3965732087198	0.30088355324485083	396	1828140	9
8942	323.1436858353877	365.85064935064815	0.5407361241871725	334	1828474	10
8943	323.3245267548116	341.2277777777766	0.19797699025135165	302	1828776	7
8944	322.8003144542964	270.90329670329555	0.2629140712871626	257	1829033	12
8945	323.02476272041173	345.2451410658283	0.4615061469476499	371	1829404	14
8946	321.1499166376092	135.54015444015508	0.1381225383028071	188	1829592	1
8947	322.23776712158275	429.93496503496334	0.34447195870535713	350	1829942	8
8948	320.4563204848497	144.09310344827657	0.1884317398071289	196	1830138	6
8949	320.2151209163648	296.336363636362	0.16991109006545124	272	1830410	5
8950	318.5609577550099	154.7988047808771	0.1439947614482805	204	1830614	11
8951	318.68645928857086	331.11111111111	0.3189944008919706	299	1830913	4
8952	316.98832401899347	148.8729323308278	0.4014547366907101	202	1831115	7
8953	314.67017762090876	85.17368421052666	0.11101531982421875	167	1831282	14
8954	315.3032199524437	377.97441077440834	0.29568675096611	327	1831609	2
8955	315.4554592760981	330.5271523178794	0.6650414797339109	303	1831912	13
8956	314.7916449430774	249.0740259740273	0.27123064069605585	268	1832180	10
8957	315.40500874842365	376.12802547770355	0.2406574756423862	346	1832526	3
8958	314.6363638654004	238.54052044609753	0.2811718364006917	253	1832779	1
8959	316.3221328432338	483.21326164874205	0.5253015874506353	364	1833143	9
8960	317.1638290775255	400.491756272399	0.48122302282973	331	1833474	12
8961	316.00412943705703	201.19386503067537	0.8751445132006931	257	1833731	6
8962	314.8928227705182	204.87346278317227	0.3983313960413779	248	1833979	4
8963	315.16428890901017	342.0394366197172	0.5231586223246584	311	1834290	11
8964	316.4807271010011	446.80810810810567	0.4184909630875561	362	1834652	8
8965	317.4453686748755	412.9448844884469	0.3421695432183463	358	1835010	5
8966	317.1941061144066	292.3191126279851	0.2543364511409276	284	1835294	13
8967	318.22561959871706	420.34545454545304	0.5552497035946664	341	1835635	7
8968	317.5111261145943	246.7762711864415	0.24050374495854016	277	1835912	3
8969	318.67100143062953	433.49865771811864	0.3720732630945701	362	1836274	14
8970	317.73296029049544	224.86688741721943	0.23321980794270833	300	1836574	10
8971	317.75227452320695	319.66438356164275	0.8293497274210165	364	1836938	2
8972	316.85691595707937	228.21641791044854	1.405514032068387	284	1837222	12
8973	316.3320967975086	264.3749999999984	0.17897069012677227	324	1837546	9
8974	318.1121091628668	494.33333333332814	0.21990586307790408	389	1837935	1
8975	316.09950580173455	116.85177304964597	0.24590490105446805	178	1838113	3
8976	314.1378210885448	119.93103448275915	0.18202522746677505	179	1838292	14
8977	312.47329077409944	147.68478964401362	0.13940807435570693	205	1838497	7
8978	312.80862659488076	346.006872852232	0.22160071489579253	319	1838816	8
8979	313.4085231468014	372.7982817869397	0.30073931173312884	326	1839142	11
8980	314.1049863024301	383.0548387096753	0.16705236909139223	362	1839504	4
8981	312.4586239394058	149.46875000000054	0.21988016626109247	184	1839688	12
8982	314.730546174588	539.6508474576225	0.38785470165226255	433	1840121	6
8983	314.22293970949767	263.9698996655515	0.5551446964306459	269	1840390	2
8984	314.49204160074623	341.133128834354	0.30552486072887075	330	1840720	13
8985	315.51157573019333	416.4454545454524	0.4946841992829975	380	1841100	5
8986	313.896590407674	154.01304347826135	0.3607390817969736	198	1841298	14
8987	316.33975461512136	558.2130111524122	0.3633580753459266	402	1841700	10
8988	316.68662691023997	351.02698412698237	0.19200097286339962	330	1842030	9
8989	317.5200384189153	400.02777777777595	0.19052700166505346	339	1842369	1
8990	317.44861581250393	310.3777777777768	0.13249860673942823	298	1842667	7
8991	316.28512659627495	201.09969418960355	0.37015840446806525	251	1842918	12
8992	317.85352625282144	473.1250922509202	0.252462641398112	360	1843278	3
8993	318.1113802520382	343.638926174495	0.24262658235068632	321	1843599	11
8994	316.6111553384067	168.0888888888895	0.48587507902136173	207	1843806	5
8995	316.72113333726145	327.60895522387796	0.21467440245581454	305	1844111	13
8996	315.1276997816666	157.37777777777842	0.08120685257935172	203	1844314	1
8997	317.8380006385212	586.1577854671253	0.49864024896731324	435	1844749	8
8998	317.9247904434567	326.5169811320737	0.1759347338693422	281	1845030	10
8999	318.8710162232326	412.5473684210489	0.5230448725148494	413	1845443	6
9000	319.3255814233191	364.3275362318825	0.372442376809042	305	1845748	14
9001	323.0801860742022	694.7860465116256	1.0059123010229145	493	1846241	2
9002	322.86363421346016	301.4249999999988	0.7395170398224565	266	1846507	11
9003	322.0286705439982	239.3672672672687	0.43748748559745954	278	1846785	3
9004	322.256161616336	344.77777777777607	0.2220024178455666	329	1847114	7
9005	323.59169688598575	455.809688581313	0.7398115221822783	389	1847503	9
9006	324.2906132504592	393.48333333333153	0.1995587932529734	335	1847838	12
9007	323.8702089766907	282.250185873605	0.2128003389780758	262	1848100	13
9008	322.84672310314005	221.52162162162256	0.553677001953125	250	1848350	1
9009	325.3549372880378	573.6681415929149	0.3849239890883774	634	1848984	4
9010	325.11786332499344	301.64754098360544	0.1750515788590827	294	1849278	6
9011	323.271991881286	140.53071895424898	0.2687217516776843	195	1849473	3
9012	325.11381741701854	507.45454545454083	0.16309106066862322	379	1849852	8
9013	326.812345909515	494.96666666666437	0.41412733348142433	466	1850318	5
9014	324.55243297673564	100.82105263157932	0.3686862618582589	175	1850493	1
9015	325.36047069076386	405.35620437956067	0.307069584773137	325	1850818	11
9016	327.4715542955445	536.4688311688273	0.2730287457795421	446	1851264	10
9017	325.7017521384158	150.4913385826777	0.19250820792295079	187	1851451	6
9018	325.223708976006	277.89743589743483	0.997239967972312	329	1851780	9
9019	322.5611354376478	58.9663551401868	0.49520125662445263	157	1851937	3
9020	323.12211730361025	378.65932203389605	0.4535607524301814	348	1852285	7
9021	326.44903393976136	655.8137809187217	0.24514889153908556	508	1852793	14
9022	326.9053912824829	372.08476821191846	0.26724564859330485	351	1853144	12
9023	327.84606150758907	420.97241379309986	0.4362119971132698	341	1853485	13
9024	327.67367734511254	310.6076452599378	0.24826457665401436	318	1853803	4
9025	329.61371975147205	521.6779179810649	0.6159146316652375	492	1854295	2
9026	330.5902479814666	427.2665427509267	0.5362649645124163	336	1854631	8
9027	328.25020264450905	96.58571428571476	0.0911689129742709	176	1854807	3
9028	326.4940239263346	152.6323308270684	0.10877082371475673	202	1855009	9
9029	327.3267616531729	409.7677966101668	0.4181467245893869	342	1855351	5
9030	325.13885234283015	108.53583061889304	0.05667714968971584	184	1855535	13
9031	325.14234280029353	325.4878980891699	0.42825984648186294	311	1855846	1
9032	324.52788157160325	263.6962199312702	0.229938736231504	283	1856129	10
9033	324.2265043952314	294.39016393442535	0.25391656615805386	301	1856430	6
9034	324.0086077723317	302.4368421052615	0.3177405463324653	297	1856727	12
9035	325.3121622174841	454.3640522875788	0.7070057404346956	390	1857117	14
9036	325.9066120238807	384.7571428571405	0.46794905229048295	330	1857447	2
9037	326.43327606237204	378.57301587301407	0.3409554676343036	372	1857819	4
9038	326.2132766350816	304.43333333333254	0.3605967362721761	288	1858107	5
9039	325.4318698961281	248.0726027397265	0.3325876043748486	258	1858365	10
9040	324.8025739984697	262.50228013029283	0.21104063655867245	273	1858638	1
9041	324.53423118531424	297.9682926829264	0.38949245061629856	312	1858950	9
9042	324.97349671659833	368.4607843137237	0.21134318277507486	334	1859284	8
9043	325.452040230445	372.82784810126367	0.3815591612213394	353	1859637	3
9044	330.04627071782016	784.8750889679633	0.522132332094254	620	1860257	11
9045	331.3768080106419	463.0999999999975	0.2734139276587445	368	1860625	13
9046	335.4816226643484	741.8582733812848	1.2974436813810735	602	1861227	7
9047	332.8386392550423	71.1832817337466	0.12456737209010768	185	1861412	2
9048	330.9078454550845	139.7592592592599	0.2548428958224267	194	1861606	1
9049	328.962603299466	136.3836298932391	0.16135727232368433	201	1861807	9
9050	332.2331647664713	656.018749999995	0.292655272162984	431	1862238	12
9051	335.1194997854732	620.8666666666613	0.35719506328424167	457	1862695	6
9052	333.7039901458739	193.5685358255461	0.4357664077008357	244	1862939	11
9053	334.43554465000955	406.8594405594391	0.5727133069719587	336	1863275	5
9054	333.4033452728736	231.21560693641743	0.1968579954571194	288	1863563	3
9055	331.08712300895604	101.78111888111928	0.20011690925149356	170	1863733	6
9056	331.1893426879574	341.3090909090887	0.2269767631918697	295	1864028	2
9057	333.8523269589195	597.4877697841664	0.4007355379555767	427	1864455	10
9058	331.90364152716813	138.98378378378425	0.19126758478619726	197	1864652	9
9059	332.810197704489	422.5592592592553	0.19493167647898524	366	1865018	13
9060	336.1832950157003	670.1199288256165	0.5977634123001976	522	1865540	4
9061	336.6140836871649	379.2621621621605	0.32970153994676543	328	1865868	7
9062	339.7222137666279	647.4270916334614	0.30482436165507043	457	1866325	8
9063	344.7809993808995	845.6007751937949	0.5911193209658101	574	1866899	14
9064	343.9395082276702	260.63188405797	0.4033136106004902	255	1867154	12
9065	341.7373341191763	123.72209737827768	0.1793895824535473	185	1867339	2
9066	343.3989106107604	507.89498327758895	0.27055907072844326	405	1867744	1
9067	341.60092150465283	163.60000000000065	0.08171619922656731	203	1867947	9
9068	339.16270298728074	97.77906976744231	0.07789615962816321	184	1868131	14
9069	338.56449116208626	279.34152046783544	0.467559564309042	305	1868436	5
9070	336.51736280675675	133.85165562914014	0.19474053804107774	283	1868719	10
9071	336.57840139733867	342.6212218649485	0.27555764013804923	367	1869086	3
9072	336.5745854344835	336.19680511181946	0.6574976965601965	407	1869493	11
9073	336.1637412194829	295.49016393442525	0.19336511020002695	290	1869783	12
9074	335.7189436864421	291.68398791540545	0.2222065580063972	345	1870128	6
9075	335.4303256781491	306.8571428571403	0.21123897796885882	359	1870487	13
9076	336.10746136526194	403.14389438943704	0.2776792082799917	357	1870844	4
9077	334.19497309699085	144.8586345381534	0.20099852895978743	197	1871041	9
9078	335.83298227013046	497.99589041095527	0.6610139358875363	430	1871471	8
9079	335.0672981167205	259.2645669291335	0.23025742210293212	241	1871712	14
9080	335.33665961831184	362.0034482758594	0.17898772455030873	310	1872022	2
9081	335.1692085150865	318.59154929577363	0.31812962560749375	299	1872321	5
9082	336.24618309660224	442.86666666666446	0.22199293526496677	362	1872683	1
9083	334.55719312710806	167.34718614718685	0.14864563559465868	187	1872870	9
9084	335.90740927530715	469.5788079470155	0.6608756662529206	535	1873405	7
9085	336.2508258192582	370.24906367041	0.30155814321417557	304	1873709	10
9086	335.742012925304	285.36953642384	0.18587883231566124	291	1874000	11
9087	336.0299612171035	364.5368421052608	0.39477323614481674	301	1874301	6
9088	334.88385208112294	221.41904761904817	0.6161619456791786	261	1874562	4
9089	335.9192816015488	438.42680412370896	0.2589537249225862	357	1874919	3
9090	335.31550802951955	275.541924398624	0.22088772097960213	302	1875221	14
9091	336.5473529492243	458.49999999999704	0.27885512568524495	414	1875635	12
9092	337.8323019549433	465.04225352112337	0.4384975387828162	419	1876054	13
9093	335.1609048613198	70.69259259259326	0.06375671089242357	218	1876272	7
9094	333.8285891881009	201.92933753943305	0.2712225135104115	251	1876523	1
9095	331.9475440988955	145.72408026755934	0.21883108905542678	214	1876737	11
9096	333.8006354449101	517.2566787003568	0.33813144505950454	386	1877123	8
9097	332.88120051903246	241.8571428571441	0.6644490363515022	259	1877382	4
9098	332.3771827376688	282.47942238267046	0.8499973842075893	315	1877697	10
9099	332.37327072337627	331.9859813084098	0.26122672469527636	324	1878021	9
9100	333.01778801614245	396.82499999999794	0.44734345529936	437	1878458	2
9101	330.85599359462765	116.83834586466223	0.2463970184326172	184	1878642	12
9102	328.4083847076324	86.0951048951054	0.11480249823095964	187	1878829	14
9103	328.98539513665037	386.1094276094254	0.3077388708142267	414	1879243	5
9104	326.5462078519505	85.06666666666723	0.045981773577238386	190	1879433	1
9105	326.2920791067643	301.13333333333253	0.24673103023540938	321	1879754	3
9106	328.1787138712521	514.9555555555506	0.4467327353395062	405	1880159	6
9107	327.6079267325396	271.0999999999989	0.32927775382995605	288	1880447	7
9108	325.7794766042871	144.7629139072854	0.22990170538713392	207	1880654	4
9109	324.36586216611306	184.418032786886	0.3894929698869294	204	1880858	9
9110	324.8122035444519	368.99999999999847	0.2652507893090109	309	1881167	11
9111	324.7075950225209	314.3513513513507	0.8078179088065295	369	1881536	8
9112	323.9597963000184	249.92772277227786	0.244231616749483	272	1881808	2
9113	322.8214359607806	210.12376237623843	0.5192634415452497	274	1882082	12
9114	322.70058214539046	310.73605442176745	0.3877104931723949	293	1882375	14
9115	323.1698837673022	369.63074433656715	0.280181797071435	348	1882723	10
9116	322.7819601234276	284.3775193798442	0.429456502199173	256	1882979	1
9117	320.99177015182295	143.76296296296354	0.16017226773406823	191	1883170	9
9118	321.21855691765865	343.67044673539357	0.3077615514978186	308	1883478	5
9119	323.0934334602832	508.706211180119	0.5467474584085533	502	1883980	13
9120	323.03888688078246	317.6387755102029	0.30811558031056024	292	1884272	3
9121	323.9609794934561	415.24814814814505	0.3112395681985995	328	1884600	6
9122	321.63850638916904	91.71366906474854	0.18452720168214407	161	1884761	14
9123	322.0906159489332	366.84946236558943	0.2688416416205249	309	1885070	7
9124	322.5518019880254	368.2092198581545	0.46948505919656636	324	1885394	4
9125	320.86973851359966	154.34545454545508	0.13597221754083585	201	1885595	8
9126	319.1287077951303	146.76666666666725	0.226348279702543	198	1885793	3
9127	319.1799896217726	324.2568904593628	0.30889763667665676	290	1886083	2
9128	318.73250551502855	274.43157894736714	0.24634383666557774	281	1886364	1
9129	318.24185293374586	269.6672473867587	0.35307884216308594	264	1886628	9
9130	317.9944464526012	293.5012048192762	0.2657528465102524	317	1886945	12
9131	318.06914582369166	325.4643835616422	0.12702409582200394	306	1887251	10
9132	316.0913957573961	120.29413919413977	0.2357832928921314	188	1887439	14
9133	316.00348516682556	307.30033670033544	0.28274793917815433	293	1887732	5
9134	314.1998705486203	135.6420233463041	0.11527904913054039	199	1887931	4
9135	314.9506985579355	389.2826714801416	0.23098766442501184	330	1888261	13
9136	318.7920883695091	699.0896797152965	0.24177411077562108	517	1888778	11
9137	318.567722256132	296.35547703179935	0.4462747440284708	357	1889135	6
9138	319.19639591076367	381.43508771929487	0.26415478046123797	325	1889460	7
9139	321.0472573484814	504.28253968253716	0.3746344374529701	353	1889813	8
9140	321.4083266076659	357.15418326692975	0.2745789828365796	292	1890105	2
9141	321.54287837808556	334.863503649634	0.48891225179036457	300	1890405	1
9142	321.18532591939305	285.7876325088329	0.6285289951137729	286	1890691	4
9143	321.27443058900167	330.0957928802573	0.7989973901023327	355	1891046	9
9144	320.61620867117136	255.45223880596984	0.8207868688246783	340	1891386	10
9145	322.67360378003156	526.3557195571915	0.47294355119977677	455	1891841	3
9146	322.20879731969603	276.19295774647804	0.45796141332509566	392	1892233	12
9147	323.5451629547465	455.8453608247393	0.1625508992408419	389	1892622	14
9148	324.4532902725674	414.35789473683866	0.32011845625566515	362	1892984	13
9149	326.0455745741428	483.6817204301044	0.3647939943105605	431	1893415	5
9150	324.24978549506807	146.46666666666732	0.350832811042444	201	1893616	1
9151	324.0929804505749	308.56928104575053	0.1964562733968099	312	1893928	6
9152	324.71633890229685	386.4288256227739	0.31503327877935533	334	1894262	8
9153	322.67058057656504	120.14050632911439	0.17014497455797697	190	1894452	4
9154	322.9515844482187	350.77096774193404	0.28804959383877843	330	1894782	7
9155	324.46617971484756	474.411111111107	0.4246279190146858	366	1895148	2
9156	323.7502956954769	252.8777777777779	0.5543065224924395	248	1895396	10
9157	322.34926270318647	183.6469964664316	0.45548813298063456	212	1895608	14
9158	320.49119030961765	136.542023346304	0.15007741827713816	190	1895798	1
9159	318.5522931666691	126.60147601476089	0.2232661817632794	209	1896007	5
9160	324.1387096289417	877.1939393939277	0.34795375952974034	621	1896628	11
9161	322.3701704290924	147.28478964401364	0.2858586836089358	209	1896837	8
9162	322.3177295943667	317.1260869565208	0.24419398089639502	306	1897143	12
9163	322.8822189650897	378.76666666666404	0.47527745161106977	378	1897521	9
9164	321.39715966203676	174.37628865979434	0.16286213598518728	214	1897735	7
9165	322.76824301047134	458.50549450549204	0.3570448681504613	359	1898094	6
9166	324.07824335982275	453.7682779456138	0.25310375140263486	416	1898510	13
9167	323.4536539086807	261.6192982456128	0.6800604013296274	260	1898770	10
9168	321.50168927594837	128.25719063545216	0.25867620427557764	188	1898958	11
9169	321.45004937999397	316.3376996805104	0.7316844831194197	350	1899308	4
9170	319.63723327157606	140.16843853820654	0.3839860757191976	192	1899500	5
9171	317.37604934465736	93.51884057971054	0.8890405338715742	187	1899687	12
9172	318.0042250214235	380.19361702127446	0.13219941420362175	346	1900033	2
9173	324.1119196133144	928.7736842105144	0.2931639919973443	606	1900639	3
9174	324.9346086363593	406.3808219178059	0.17048428889374556	353	1900992	14
9175	325.9662378150134	428.0975265017652	0.29066236424514813	347	1901339	1
9176	325.0001946319097	229.36191950464513	0.45068105061848956	306	1901645	8
9177	325.87691995831784	412.6727272727237	0.18531909887341486	345	1901990	9
9178	326.5240262035745	390.58754448398383	0.22087429790962032	328	1902318	7
9179	324.9591433422608	170.03574007220269	0.12779917806949256	212	1902530	5
9180	325.1130499633129	340.34980544746907	0.2844184196158631	292	1902822	11
9181	325.4565102110107	359.45907473309444	0.20317677943310394	319	1903141	13
9182	325.26927844223394	306.73333333333255	0.6432127178839917	265	1903406	12
9183	323.1655856578116	114.90000000000043	0.152252758250517	170	1903576	1
9184	323.8078263529576	387.38965517241076	0.3859468942665192	332	1903908	10
9185	324.9537304215835	438.39823321554616	0.22743238176618302	350	1904258	2
9186	324.1100665350892	240.58734177215342	0.5764853002325806	283	1904541	14
9187	326.9666900076693	609.772413793099	0.37082754644600235	453	1904994	6
9188	328.68495236804273	498.7929260450115	0.2014221856438219	413	1905407	4
9189	327.6451258991174	224.70230547550563	0.198229365878635	288	1905695	3
9190	326.3988179423069	203.0143302180695	0.36810588444211356	243	1905938	9
9191	323.87183972966125	73.70099667774114	0.7089915725420106	159	1906097	10
9192	322.4581850266321	182.50636942675234	0.2600983635323947	244	1906341	5
9193	322.87497159741844	364.1368421052608	0.2640197503762167	305	1906646	8
9194	320.5294711396045	88.3249258160241	0.19407172825025476	184	1906830	2
9195	320.01830887853953	269.4132450331117	0.43939214338336074	285	1907115	1
9196	320.4461701583548	362.8044368600656	0.3839614636970289	330	1907445	11
9197	322.2158683080723	497.41598513010814	0.32003321975627275	378	1907823	13
9198	322.99311807569575	399.9408450704194	0.24690159062792238	401	1908224	12
9199	322.50850268441246	274.5315789473672	0.3815403529575893	280	1908504	14
9200	320.0026297787805	71.9212121212124	0.8712555335846958	151	1908655	2
9201	319.4165479254371	261.39444444444405	0.3736941162566567	267	1908922	5
9202	319.231963091344	300.95806451612793	0.6987686646290314	312	1909234	3
9203	319.1713731901603	313.17297297297097	0.2870724372973703	347	1909581	4
9204	318.46102908576586	248.13696275071774	0.32253170334530196	297	1909878	10
9205	319.2543931538825	397.7974358974328	0.5110128703870271	380	1910258	6
9206	320.0803672079552	401.8517985611481	0.20213977710620776	333	1910591	9
9207	319.38706513331977	250.75015974441033	0.5002710827112985	303	1910894	8
9208	322.6959524437699	650.2757961783335	0.4112118675595238	630	1911524	7
9209	322.19437354216956	272.5380622837361	0.3243515390745351	284	1911808	11
9210	323.14352071583875	417.1090909090875	0.2728048715110349	337	1912145	1
9211	322.99936719882123	308.7281690140837	0.3385377648758562	292	1912437	13
9212	321.14871599258646	137.934246575343	0.15905518165001503	195	1912632	3
9213	319.27791321804267	134.06843853820683	0.0627344945673886	253	1912885	14
9214	318.8303030999468	274.5169014084502	0.38679639667483934	282	1913167	4
9215	318.5806789010641	293.8678832116783	0.40176787095911365	272	1913439	9
9216	316.89398531960063	149.91132075471754	0.14080738298820727	198	1913637	11
9217	316.40922913987396	268.4183673469377	0.3826781502605355	274	1913911	8
9218	316.4840158293669	323.88789808916977	0.25816786179848766	327	1914238	2
9219	317.63409737925826	431.49217081850304	0.18666855034800622	346	1914584	5
9220	317.476089738799	301.8333333333325	0.22689209470323696	314	1914898	6
9221	316.43294975644363	213.16209150326893	0.2696596228558084	253	1915151	7
9222	318.987003820523	571.8383561643789	0.40396502205495083	445	1915596	12
9223	317.08721828936	129.00845070422605	0.08144199901632129	223	1915819	3
9224	317.95864292625436	404.2296819787975	0.4996748646780448	409	1916228	10
9225	317.9036906433333	312.46341463414484	0.2883154265195853	289	1916517	13
9226	317.682862325857	295.82085889570413	0.7758422946044166	323	1916840	1
9227	319.6531033890095	514.706968641111	0.4193413792824259	392	1917232	14
9228	319.6188097651914	316.22374100719276	0.14377467714507006	290	1917522	11
9229	320.45025803117574	402.7636363636332	0.20444543183739505	335	1917857	4
9230	320.181049568511	293.52941176470506	0.15921350944799723	299	1918156	2
9231	318.30739058797747	132.81515151515217	0.09204899367465767	186	1918342	13
9232	319.02380837644984	389.94916943521315	0.23816418647766113	352	1918694	9
9233	319.1984819534627	336.49116607773726	0.19990367951130789	309	1919003	6
9234	319.08533672437176	307.8839590443671	0.2003352697876385	299	1919302	12
9235	319.39281669046136	349.83333333333104	0.3896642445090288	334	1919636	5
9236	319.7208575638044	352.1969040247666	0.2570504400159852	347	1919983	8
9237	319.0127473488221	248.90983606557484	0.25148773193359375	264	1920247	1
9238	318.95992220091523	313.7302325581382	0.18545919638185115	321	1920568	10
9239	317.01832924849856	124.80062695924823	0.15749671422138115	193	1920761	2
9240	316.6870879849991	283.8942028985496	0.46763787753340125	276	1921037	14
9241	320.18199792706685	666.1780821917729	0.444265643229782	529	1921566	7
9242	321.9980584938712	501.7880546075023	0.42749392084714744	476	1922042	3
9243	321.75981273321366	298.17348242811414	0.2718143958549995	308	1922350	11
9244	321.1348106970867	259.2596091205211	0.44896499362922987	338	1922688	4
9245	319.3540788262782	143.06162361623677	0.1787980596224467	192	1922880	1
9246	320.05371985619723	389.3181818181788	0.32405052656008876	324	1923204	9
9247	320.3088089552131	345.562629757784	0.4530333503844246	315	1923519	6
9248	319.496133236795	239.0412371134027	0.29003829692061794	289	1923808	5
9249	319.7832744685296	348.21025641025534	0.21895567095891946	331	1924139	13
9250	320.45277049096757	386.7328767123267	0.14682396068129427	344	1924483	12
9251	321.76443576851403	451.6192982456096	0.19998308817545574	360	1924843	8
9252	322.58042777446525	403.3636363636332	0.2740874131037471	329	1925172	10
9253	321.9673358254877	261.2712328767112	0.18138482271491801	263	1925435	2
9254	320.04768656361836	130.00240963855487	0.21820931783536585	205	1925640	11
9255	319.7829929147654	293.57832167832066	0.25189339773995534	280	1925920	14
9256	317.6750250545833	108.98620689655228	0.37278005239125844	185	1926105	1
9257	317.3740929858556	287.5818181818175	0.22019213066726434	305	1926410	7
9258	317.0405418370189	284.0189781021893	0.3955536765613775	261	1926671	4
9259	316.4342792757916	256.4142857142855	0.20382126063516695	292	1926963	3
9260	315.81435492275	254.44184397163139	0.30454766750335693	256	1927219	9
9261	316.2108100357299	355.45986622073434	0.21910959408607011	324	1927543	6
9262	316.331988109006	328.32861736334195	0.3413800982646762	317	1927860	13
9263	316.6864986777429	351.78304498269745	0.2733344083987408	322	1928182	12
9264	317.5315156785431	401.1881987577603	0.23181746435947106	366	1928548	5
9265	317.7352364929807	337.9035971223	0.36800023005558896	325	1928873	8
9266	316.6553746940886	209.74905660377453	0.47031986530010517	260	1929133	10
9267	316.43059017791694	294.1769230769215	0.42937429745992023	288	1929421	14
9268	314.6110468660658	134.47625899280632	0.16487148152061956	201	1929622	3
9269	315.44919591297605	398.4259515570917	0.3360410353716682	340	1929962	1
9270	316.3295986906884	403.48947368420687	0.347986323859102	372	1930334	2
9271	316.38546646684773	321.9163763066186	0.7485261234551369	299	1930633	4
9272	315.58058122113954	235.8969418960258	0.3441693906430845	270	1930903	9
9273	313.1298443744454	70.50689655172445	0.5850739112267127	156	1931059	8
9274	312.9002866714416	290.1740740740728	0.16201678394565922	338	1931397	7
9275	311.7789405211451	200.7656716417917	0.19403211153470554	260	1931657	6
9276	311.613965069422	295.2813953488362	0.13681055536333298	302	1931959	13
9277	311.62267813190607	312.4852713178284	0.1299711930124383	285	1932244	5
9278	311.8758837830194	336.943243243242	0.29316100096091247	312	1932556	12
9279	309.9004149080145	114.32899628252845	0.05293242464360503	194	1932750	2
9280	309.5948393303629	279.3428571428563	0.18966818027978338	277	1933027	3
9281	310.53364603910006	403.47551020407974	0.3197043158791282	352	1933379	10
9282	315.92988872928805	850.1579150579015	0.42371354279694734	648	1934027	11
9283	314.8131873262719	204.25974842767388	0.5716007172115265	252	1934279	1
9284	314.32562688158055	266.0571428571425	0.2329044413477294	267	1934546	9
9285	316.0153487149545	483.29781021897594	0.29694166307325487	385	1934931	14
9286	315.00684387645356	215.16486486486573	0.3341963543155329	246	1935177	7
9287	315.7006335937173	384.3858156028344	0.32824493408203126	375	1935552	4
9288	316.86511580739847	432.1488549618305	0.15555112233418905	334	1935886	6
9289	315.32481056127415	162.83459119496933	0.5685521353662542	226	1936112	3
9290	315.43557629649183	326.4013840830438	0.17814631127194816	299	1936411	12
9291	313.82192641587983	154.0705882352949	0.38960361908369534	223	1936634	11
9292	317.4907031676572	680.6996015936213	0.40234192445638756	443	1937077	8
9293	314.9799854104286	66.41892744479524	0.4107658386230469	155	1937232	14
9294	313.92517893380773	209.49933774834506	0.33681868010876226	255	1937487	1
9295	314.41092714446967	362.49999999999784	0.49785144826307653	374	1937861	13
9296	313.59156866166853	232.47507886435434	0.18223839244623294	261	1938122	10
9297	313.89172170357415	343.6068728522314	0.1680632054631981	343	1938465	2
9298	313.9704541215749	321.7649635036489	0.3222469129060444	285	1938750	9
9299	313.1384489267644	230.76993464052396	0.25182118957295957	273	1939023	7
9300	316.33060497803723	632.3540540540477	0.3606510407934885	466	1939489	5
9301	315.80492718104495	263.7628252788097	0.2990827304650084	261	1939750	6
9302	314.1629150839557	151.60371747211954	0.20415898061169244	193	1939943	8
9303	312.3002773861076	127.89914529914577	0.21388346060163024	173	1940116	1
9304	310.411846040818	123.45714285714331	0.15503413936634755	193	1940309	9
9305	310.94699785068	363.92702702702564	0.6806697644685444	380	1940689	4
9306	311.2202778721732	338.2749999999983	0.4910316125670476	335	1941024	3
9307	310.4361862045626	232.81111111111167	0.19724149230524157	282	1941306	13
9308	311.1522791711774	382.04548286604165	0.36640182365439095	353	1941659	11
9309	312.93948365219285	489.87272727272284	0.490838549411968	373	1942032	14
9310	312.063679880963	225.35910652921012	0.2329940495528574	254	1942286	6
9311	313.5242796412931	458.1236559139754	0.3055732224013779	364	1942650	2
9312	316.8694418628013	648.0405017921092	0.30663923489845407	472	1943122	12
9313	316.4656167021238	276.486925795052	0.22824711502690018	273	1943395	5
9314	316.47378172715554	317.2821192052967	0.12358318618421901	303	1943698	7
9315	319.3879804178205	607.8936507936468	0.22050996584312937	428	1944126	10
9316	318.9581160935184	276.4015479876157	0.24750813802083332	300	1944426	1
9317	316.83773353885505	106.91986062717834	0.08956743701952233	219	1944645	4
9318	316.58325275519064	291.38965517241184	0.6606571772327162	292	1944937	9
9319	315.0804995927181	166.3079365079373	0.2717644990380131	201	1945138	2
9320	313.38462417425575	145.49295774647948	0.15155788402461526	199	1945337	10
9321	313.63684554817155	338.60676156583474	0.4787084008478055	314	1945651	14
9322	313.791928073082	329.14509803921374	0.3416331732451026	335	1945986	13
9323	315.0857865701289	443.1777777777743	0.26944763625877494	345	1946331	11
9324	314.87260753654436	293.7678832116783	0.2193743946788075	273	1946604	6
9325	313.16193241659295	143.80509554140195	0.2032692377468408	217	1946821	7
9326	317.0014791701655	697.1166077738451	0.3806562184828095	519	1947340	8
9327	316.11309868267097	228.1634304207128	0.1546517393014727	274	1947614	12
9328	318.5693153660951	561.7347670250848	0.5823053520741387	439	1948053	3
9329	318.51518404988997	313.156183745582	0.29861739853681146	295	1948348	5
9330	316.72633939893353	139.63071895424903	0.32741449393478095	204	1948552	9
9331	317.558257823126	399.9181818181802	0.23695930145071736	318	1948870	1
9332	317.1997075029592	281.70322580644995	0.2851201636998216	311	1949181	4
9333	315.12217878236	109.4468354430385	0.11511609105780574	202	1949383	10
9334	314.57166932330347	260.07123287671124	0.09736980785023082	275	1949658	2
9335	314.1573460726934	273.1393442622943	0.2613225050375495	284	1949942	13
9336	313.53147028638506	251.56976744186161	0.3098786903993927	274	1950216	7
9337	311.48663099335727	109.04754098360726	0.18026790618896485	220	1950436	5
9338	310.99126141544986	261.9496732026139	0.46068906784057617	288	1950724	14
9339	310.72250737734714	284.11585760517687	0.4667122580788352	297	1951021	8
9340	310.61838421440166	300.31019108280077	0.30200002100560575	308	1951329	6
9341	310.98720037225763	347.49999999999795	0.3304515414767795	324	1951653	11
9342	311.7498767556318	387.2548387096753	0.29697613716125487	320	1951973	12
9343	311.03018529704565	239.78073089701124	0.44378921332046334	259	1952232	4
9344	313.25865046916476	533.8767025089568	0.32700994950306567	395	1952627	3
9345	313.2060332477496	307.99692832764305	0.3170687434184982	332	1952959	1
9346	311.37312443042356	129.91515151515208	0.15892697711323583	215	1953174	5
9347	314.440827968728	618.1434782608663	0.4321991375514439	448	1953622	9
9348	315.06334276596374	376.6923076923061	0.39932883055850527	309	1953931	2
9349	314.12272573174675	221.00163934426322	0.29254371889175906	248	1954179	13
9350	313.4754984744293	249.40000000000128	0.6392296884574142	255	1954434	14
9351	313.3140702223582	297.33267326732556	0.14613610485714856	293	1954727	7
9352	312.7126678378917	253.17383177570147	0.32643293542615603	271	1954998	11
9353	313.24441439894935	365.8873239436607	0.21603254838423294	319	1955317	6
9354	313.9322202549598	382.0249999999983	0.3041303883428159	460	1955777	10
9355	311.67616911468133	88.32710622710674	0.10483278853169987	178	1955955	9
9356	311.3050704271975	274.5663003662991	0.2880324129928411	257	1956212	1
9357	312.71601972292547	452.399999999996	0.30669980875651043	375	1956587	12
9358	312.77003683066073	318.117730496453	0.15628885002266424	293	1956880	4
9359	314.8805103753976	523.8173913043449	0.39528905392847685	413	1957293	8
9360	313.18160382236823	144.98985507246448	0.28220004127139137	252	1957545	14
9361	311.15757725782873	110.77894736842177	0.05652887464145531	207	1957752	7
9362	311.2993885820246	325.3387096774178	0.3302680294529921	294	1958046	5
9363	310.9073946962044	272.09999999999866	0.23742346454867355	278	1958324	13
9364	311.3242096381312	352.5888888888878	0.3626560190105965	362	1958686	3
9365	309.58191491017095	137.09473684210582	0.12968089154377077	207	1958893	10
9366	309.50265053138725	301.655477031801	0.29803067759463664	304	1959197	11
9367	308.62211305428656	221.44890282131772	0.1860216074976428	261	1959458	6
9368	311.1977114726158	566.1819548872116	0.4906262469548051	465	1959923	2
9369	311.43275130704217	334.70169491525246	0.3941053932848068	313	1960236	9
9370	309.9459256254736	162.75018315018366	0.3445620983104988	203	1960439	3
9371	310.65239740370157	380.5931034482728	0.36542750701443305	331	1960770	1
9372	311.08230595561605	353.6432525951538	0.1657339581371059	338	1961108	4
9373	311.87572964930666	390.42467532467384	0.27619482456952676	348	1961456	12
9374	311.06253992038114	230.55675675675778	0.3248214137051754	261	1961717	13
9375	309.0837759443983	113.18614232209787	0.05592092771208688	178	1961895	11
9376	309.15618725558625	316.32490706319567	0.28049166943026077	293	1962188	5
9377	308.4019587163637	233.73333333333508	0.49916159140097127	370	1962558	8
9378	308.3282724625334	301.03333333333114	0.1449167121271169	322	1962880	7
9379	307.6932624651808	244.82727272727357	0.31613071359318795	278	1963158	10
9380	308.5469927618773	393.06629213482944	0.6458424675394092	338	1963496	6
9381	308.01237795793344	255.0855123674907	0.22696082375266335	275	1963771	2
9382	306.47225417835415	154.00000000000065	0.1618832857414866	209	1963980	11
9383	305.88415894284367	247.6627306273069	0.18610915836138217	253	1964233	4
9384	305.1517145659588	232.63972125435612	0.3038928271289841	251	1964484	13
9385	309.57065895876065	747.0461538461468	0.4713391500806052	567	1965051	14
9386	308.7398165667039	226.48641975308766	0.4155825345021374	265	1965316	12
9387	309.2887578844317	363.6339483394819	0.27071564603848475	311	1965627	3
9388	310.19226713098413	399.6396825396808	0.4010429847531202	328	1965955	1
9389	309.40401424160575	231.36697819314756	0.23053182623043272	271	1966226	5
9390	308.9529362985024	264.2962199312703	0.1730412507315405	277	1966503	7
9391	310.27709551683216	441.36885813148524	0.34956796380537974	395	1966898	9
9392	308.705232192186	153.09076305220964	0.09770786578838642	195	1967093	6
9393	307.6915092115815	207.33293413173763	0.29814633190403494	261	1967354	10
9394	308.25608060595215	364.1486486486466	0.5037854216819586	344	1967698	8
9395	306.35999118036403	118.64713804713854	0.07880779128000526	193	1967891	4
9396	304.63210882581234	133.57175572519142	0.0632973169025622	190	1968081	1
9397	304.32549361990715	273.9705882352937	0.25113151717360005	274	1968355	2
9398	304.18981011227953	290.757142857142	0.15865721525969328	270	1968625	13
9399	303.2581292635529	211.02172523961772	0.28969878547276434	253	1968878	12
9400	302.5744511967238	234.89032258064572	0.19930486352724722	263	1969141	3
9401	301.98797731181935	243.9270627062713	0.5681151196472627	266	1969407	14
9402	302.3881413097449	342.00437710437535	0.2613243103027344	350	1969757	11
9403	302.1094707810012	274.52108843537314	0.32218938535642794	281	1970038	9
9404	299.908164893067	81.97888198757802	0.11391177756248871	173	1970211	1
9405	298.70829796806277	179.92147239263863	0.46327682195925246	255	1970466	4
9406	298.9348560140232	321.36410256410164	0.26797347973397306	311	1970777	10
9407	299.3805044143693	343.499696048631	0.26512249096019846	333	1971110	7
9408	300.64128760551966	425.4588235294099	0.32785388722139247	340	1971450	6
9409	301.76961594352196	413.47412140574846	0.40583397919994935	401	1971851	5
9410	301.25133082703155	249.9411042944791	0.5141520811520082	291	1972142	2
9411	302.44146268005153	420.2645161290302	0.268493470209663	377	1972519	8
9412	300.1808831047974	76.38350515463951	0.45245829389139186	163	1972682	9
9413	299.7031899200079	252.41156462585053	0.1599099708325935	264	1972946	11
9414	299.50274279589433	279.65847750864947	0.2552606298568401	282	1973228	3
9415	299.0091264108801	250.14110429447908	0.377625990078936	289	1973517	12
9416	298.7621440961877	274.31089494163297	0.25932363479856463	252	1973769	1
9417	297.4136405259482	163.91178707224424	0.3093927152488264	223	1973992	4
9418	297.1154770936617	267.59729729729673	0.34654503899651606	296	1974288	7
9419	300.5013581650189	635.7035842293853	0.45433341507363106	452	1974740	14
9420	301.5465884858077	405.02439024389975	0.2858061213760601	339	1975079	10
9421	300.2730932849887	174.19706840390978	0.2200963848926982	244	1975323	2
9422	300.6797739044854	340.94115523465507	0.5191737088290128	308	1975631	5
9423	301.53432827811656	386.13521126760344	0.36053122107976066	363	1975994	6
9424	306.2728441502649	775.3859154929477	0.4599360010645411	555	1976549	13
9425	305.27181929182416	206.17035830618994	0.32192828369140625	250	1976799	11
9426	305.1766800462743	295.7578947368404	0.23252246523863518	298	1977097	3
9427	303.30079826323316	117.5885017421607	0.14518404530954884	182	1977279	7
9428	301.69213454289593	142.43442622950892	0.1478841995524469	214	1977493	10
9429	301.8387386211958	316.3525423728791	0.5944642699822009	327	1977820	4
9430	299.4431101926385	62.27589576547243	0.6693986820269234	158	1977978	11
9431	301.77063226796963	532.1953177257491	0.6853011524703023	463	1978441	8
9432	299.9888266545098	123.59007092198661	0.12362490711124262	217	1978658	13
9433	300.3910436511226	340.2105263157873	0.2714012777729399	314	1978972	14
9434	299.8080993163063	242.0966101694923	0.3052765429019928	256	1979228	6
9435	303.48156671024	667.1548387096738	0.34857681479426583	521	1979749	9
9436	304.09258557551163	364.5834532374078	0.454003660140499	310	1980059	5
9437	302.8571635957255	180.5503875968999	0.26585678392620177	209	1980268	7
9438	303.21776917495816	338.91772151898516	0.9076039513876272	344	1980612	2
9439	309.0362112015183	885.0619718309737	0.436506587623531	585	1981197	12
9440	308.52709112771964	258.1242038216553	0.4749362032178422	284	1981481	3
9441	314.2583094250754	881.6489208632984	0.3754134570654553	571	1982052	1
9442	313.87721730555387	276.1490974729229	0.3454594930013021	270	1982322	11
9443	313.92792661397976	318.9481481481463	0.4224186271326648	291	1982613	10
9444	312.40215582241626	161.3508474576277	0.19939839398419415	216	1982829	14
9445	312.86517774245294	358.70434782608567	0.6073861459585337	325	1983154	4
9446	313.03527340530144	329.87474402730163	0.3180695059914259	318	1983472	8
9447	313.05121549196554	314.62948207171144	0.5184337656985047	279	1983751	6
9448	313.37076953913646	345.00662020905736	0.521574460543119	312	1984063	13
9449	311.29229913188067	105.5237288135598	0.3525255761965357	198	1984261	3
9450	311.2878303238288	310.8454183266914	0.2309688196285537	277	1984538	5
9451	309.0428085942957	86.78565737051835	0.07747078512956997	167	1984705	11
9452	309.2922138416861	333.9833333333323	0.39685919089395494	305	1985010	7
9453	311.205362625255	500.6070921985788	0.22713032217000856	383	1985393	9
9454	310.5146072446165	242.1298245614044	0.3206952284482192	297	1985690	12
9455	310.4916873205802	308.2226148409881	0.180992484478503	309	1985999	1
9456	309.6047704473744	221.80000000000135	0.27335528716498	281	1986280	10
9457	308.6633871724309	215.466442953021	0.27869044193605175	294	1986574	14
9458	310.7927789417322	521.6025641025623	0.22307269978073407	424	1986998	2
9459	310.96207149129793	327.7220338983034	0.5525112575954861	315	1987313	4
9460	310.570450776385	271.79999999999944	0.21772125352744107	281	1987594	13
9461	309.68466983550013	221.99235668789913	0.30680526474774894	295	1987889	3
9462	309.28565029763894	269.78271604938254	0.4125154139631886	295	1988184	11
9463	307.613332256201	142.05384615384685	0.19914787610371906	240	1988424	12
9464	308.1869640581941	364.97651245551424	0.3025368761660448	335	1988759	5
9465	309.27493115230607	416.9836734693861	0.5261984709606035	421	1989180	6
9466	311.7286745944062	554.6492753623164	0.5168425664146146	467	1989647	8
9467	309.6445226002352	103.31347517730558	0.18207585062957615	207	1989854	2
9468	309.78468097783644	323.660360360359	0.21455919026025658	366	1990220	7
9469	309.0355180168553	234.86838487972557	0.4439381024309697	262	1990482	10
9470	309.5218248085177	357.66619718309767	0.43359579284334443	366	1990848	9
9471	308.6829677644459	225.636120401339	0.25279413656409516	251	1991099	4
9472	309.60199901395373	400.5860927152299	0.26372096302745107	364	1991463	1
9473	308.0544032662384	154.84242424242467	0.24259863739804283	193	1991656	7
9474	307.435794717447	246.19354838709734	0.27562390946145554	279	1991935	12
9475	307.39973640926166	303.82996389891537	0.1660760649552582	282	1992217	5
9476	307.9809933407017	365.5254295532626	0.5623589717980587	330	1992547	3
9477	306.0634980140362	116.23146067415782	0.20305571684966217	185	1992732	4
9478	306.2632227698694	326.0359735973582	0.1502315771012079	336	1993068	11
9479	305.92291438558703	272.23238434163636	0.18480931905875528	266	1993334	2
9480	305.23867158985405	237.49863481228775	0.4305509234231616	252	1993586	10
9481	304.63837330932967	245.2088435374155	0.26246620292094214	268	1993854	8
9482	308.43440485862834	684.2415282391976	0.4245235184977825	532	1994386	14
9483	312.0664401203868	671.6379310344752	0.4061293856788228	524	1994910	13
9484	313.32064993301935	437.4874213836429	0.33729005568098314	404	1995314	6
9485	314.0370187761549	384.9575342465736	0.6091369474777067	396	1995710	9
9486	314.676140701958	377.94921135646365	0.15163765170357443	352	1996062	1
9487	314.59071592860175	306.1336633663354	0.28099428979974045	304	1996366	12
9488	314.35432936856665	290.9520599250922	0.3986912821675395	273	1996639	2
9489	313.0133383136869	180.2552238805979	0.8626198935342002	286	1996925	10
9490	311.85964679101517	197.6441860465122	0.40846723359206627	290	1997215	4
9491	312.81151075475964	407.0460431654647	0.4032516695622344	353	1997568	7
9492	312.74874258598754	306.5346938775497	0.3325411774391352	301	1997869	11
9493	312.21751212607194	259.6256965944271	0.2636322670794548	282	1998151	8
9494	312.50533700481117	340.99999999999824	0.3063878422289823	339	1998490	5
9495	313.2326807978836	385.2397163120551	0.26726688719227953	331	1998821	3
9496	313.310269299351	320.9915309446244	0.24288199856537562	307	1999128	14
9497	313.44304976786947	326.5883161512012	0.22835993067837693	307	1999435	6
9498	313.6731509157604	336.4531645569605	0.3942972064371986	337	1999772	13
9499	314.5063424835259	396.99230769230655	0.40186104077971385	356	2000128	9
9500	315.2252202351612	386.39411764705756	0.47503468747309746	363	2000491	1
9501	315.18616347254897	311.3195439739404	0.36982948951471867	306	2000797	11
9502	316.1653516717105	413.1049833887014	0.2921537231791121	353	2001150	12
9503	315.71956994986516	271.58717948717793	0.20306156902778438	328	2001478	10
9504	315.643867208113	308.14929577464665	0.33984837804112705	333	2001811	3
9505	315.6964121425892	320.8983606557364	0.49938079741786257	331	2002142	5
9506	316.31304935006693	377.36013289036305	0.2310301849807518	345	2002487	7
9507	317.56235169238715	441.2432835820859	0.29125219345092773	400	2002887	4
9508	318.3385542624198	395.18260869564796	0.4430185052412975	395	2003282	2
9509	317.7690258626527	261.38571428571385	0.2674704078290102	278	2003560	13
9510	316.8126432963339	222.13076923076983	0.4801136723271123	270	2003830	6
9511	316.9759862511256	333.14693877550803	0.30004430865961784	341	2004171	14
9512	316.3981941305498	259.19677419354747	0.2677979229165496	278	2004449	1
9513	315.30330927662294	206.90970873786483	0.5055734487680289	260	2004709	10
9514	314.2958735864541	214.55974025974132	0.3727909028530121	256	2004965	3
9515	314.35655314846184	320.36382978723304	0.17573329202489915	306	2005271	11
9516	319.41160075566324	819.8613138686017	0.562348187593423	669	2005940	8
9517	319.62842201747924	341.0937269372679	0.18309822688027033	315	2006255	5
9518	320.34180071865273	390.96629213482953	0.6897363264248564	359	2006614	13
9519	320.5267770776634	338.8394366197165	0.24943529134589104	343	2006957	14
9520	321.61053661064096	428.90273037542283	0.49193865402154463	454	2007411	12
9521	323.77470397180724	538.0272727272685	0.5437605302412432	546	2007957	9
9522	326.3635419123263	582.6584980237132	0.5862068159575013	457	2008414	4
9523	327.3178869492291	421.79804560260396	0.37199342766763954	439	2008853	2
9524	325.43880212362393	139.4094043887156	0.6334309030086436	235	2009088	3
9525	324.3924304958303	220.80163934426326	0.5238450317382812	250	2009338	11
9526	324.08084517392285	293.2338983050835	0.21875203361909978	287	2009625	10
9527	328.8164339824575	797.6397260273874	0.35348127885298297	550	2010175	7
9528	329.28778326131	375.9513618677026	0.5834910633799794	364	2010539	1
9529	327.3951008309957	140.01954022988548	0.22361786548907941	208	2010747	13
9530	325.69925593201054	157.81061093247678	0.5012318353233097	318	2011065	8
9531	326.3210946979916	387.8831325301179	0.27993502501385437	578	2011643	6
9532	326.07987960163405	302.19958506224026	0.8479803864067122	338	2011981	5
9533	325.79150777190983	297.242696629212	0.44607873213918586	285	2012266	9
9534	324.44139489199296	190.78021978022093	0.20335203388570502	289	2012555	14
9535	324.1141720693529	291.71911262798517	0.2650731316928206	290	2012845	4
9536	324.4345949745097	356.1564625850325	0.321337571458352	349	2013194	12
9537	324.3199059590712	312.96569343065613	0.3550725809733073	300	2013494	3
9538	324.9752835418162	389.8576642335753	0.30659713288267215	334	2013828	2
9539	324.6623446598864	293.6813953488365	0.40097945591188827	318	2014146	11
9540	323.78615769537225	237.04364820847027	0.21742149953092083	267	2014413	7
9541	322.97481510576034	242.65189873417873	0.41411598361268337	294	2014707	10
9542	323.3259760456118	358.0909090909067	0.20850382190692002	309	2015016	1
9543	322.8608966130245	276.81803278688454	0.18493176868983677	280	2015296	8
9544	320.5996972032083	96.74095563139981	0.09777467449506123	192	2015488	3
9545	320.3311288026047	293.7428571428557	0.3411714638493391	383	2015871	13
9546	319.93859170812703	281.0774193548376	0.25005193342242327	285	2016156	14
9547	320.2111520997706	347.1946308724816	0.3183170665394176	319	2016475	9
9548	320.1042252921486	309.51847133757803	0.3426793353856342	407	2016882	6
9549	319.5533366228449	265.0153583617741	0.19623859835342622	284	2017166	2
9550	317.48360408649194	112.5800829875525	0.5765587346470771	201	2017367	8
9551	318.70540440926334	439.66363636363263	0.3585013300994706	366	2017733	12
9552	319.49607763789794	397.77272727272367	0.419946462036627	494	2018227	5
9553	319.25355348123725	295.2436619718303	0.20314355330033737	286	2018513	1
9554	319.35157532347404	329.0557377049166	0.23833860367063492	315	2018828	10
9555	318.81378464576795	265.5725075528692	0.2325539839895148	304	2019132	7
9556	320.32656878512586	470.09219858155785	0.1891024416378197	369	2019501	11
9557	322.0552206230477	493.1917525773172	0.2645568272937265	531	2020032	4
9558	322.87621281836164	404.15444015443745	0.25027797348319986	359	2020391	13
9559	322.25016171679397	260.2711026615965	0.4523497550718246	248	2020639	8
9560	322.35802373598966	333.0363636363625	0.24977939793320952	305	2020944	6
9561	323.57197829716455	443.75347985347736	0.4074935065375434	360	2021304	14
9562	324.94525851419286	460.89999999999765	0.27953849205603964	390	2021694	3
9563	324.66513491927896	296.9328990228006	0.27447334316134037	287	2021981	12
9564	324.943243063757	352.4759493670867	0.13256476103369869	335	2022316	2
9565	324.61562429771567	292.1813664596256	0.3966377581369605	307	2022623	10
9566	327.2375247923271	586.8056737588615	0.25406724228008604	443	2023066	9
9567	326.9491428103971	298.39932659932566	0.2569946886381645	281	2023347	11
9568	327.1035797210554	342.3928338762201	0.17041520686164452	321	2023668	7
9569	328.4293120397868	459.6768115942008	0.3371025043758538	366	2024034	5
9570	330.21889437726435	507.38754578754276	0.21096475068333878	383	2024417	1
9571	329.5528033355896	263.6097902097894	0.3028899282779334	265	2024682	13
9572	328.7246507288549	246.73754266211716	0.6196945423388299	262	2024944	6
9573	328.1523819167336	271.4977695167278	0.2745856055917666	258	2025202	14
9574	329.60891692109567	473.8058823529392	0.5534906200334138	408	2025610	4
9575	327.629161085218	131.63333333333378	0.13023533644499602	216	2025826	11
9576	327.5406926254912	318.7823151125382	0.32493813430206686	316	2026142	8
9577	327.0807339750984	281.5448275862054	0.3435896763818189	287	2026429	3
9578	324.8982964983611	108.8369863013705	0.14956884564093822	212	2026641	7
9579	323.67408174529805	202.47682119205365	0.16713833900952432	259	2026900	2
9580	323.5070337383026	306.9692810457503	0.2537610123797161	328	2027228	12
9581	323.6282920722482	335.63286713286584	0.2281320656940436	314	2027542	9
9582	323.8665347487953	347.45255972696026	0.24689615562944658	347	2027889	5
9583	324.6744638069017	404.65944055943896	0.22909386064753187	358	2028247	1
9584	322.8727448923054	144.50257234726737	0.2574196874567893	226	2028473	14
9585	322.603249915707	295.9232472324711	0.231145028037892	287	2028760	6
9586	322.0896303858332	271.24129692832685	0.1553729221738618	290	2029050	4
9587	321.27649708775516	240.77630057803592	0.2714204168938971	308	2029358	13
9588	319.9108574813091	184.7125364431494	0.20405669801263696	251	2029609	11
9589	319.3537868811796	264.20379746835425	0.23365620930989583	300	2029909	8
9590	319.2091812157576	304.89322033898156	0.4222619549121732	306	2030215	3
9591	318.9550446274806	293.7955223880581	0.21206390945999712	270	2030485	12
9592	318.5775357147521	281.204153354632	0.2102094663606657	286	2030771	2
9593	318.98403571992344	359.2275362318816	0.3546156936816955	356	2031127	7
9594	320.80446118550896	501.0265822784745	0.6747695146980932	590	2031717	10
9595	321.5181508393881	392.17342657342505	0.2994131861205699	343	2032060	9
9596	320.1528784219033	184.99090909090984	0.19169950485229492	240	2032300	1
9597	319.61738761236785	266.60379746835423	0.32114236251167627	276	2032576	5
9598	319.2975040588248	287.6290322580634	0.2630883069105551	284	2032860	14
9599	318.5390961824157	243.4567164179109	0.3135085998778324	251	2033111	4
9600	318.1420121512846	278.830693069306	0.30845723833356586	280	2033391	6
9601	316.2908312324295	133.02392026578127	0.09505360985770443	197	2033588	3
9602	316.04594894241006	291.80260223048225	0.31257802290882136	278	2033866	13
9603	315.3772190946798	249.17296416938242	0.17534792250481204	276	2034142	8
9604	313.63574448158766	141.22975778546765	0.1014019961648144	213	2034355	10
9605	313.2575688549536	275.8181818181805	0.30757073361901244	259	2034614	7
9606	313.9292834889847	380.4290322580626	0.6259915641184604	356	2034970	11
9607	311.993100243136	120.3109589041102	0.5670288848876953	200	2035170	9
9608	312.27901829730837	340.5849056603747	0.345868374438996	329	2035499	12
9609	312.8919553870625	373.5727272727242	0.2307450430733817	336	2035835	2
9610	310.8432731213275	108.0237288135597	0.12092272808097002	173	2036008	4
9611	308.754379639261	101.95392491467626	0.12649928564312815	174	2036182	13
9612	308.8066045725101	313.97687296416836	0.1869969490246895	312	2036494	1
9613	309.01358614583256	329.5047619047602	0.16015850574977628	323	2036817	5
9614	310.243567931433	432.0117647058806	0.2053705851236979	348	2037165	14
9615	309.21025883439717	206.91265822784925	0.623239008585612	240	2037405	8
9616	309.5542141238667	343.60578778134834	0.5004244760366586	325	2037730	6
9617	310.7873386492946	432.8666666666632	0.6108216871493648	337	2038067	3
9618	310.86071433343363	318.1249070631957	0.2236293445933949	275	2038342	10
9619	310.30177932124684	254.9672131147539	0.13270144834837505	269	2038611	11
9620	310.3839107817657	318.51492537313237	0.30226334047989106	284	2038895	9
9621	308.58013516601153	130.00634920634977	0.18027248682151914	191	2039086	13
9622	308.0740159335567	257.968211920529	0.2943461271707485	267	2039353	12
9623	307.49689646387634	250.36206896551775	0.28674484613373524	254	2039607	2
9624	305.9368163881265	151.48888888888945	0.17805618771238824	173	2039780	1
9625	305.6292009124172	275.17526881720335	0.16877329626748727	258	2040038	4
9626	305.4756828971011	290.27739938080396	0.39439040302199657	347	2040385	7
9627	305.80787973608375	338.6953667953649	0.25565839494977677	280	2040665	14
9628	304.60906409661766	185.92631578947464	0.2867616303113042	245	2040910	6
9629	303.23119337266394	166.8219917012456	0.23603645478836213	198	2041108	4
9630	303.3545280554786	315.5646616541334	0.3064729298976873	302	2041410	8
9631	305.28735314529416	496.63703703703214	0.2690643234820875	403	2041813	5
9632	304.89963319745897	266.515358361774	0.20767841551826788	269	2042082	9
9633	304.40119914306445	255.0562277580073	0.24005274470118956	331	2042413	3
9634	304.013363622222	265.61764705882297	0.2232559902567259	284	2042697	13
9635	304.06608712885696	309.2857142857132	0.49454005825081	299	2042996	11
9636	304.36906098810726	334.3634730538904	0.17842583966678416	338	2043334	10
9637	304.5527037115595	322.7333333333317	0.3575243090019851	305	2043639	1
9638	305.2045289876111	369.7352313167243	0.20004853523183533	323	2043962	2
9639	305.8680879380177	371.56042402826677	0.17227807168658255	347	2044309	12
9640	304.0242559795008	121.4848920863316	0.14929926235045018	223	2044532	8
9641	304.4054249720524	342.14115523465495	0.2908812342463313	296	2044828	14
9642	304.190374674901	282.90039525691594	0.4172799332810956	253	2045081	5
9643	304.2257744300975	307.7303501945511	0.26026728615831973	268	2045349	9
9644	303.6041718582103	242.0655172413799	0.20017205423383572	268	2045617	3
9645	302.6851301396282	211.7000000000008	0.2948021795963035	257	2045874	10
9646	302.46397114592423	280.5692307692296	0.19057476005680934	301	2046175	11
9647	302.52133726536874	308.2005830903774	0.1858045149513078	503	2046678	7
9648	304.3099410970161	481.38172043010456	0.42463781550067115	454	2047132	4
9649	305.1966636038541	392.98219178081956	0.19320399693080356	350	2047482	2
9650	306.15310981185223	400.84128440366743	0.6516498832545653	486	2047968	6
9651	307.331232849072	423.96541353383145	0.33968492811479367	421	2048389	1
9652	305.2007907495889	94.28702290076376	0.16093373444914086	163	2048552	10
9653	306.3580418348987	420.92589928057293	0.22641863843402127	466	2049018	13
9654	305.9395064326269	264.504501607716	0.2451186316353934	280	2049298	14
9655	306.0823628302889	320.2251461988286	0.6174626193203769	364	2049662	8
9656	306.3559028383496	333.43636363636153	0.5170334724096761	301	2049963	3
9657	307.2906215877439	399.82777777777596	0.2352842403646788	341	2050304	5
9658	306.6599859989292	244.22706270627128	0.2972670000315619	263	2050567	7
9659	311.18540022344683	759.201408450694	0.4797705014546712	576	2051143	12
9660	311.1568015403613	308.3255319148922	0.21166555881500243	320	2051463	11
9661	313.57493775030974	552.9704225352074	0.38997457595098584	420	2051883	9
9662	311.8692053219592	143.00169491525492	0.34589515354322353	230	2052113	13
9663	313.4350064194245	468.4493150684904	0.16577705204019968	383	2052496	4
9664	311.3173958188318	101.67394636015364	0.07177847693948185	170	2052666	3
9665	311.1017932892149	289.75714285714207	0.2617162159511021	280	2052946	1
9666	308.9400480835955	94.92727272727322	0.12999775988907464	177	2053123	8
9667	310.6136884190861	476.3040816326493	0.4118148984288323	338	2053461	6
9668	311.0142068249976	350.6655290102358	0.36186471846178814	349	2053810	2
9669	309.4007450288565	149.6680272108848	0.5186843120405826	203	2054013	11
9670	310.8744727702055	456.7735191637594	0.21322223190267356	379	2054392	14
9671	310.27323316195736	250.75051194539358	0.32477667927742004	256	2054648	7
9672	310.8269873168243	365.6486486486471	0.3947230747767857	329	2054977	12
9673	311.11213958898475	339.34221453287046	0.232294478973785	308	2055285	9
9674	310.28439107445087	228.33728813559395	0.5648187445115673	258	2055543	4
9675	308.7284402934773	154.68931297710023	1.4864158320233105	246	2055789	2
9676	309.028912162944	338.7756272401418	0.3379830338380518	303	2056092	13
9677	308.7014532996171	276.28302583025726	0.1829601608159888	262	2056354	8
9678	308.13789521261396	252.34564459930354	0.28589566306922826	263	2056617	6
9679	308.25888835351105	320.2372093023246	0.16357831453022204	285	2056902	3
9680	308.9113943604869	373.5094890510938	0.12436059618753101	315	2057217	1
9681	311.387873637221	556.5593220338943	0.356438474202617	569	2057786	10
9682	309.8881920839474	161.41971830986014	0.2690874988814274	251	2058037	14
9683	309.48305209859177	269.374193548386	0.22398971725296188	273	2058310	11
9684	308.50201644940074	211.37948717948794	0.22023363521590772	257	2058567	7
9685	313.53931429256954	812.2318007662786	0.7583145513767149	574	2059141	5
9686	312.7970978280891	239.3176678445236	0.22225430607795715	256	2059397	9
9687	310.8435665661203	117.44397163120644	0.24095684412575552	243	2059640	6
9688	310.4476465799016	271.2515679442499	0.38396052168451855	283	2059923	4
9689	311.8298797915219	448.67096774193243	0.43116821115173165	351	2060274	12
9690	312.64829527932096	393.6714285714269	0.2736786151754445	348	2060622	2
9691	314.2983274780429	477.65151515151285	0.4830514836438837	374	2060996	13
9692	314.46150527708795	330.6161073825489	0.7663692149454111	317	2061313	1
9693	314.60818124598893	329.12910216718177	0.4509257923473011	330	2061643	3
9694	314.62143746169806	315.93380281690094	0.2466355526086056	396	2062039	8
9695	314.44803704056943	297.2813953488363	0.16041234875401705	282	2062321	11
9696	313.11274944124807	180.9192771084346	0.2863494808934316	238	2062559	5
9697	313.99313993244704	401.15179856114827	0.4266352036420037	340	2062899	7
9698	315.15107247870077	429.78639455782127	0.36204321694836394	361	2063260	14
9699	318.43800864036064	643.8446886446848	0.47585469017626186	447	2063707	10
9700	317.6176148553269	236.39863013698687	0.2679402407477884	272	2063979	9
9701	316.052763031098	161.13243243243306	0.3687518137805867	212	2064191	2
9702	313.7607515298193	86.85161290322627	1.0077236077724359	195	2064386	3
9703	314.19644909926683	357.3305084745742	0.29517753035933886	324	2064710	4
9704	315.19410328531694	413.9618677042783	0.4048902496256074	373	2065083	6
9705	315.7436038109053	370.14415584415434	0.22144304768423015	356	2065439	12
9706	314.06557716876944	147.94093959731617	0.1970783415294829	231	2065670	5
9707	314.00314781217605	307.8226415094323	0.2862487456023881	317	2065987	1
9708	314.5497348907553	368.6618556701011	0.21006025709547438	333	2066320	13
9709	314.6066145386529	320.2376996805101	0.45800153235530544	311	2066631	11
9710	315.58263349964926	412.20851063829605	0.29401048300922783	345	2066976	8
9711	313.4655372026756	103.87300380228189	0.2806595624503443	177	2067153	6
9712	313.46503133230993	313.41495016611157	0.3968703031539917	320	2067473	10
9713	313.9644449920508	363.4063973063951	0.23108228423891689	338	2067811	14
9714	313.5710469189419	274.6246376811584	0.3101428398719201	260	2068071	2
9715	311.9607885570322	152.5452107279699	0.45140234090514103	236	2068307	5
9716	313.3647280720735	452.35474006115976	0.3748943357539356	399	2068706	9
9717	316.18219038039376	595.1109589041046	0.4156690276829542	452	2069158	7
9718	317.0031945635463	398.28260869565065	0.6465795328328897	364	2069522	3
9719	318.05170276389623	421.85401459853784	0.14354033457572354	379	2069901	4
9720	317.02609618401846	215.4910447761201	1.0078366112163049	262	2070163	1
9721	317.0298070090121	317.3971786833843	0.18579186711992537	336	2070499	12
9722	317.5688047135699	370.9295774647872	0.16826977350015557	339	2070838	13
9723	317.7415369562893	334.8420289855058	0.2163632546701739	310	2071148	8
9724	318.6237060023108	405.9584415584399	0.4729273836377641	355	2071503	11
9725	317.94570384161653	250.82348993288656	0.21983136992523636	276	2071779	2
9726	318.29830340697396	353.2056603773563	0.2070253589485265	316	2072095	10
9727	320.88199961818714	576.6679245282968	0.23926587682438577	421	2072516	6
9728	320.2386386383987	256.5459016393438	0.24602372496278135	286	2072802	5
9729	319.884906340065	284.8654088050303	0.31546527409957625	295	2073097	9
9730	322.39691441952147	571.0857142857086	0.30909258141041906	431	2073528	14
9731	321.70265956104055	252.9714285714293	0.23143977744906558	255	2073783	12
9732	322.3262996320968	384.066666666665	0.24657320462740384	325	2074108	7
9733	323.2294682904521	412.6431654676228	0.5121848074881522	333	2074441	4
9734	324.09557218405996	409.83985765124334	0.15348616985331975	349	2074790	3
9735	324.50920829895404	365.4591836734679	0.2817076459343051	324	2075114	1
9736	324.2787273270756	301.46111111111037	0.3332770519458784	283	2075397	13
9737	323.5657082198948	252.9768166089966	0.22156965031343348	272	2075669	8
9738	323.39719399483874	306.7142857142846	0.27278131927173443	289	2075958	11
9739	321.79791195036074	163.4689895470389	0.19980565292575347	211	2076169	5
9740	322.18333018185047	360.3397350993362	0.2769711585271926	336	2076505	2
9741	320.06879317632826	110.72962962963018	0.10581727738076067	188	2076693	12
9742	320.81613412543135	394.80288808663954	0.2956922239803787	347	2077040	10
9743	318.99930352347667	139.13307392996168	0.11969810636172741	203	2077243	1
9744	318.85525822343357	304.5947735191623	0.1799351993023149	298	2077541	9
9745	319.03951015247736	337.280451127818	0.4908886613516972	348	2077889	6
9746	318.26614515128705	241.7030100334462	0.33444850960957634	291	2078180	7
9747	318.23144596392507	314.7962264150928	0.25198789897717927	285	2078465	13
9748	319.14949514064944	410.0363636363605	0.17328002701944378	335	2078800	3
9749	318.4757365236481	251.77363344051523	0.18980178610576484	343	2079143	4
9750	318.56801902552127	327.70398671096194	0.321503423875378	310	2079453	8
9751	318.1376977202835	275.535888501741	0.2012073447487571	275	2079728	11
9752	320.0581803922034	510.18596491227436	0.26837717000048716	441	2080169	14
9753	318.6054636189562	174.7865030674852	0.36981562400350765	245	2080414	12
9754	316.60074231609997	118.13333333333391	0.45373036661945965	251	2080665	2
9755	315.3304235156935	189.56886227545004	0.3925322602614473	259	2080924	1
9756	316.1917909223275	401.467164179101	0.20809496198381697	350	2081274	10
9757	317.42514698570693	439.52739726027175	0.4393222096202138	364	2081638	9
9758	316.73857336819884	248.76778523489995	0.7239198285817193	263	2081901	3
9759	317.83787728968923	426.66896551723767	0.4671262141327682	353	2082254	6
9760	317.4886066249004	282.91081081081	0.2791918198839366	278	2082532	11
9761	317.80810339693517	349.4382838283813	0.2995341303828242	333	2082865	13
9762	319.7729321374018	514.2909774436031	0.7836541312081473	420	2083285	7
9763	318.7744503407803	219.92475247524825	0.2274654041637074	275	2083560	14
9764	320.41769834673573	483.09925093632665	0.19399561346533464	374	2083934	8
9765	320.2271996849467	301.3678321678309	0.1396317249012304	307	2084241	12
9766	320.7433459390478	371.84182509505547	0.1333288701784189	311	2084552	2
9767	326.6822892912515	914.6376811594156	0.4376639491926649	599	2085151	5
9768	328.74594008254945	533.0473684210473	0.48600472529382166	458	2085609	4
9769	328.43108549272046	297.2604810996549	0.27540218707212466	291	2085900	1
9770	328.45991332392464	331.31386861313774	0.22553924254350438	299	2086199	10
9771	328.70873056079216	353.3416370106747	0.39632077510302893	309	2086508	6
9772	328.7697797739555	334.81365187713146	0.3642224828509308	371	2086879	9
9773	328.90256978109403	342.0487804878036	0.25777184531549224	359	2087238	13
9774	327.1663187311704	155.27746478873317	0.6231228536810757	242	2087480	4
9775	328.68165554385865	478.699999999995	0.22399167181218713	412	2087892	11
9776	329.33873589563655	394.3896907216473	0.306057105126319	385	2088277	12
9777	329.6670873901833	362.17388535031535	0.5404144287109375	390	2088667	7
9778	330.6106404910448	424.0223974763363	0.3680177168412642	396	2089063	8
9779	330.2947313179683	299.0197231833899	0.26179249222214157	296	2089359	10
9780	332.4892767584118	549.7492753623169	0.24410138388936833	516	2089875	3
9781	332.48140821228094	331.70242214532783	0.20144108883805378	419	2090294	5
9782	333.5847369873009	442.8142857142825	0.36781628332405447	428	2090722	14
9783	334.2461206643593	399.7231046931381	0.3292856371080553	370	2091092	1
9784	339.5137059693436	861.0046511627882	0.2917322573454484	575	2091667	2
9785	339.0978281689095	297.92592592592445	0.1334981200515583	279	2091946	13
9786	339.0512296781611	334.43797909407454	0.26357280248883125	348	2092294	6
9787	337.30485123964723	164.41338582677264	0.15816174090748103	284	2092578	11
9788	335.48839265530836	155.65899280575601	0.16071913184189215	205	2092783	10
9789	334.01661913884993	188.31104100946465	0.74029541015625	261	2093044	12
9790	335.26508718870656	458.86342412451097	0.1686490015550093	352	2093396	4
9791	335.5768832621571	366.4446945337597	0.3901601208306347	386	2093782	9
9792	335.00982119645283	278.8706766917285	0.18800887801134544	293	2094075	8
9793	334.93805877784627	327.83357933579185	0.20675989786783855	300	2094375	14
9794	334.44388362813424	285.5205438066453	0.3829267719123937	316	2094691	3
9795	335.095552899961	399.6108108108089	0.4023945985408371	361	2095052	7
9796	336.3695973709613	462.4999999999956	0.21778069970442013	374	2095426	5
9797	335.55380280570233	254.79014084507062	0.30240357811771224	268	2095694	6
9798	336.7595425554231	456.127777777775	0.3043920739412899	403	2096097	1
9799	334.5531533154359	116.12061855670153	0.22743045078234725	178	2096275	9
9800	333.8144387757456	260.68169934640474	0.2542109418271193	268	2096543	10
9801	331.8569395492785	138.06451612903265	0.12122966057092101	199	2096742	8
9802	331.5222397190031	298.3869565217379	0.22411678148352582	276	2097018	12
9803	332.0156771857586	380.8659863945561	0.21901637806611904	340	2097358	11
9804	329.94508684746745	124.95664335664381	0.5104064524499445	183	2097541	7
9805	329.2916558465425	264.601986754966	0.39277740478515627	300	2097841	4
9806	330.2509419024561	425.2202614379048	0.4354827154250372	420	2098261	13
9807	328.02210722391595	107.36747404844326	0.3047243530987299	171	2098432	6
9808	326.01370027807087	127.18141263940569	0.34042000635869085	177	2098609	1
9809	325.18121822736686	242.76549520766903	0.2533342314929497	287	2098896	14
9810	326.27005398516803	434.06479400748816	0.4677602431353401	340	2099236	3
9811	326.12154888505574	311.41954397394034	0.24735807825307377	305	2099541	5
9812	324.42057515444696	156.02417582417633	0.349359851198148	197	2099738	12
9813	330.3595891831222	918.321978021972	0.39263555027494496	596	2100334	2
9814	330.3898394451371	333.38461538461445	0.13460213114101685	319	2100653	9
9815	330.41903457586557	333.3093525179838	0.3993857138132969	299	2100952	10
9816	328.70472749858936	158.9883268482495	0.44473278103162295	199	2101151	14
9817	328.3283334222566	291.065319865319	0.3911795267244665	287	2101438	11
9818	327.70972256190163	266.4672473867581	0.20437182606877508	296	2101734	13
9819	328.2721941095168	383.95687732341804	0.25979037919649767	323	2102057	7
9820	327.85954909149854	287.00769230769157	0.3020472494971673	302	2102359	4
9821	325.9783047711521	139.7351170568569	0.5329508758397494	207	2102566	3
9822	327.66250707142586	494.39853479853156	0.19994210368646287	403	2102969	8
9823	325.7212153340449	133.53333333333384	0.1556950583675791	197	2103166	5
9824	325.8327108219005	336.8707641195996	0.17399647550762826	318	2103484	1
9825	324.97931637361415	240.49326599326724	0.49864386010357714	254	2103738	12
9826	323.17487485822966	144.53516483516538	0.21129268230778156	202	2103940	10
9827	321.88226852450805	193.91424148606916	0.3341452724249788	258	2104198	2
9828	321.23558869640584	257.21428571428555	0.3174932506722464	284	2104482	9
9829	319.41356354874137	139.03307392996163	0.2080226412006453	204	2104686	4
9830	322.7031720993004	648.3744186046466	0.38038725193923084	492	2105178	6
9831	323.14787438504135	367.1734006733985	0.2269823451242047	334	2105512	11
9832	322.66321236144813	274.6816720257213	0.2395398300305932	339	2105851	14
9833	321.09280594316283	165.62257053291617	0.7118927600337009	255	2106106	5
9834	321.17278110953765	329.09032258064383	0.3283645772488318	321	2106427	3
9835	321.9627554261018	400.17021276595534	0.219356122455225	359	2106786	7
9836	322.6785881893011	393.5460317460294	0.18925377953396694	381	2107167	13
9837	323.52020971481545	406.84074074073783	0.28575005615956683	338	2107505	1
9838	322.57917155209356	229.41639344262404	0.4996986518471928	295	2107800	10
9839	322.4711485662143	311.77687296416826	0.3976888142659992	334	2108134	12
9840	321.797553799795	255.11167192429	0.7484520038245862	287	2108421	2
9841	323.27476517768486	469.51869158878145	0.29535262649123734	444	2108865	8
9842	323.59388053960663	355.18630136986127	0.2381584817302716	317	2109182	4
9843	323.64198935325817	328.4047619047603	0.23441273580768152	334	2109516	9
9844	323.453715801189	304.814634146341	0.39196845666686103	335	2109851	6
9845	323.39935594814165	318.01773049645305	0.382900705142897	294	2110145	5
9846	321.512185918072	134.682352941177	0.24896245658115188	211	2110356	10
9847	319.7406947209122	144.3630662020911	0.18338953522202883	193	2110549	2
9848	319.9339084633582	339.0620689655148	0.6297898877219218	367	2110916	14
9849	320.36416655186946	362.95971731448606	0.47613114756546254	327	2111243	13
9850	317.8271958128683	66.66709265175746	0.7326869379523342	163	2111406	6
9851	321.6171793291921	696.8255474452487	0.3201680223480994	476	2111882	11
9852	320.69598929881806	229.49817629179475	0.5569754066707203	318	2112200	12
9853	322.6233537301541	513.4324324324296	0.38152405341285234	439	2112639	3
9854	323.0293955551714	363.22753623188254	0.12822050987919675	316	2112955	8
9855	320.90523031249097	110.61287128712922	0.3652560340033637	180	2113135	5
9856	318.8993131445012	120.31351351351385	0.16453337274203644	181	2113316	10
9857	320.21140936013524	450.10893470790035	0.36646618889373483	412	2113728	1
9858	319.7882683305069	277.89730639730567	0.2555663417762434	284	2114012	9
9859	318.8124625702788	222.20769230769304	0.34876195271809896	300	2114312	4
9860	318.46227997356146	283.7942028985496	0.5125551189326207	277	2114589	2
9861	322.2996497388815	702.1992565055683	0.4220337875246063	635	2115224	7
9862	322.290291539365	321.3638297872332	0.4116816907315641	296	2115520	13
9863	320.21059480953835	114.32061855670158	0.2421646702046297	196	2115716	8
9864	320.64243022952115	363.394136807816	0.2765007806738569	339	2116055	14
9865	320.516067782896	308.0061855670087	0.5182026895778573	321	2116376	6
9866	320.0796612034277	276.87540983606493	0.39524814771569294	345	2116721	11
9867	319.5925553130429	271.3690721649474	0.2426398259943182	275	2116996	4
9868	317.9753072843424	157.8677524429978	0.3967465837939982	277	2117273	1
9869	317.7925907563495	299.70365448504884	0.5649020794740657	291	2117564	9
9870	318.26071890284004	364.6054054054029	0.42348174673919303	407	2117971	12
9871	317.38325124869533	230.51395348837332	0.4588834671747117	252	2118223	2
9872	317.51759126017004	330.8172523961651	0.3745422134170303	333	2118556	10
9873	318.8432285771403	450.08132295719565	0.31127506066422433	362	2118918	5
9874	318.4157902490728	276.0993957703904	0.21117820739746093	380	2119298	3
9875	318.33055827250803	309.892592592592	0.6824408689159557	326	2119624	7
9876	318.07466033309504	292.74076433120865	0.42354865074157716	320	2119944	8
9877	316.9962240745917	210.23103448275936	0.32096569779990375	276	2120220	6
9878	317.95894604437206	413.2684210526284	0.2517352833467371	340	2120560	14
9879	316.22613396908736	144.6777385159016	0.16546756225012837	213	2120773	9
9880	316.1662102090143	310.2337579617805	0.22900355380514395	368	2121141	13
9881	316.58954810692416	358.4999999999982	0.20031633182447783	294	2121435	1
9882	315.2853286821929	186.16760563380384	0.19854135131835937	250	2121685	2
9883	315.40509314281127	327.2617747440254	0.47649393389301914	310	2121995	12
9884	314.3792186819714	212.81764705882446	0.21405784900371844	312	2122307	5
9885	316.2196791641908	498.4252669039116	0.3812363822505159	424	2122731	11
9886	317.86776539141675	481.02830188678774	0.3195478026218678	434	2123165	4
9887	318.7277131670558	403.8625429553244	0.25466821187053884	359	2123524	3
9888	320.18105508300425	464.0619047619022	0.34852803047067427	406	2123930	10
9889	317.725022309952	74.5777777777781	0.9365743979429587	156	2124086	12
9890	317.06962715931627	252.185507246377	0.4494155140851767	267	2124353	9
9891	316.03102766191665	213.20967741935533	0.34208667184424213	254	2124607	13
9892	316.6940557311621	382.3338345864635	0.19567409895623994	311	2124918	7
9893	316.2692191493856	274.210397553516	0.3593158540271577	315	2125233	8
9894	316.9648152141195	385.828825622774	0.1452256819781135	340	2125573	6
9895	316.03150693125934	223.63398692810568	0.3584767823578209	279	2125852	1
9896	317.1286539081513	425.74620462046016	0.2460142525520114	362	2126214	14
9897	315.87022451192695	191.28571428571533	0.2359432736859051	229	2126443	3
9898	315.1339247825309	242.2402515723282	0.31396552252175547	281	2126724	11
9899	315.2615334900959	327.8947955390321	0.2535263248747843	326	2127050	4
9900	318.1583733523275	604.9455197132569	0.40498421885056135	437	2127487	2
9901	316.6619038056554	168.5114186851216	0.23964961882560484	217	2127704	13
9902	316.42528115749053	292.99963898916826	0.18917499028199108	282	2127986	10
9903	314.53838257789056	127.73542319749276	0.2294440636268029	195	2128181	1
9904	314.31466023071084	292.16614785992067	0.1266706665950035	268	2128449	7
9905	314.32241773799274	315.0904109589026	0.1800220750442157	307	2128756	12
9906	313.6724668725099	249.32733118971126	0.17454811743704596	271	2129027	8
9907	313.2443410738413	270.85988700564883	0.18303225825008113	313	2129340	9
9908	312.913540760746	280.16430976430905	0.21671482668084613	295	2129635	6
9909	312.94214053100416	315.7735177865601	0.3787901742117746	280	2129915	14
9910	315.9368013174749	612.4082191780749	0.4504491381791789	553	2130468	5
9911	314.5124053322722	173.4972027972038	0.30261784383695417	292	2130760	11
9912	314.1438267334949	277.6545454545442	0.20135801019221006	277	2131037	2
9913	312.95609022054595	195.37017543859744	0.2331753362175877	326	2131363	3
9914	312.4668230477134	264.0293729372927	0.1901432243553368	296	2131659	4
9915	312.2707880218694	292.86332046331927	0.14939572420987215	275	2131934	7
9916	310.54850362919524	140.042348754449	0.538532829284668	200	2132134	14
9917	310.0481173583354	260.50987654320977	0.31979861581252395	326	2132460	10
9918	309.3164464741411	236.88102893890758	0.2248099336656041	299	2132759	1
9919	306.96902913583654	74.57471264367882	0.14906016463938826	259	2133018	12
9920	308.3310531301924	443.1714285714252	0.1561542975666165	353	2133371	13
9921	308.5377425988904	328.9999999999979	0.26897109442158423	309	2133680	8
9922	308.46918870231326	301.6823529411758	0.6794876151068514	291	2133971	9
9923	308.35910162628664	297.46048109965506	0.20042602908652546	289	2134260	6
9924	305.43267030584127	15.715969581748984	0.06326805662225794	108	2134368	12
9925	304.5137272505816	213.53836477987525	0.2582596092893366	285	2134653	11
9926	303.0886704378459	162.00804597701193	0.1829790937791177	218	2134871	13
9927	302.315381003092	225.75972696245836	0.6184422639425328	267	2135138	7
9928	302.68252089935476	339.0293706293694	0.1897352793860057	315	2135453	4
9929	303.96624114490663	431.05454545454205	0.21828485160805394	343	2135796	3
9930	305.8563996289799	492.98208955223384	0.27488785731939624	405	2136201	5
9931	305.31352577353516	251.5690140845081	0.15419714585790095	265	2136466	1
9932	306.36574446768986	410.5353951890012	0.1542436911458784	361	2136827	2
9933	306.01112024560433	270.90332225913573	0.13709404809134348	280	2137107	14
9934	305.6873120734513	273.6303030303024	0.22962782407376547	293	2137400	10
9935	305.65552556689005	302.5086614173221	0.12714790534294373	281	2137681	8
9936	305.5154297706806	291.64594594594513	0.22016621942389503	292	2137973	6
9937	305.73914033783865	327.88648648648535	0.1969921738354128	335	2138308	9
9938	306.5780370700534	389.62881355931955	0.28774230059455425	340	2138648	12
9939	305.22834220121166	171.60855018587426	0.32928131244800707	216	2138864	2
9940	303.5429941404163	136.6935361216736	0.25363836238521553	191	2139055	8
9941	303.5138098130472	300.62456140350696	0.21200375376698077	291	2139346	13
9942	302.91591744870516	243.7245733788407	0.4312134676201399	258	2139604	1
9943	302.5775368209309	269.07785467127934	0.3098702229244608	284	2139888	3
9944	302.2993019932621	274.7540540540534	0.1725281885225479	292	2140180	4
9945	301.79597664704545	251.9667673716019	0.18060997035676632	289	2140469	7
9946	302.6434411229992	386.5424242424229	0.29770049643009266	376	2140845	11
9947	302.3234587665637	270.64520547945096	0.20452057614045985	272	2141117	10
9948	302.57722417889806	327.6999999999976	0.23347930434327688	322	2141439	5
9949	303.23619106754387	368.4739130434765	0.26456683022635324	336	2141775	14
9950	303.87779156288343	367.3962406015013	0.24111815421811997	310	2142085	6
9951	302.34818536442634	150.91717171717238	0.20688393265728788	207	2142292	2
9952	301.07933987441845	175.46363636363688	0.25215913699223447	208	2142500	8
9953	300.76790536069166	269.93588850173984	0.32638662747386	331	2142831	9
9954	299.54622630708474	178.60000000000056	0.14582019680542566	213	2143044	5
9955	299.7423085279996	319.15444839857537	0.2003242234052238	295	2143339	1
9956	301.1403989562331	439.55135135134907	0.36641591251383687	367	2143706	12
9957	301.16789048905883	303.8895522388043	0.3345839476670235	281	2143987	7
9958	301.4573338863265	330.1122302158256	0.1752525200278072	295	2144282	4
9959	301.74086885071233	329.8108303249075	0.18464836047010022	311	2144593	3
9960	301.14842479243026	242.49646302250872	0.33088653564453124	275	2144868	10
9961	302.64338538436357	450.6444839857624	0.2483991747317107	368	2145236	13
9962	302.44589355950546	282.8942028985495	0.18807519232476508	286	2145522	14
9963	300.20787823293296	78.64436090225618	0.19887610987613075	190	2145712	9
9964	300.66632326012746	346.0523809523789	0.19233879001661278	348	2146060	11
9965	301.6336140911304	397.3954063604225	0.252103464944022	336	2146396	6
9966	301.8904982892021	327.32203389830323	0.22646384403623385	319	2146715	2
9967	301.8607611895218	298.9167883211673	0.32030102133390764	331	2147046	8
9968	300.1592206917205	131.70671140939652	0.3655179738998413	192	2147238	4
9969	299.8120173736922	265.4388888888885	0.13081131754694758	296	2147534	5
9970	299.20608238514046	239.21851851851991	0.2767907234087382	292	2147826	1
9971	298.3022279104954	208.8206349206355	0.19561377305250902	260	2148086	10
9972	298.2748722980571	295.5666666666655	0.23506021807270666	310	2148396	12
9973	298.91094710448834	361.88235294117527	0.25178860706888184	314	2148710	3
9974	299.9369804905863	401.5142857142831	0.32833817557505496	341	2149051	7
9975	300.3746794142027	343.7068728522315	0.21514221102173564	342	2149393	13
9976	299.97006548719355	259.91328671328597	0.14624177739861305	267	2149660	6
9977	301.2822865405066	431.192170818503	0.30425909528759626	349	2150009	9
9978	302.09976718947854	383.03035143769785	0.3408406360001214	354	2150363	14
9979	300.06498004389954	98.62105263157942	0.19244551295556392	197	2150560	5
9980	299.28648175861207	222.21515151515257	0.23353540080867402	292	2150852	4
9981	300.7567934116142	446.3176470588215	0.2067896236072887	352	2151204	2
9982	300.9592718351139	321.00463576158774	0.20113230326089515	332	2151536	8
9983	298.61746649217804	66.7787375415285	0.726035641401242	195	2151731	7
9984	297.19085520753794	155.95633802816965	0.13888185501098632	200	2151931	6
9985	297.26672652967636	304.777987421382	0.22496689422221122	316	2152247	1
9986	297.8640592643796	356.99999999999824	0.3615565361277916	389	2152636	12
9987	301.3887837511008	650.3365079364996	0.388614501953125	575	2153211	11
9988	299.11642298940205	74.15270758122773	0.702559232711792	160	2153371	2
9989	298.6099990192483	248.47402597402726	0.22534302203324588	274	2153645	9
9990	298.90538407888965	328.14850498338734	0.3770041927214592	372	2154017	3
9991	298.28224381834764	236.5913580246929	0.4506684152703536	380	2154397	10
9992	299.12900532177	382.95839416058277	0.24583680123993845	330	2154727	13
9993	298.5604412959496	242.27260273972678	0.2730875377413593	316	2155043	14
9994	298.9880598795058	341.322299651566	0.2853756558363605	314	2155357	5
9995	296.68233512486654	68.41558441558468	1.0159543595224056	159	2155516	11
9996	297.8695117736179	415.39999999999696	0.19835437277088994	345	2155861	4
9997	296.14017282026526	124.9356164383567	0.1904242089454164	188	2156049	12
9998	296.263454886529	308.4683794466392	0.1775238983822565	274	2156323	1
9999	297.3545360567272	405.37157190635253	0.2292739232381185	360	2156683	8
10000	298.8020125939701	442.1021897810199	0.18322707152300227	359	2157042	7
10001	297.19581881533577	138.18263473053946	0.17687109404919193	204	2157246	9
10002	297.01542800306896	279.1567375886515	0.2864909520963343	328	2157574	6
10003	295.3072002767106	126.19265536723213	0.4218247793253186	206	2157780	10
10004	294.84743120553964	249.33029315961053	0.29412140986041835	307	2158087	2
10005	294.7825932571206	288.3636363636346	0.20358050766811575	279	2158366	14
10006	293.250814943597	141.60476190476248	0.1791335379723275	202	2158568	4
10007	293.0690126765139	275.0705882352936	0.3230622150145556	263	2158831	5
10008	291.5621656870037	142.38431372549064	0.22429187962266264	183	2159014	8
10009	292.3503667726086	370.38227424749044	0.48966480277435126	342	2159356	13
10010	290.33623917325855	90.9376068376072	0.1810910671572142	158	2159514	10
10011	289.32511604532965	189.22392638036865	0.39733403123269867	254	2159768	11
10012	288.3833410753525	195.1476190476196	0.5067133542870274	238	2160006	12
10013	288.15417433126566	265.46666666666624	0.24285735207042475	261	2160267	6
10014	288.0808842886333	280.82517006802624	0.2095783233642578	320	2160587	1
10015	288.4791153128566	327.90398671096193	0.30917616014356736	308	2160895	9
10016	288.0246574930614	243.0333333333346	1.0110082523056747	277	2161172	2
10017	290.1085537752736	496.4142857142812	0.3629183477284957	392	2161564	7
10018	288.6213714633273	141.39032258064572	0.2627343071831597	198	2161762	12
10019	288.3193006058369	258.4142857142854	0.433415693395278	272	2162034	4
10020	287.8141688242683	237.8061224489802	0.27760367845966866	274	2162308	14
10021	293.54279636679473	860.6769230769164	0.815414306248746	623	2162931	3
10022	293.7626058131987	315.52374100719277	0.1648235256824429	297	2163228	8
10023	291.57207066415765	74.7090909090912	0.6192201412982822	161	2163389	1
10024	289.9221439774496	126.57940199335596	0.19292989877554087	195	2163584	6
10025	289.8911065867548	286.818404907974	0.1885416143779814	321	2163905	10
10026	291.06979767142485	407.760215053761	0.41857623475970646	330	2164235	11
10027	293.2362901709011	507.71904761904534	0.23598955624067602	398	2164633	5
10028	291.1411015811187	83.71743119266094	0.11190805937114515	171	2164804	3
10029	294.7212199770721	649.1529411764645	0.1923982720626028	456	2165260	13
10030	295.40852822339804	363.4520446096636	0.4232669017353996	305	2165565	9
10031	295.4561144740108	300.1671532846709	0.47485362384336216	282	2165847	4
10032	294.54158149828476	204.00281690140923	0.3907586556893808	297	2166144	2
10033	294.1750480362431	257.8882352941173	0.33367445744366286	251	2166395	1
10034	294.246630889214	301.3333333333318	0.2910933539411491	319	2166714	12
10035	295.61497925213644	431.0814671814632	0.28768499162462025	360	2167074	14
10036	297.84653960454256	518.7710144927512	0.3398227545306506	391	2167465	7
10037	297.71087044674164	284.27962382445077	0.2594920679466012	291	2167756	10
10038	298.1252447354715	339.14829931972633	0.2788372463650174	315	2168071	11
10039	298.96262316059995	381.8630872483195	0.24023527018229165	375	2168446	6
10040	302.06884767526253	609.5850746268594	0.7948890316018331	433	2168879	8
10041	303.3658133338482	431.76541353383107	0.37008860507442376	343	2169222	5
10042	301.94625943503746	161.4104234527695	0.2022317220149428	209	2169431	4
10043	300.10409095833415	117.72941176470633	0.27699883429558725	182	2169613	12
10044	300.23367299957044	313.062295081966	0.4193544541141228	311	2169924	13
10045	300.3234853378977	309.21490683229626	0.1205180850191382	323	2170247	3
10046	298.3158536591219	99.56031746031793	0.28098605723863235	178	2170425	7
10047	297.65705724877654	232.43621262458595	0.3738041354301281	266	2170691	1
10048	295.9193102057005	123.88235294117698	0.10019559958546433	194	2170885	10
10049	297.3180525875145	435.79354838709463	0.27104003746889277	383	2171268	9
10050	297.5413905801579	319.6518518518511	0.2083908271195361	321	2171589	2
10051	297.51072992110954	294.4753246753241	0.22470341172329214	301	2171890	14
10052	295.3882957736494	85.26731517509762	1.1147261028048359	158	2172048	1
10053	295.113618295365	267.9205479452044	0.3069802338222288	265	2172313	6
10054	294.88600090940383	272.3518796992468	0.36619141919031584	283	2172596	8
10055	293.95828420249046	202.11433021806948	0.36478563338991193	252	2172848	12
10056	292.4268629766272	140.81616161616225	0.15696922707672856	207	2173055	7
10057	292.6113914483102	310.8797101449262	0.1569134995744035	296	2173351	4
10058	292.5429728980655	285.76953642383995	0.16958790955227843	287	2173638	5
10059	290.43822090994865	82.06777408637913	0.17986773899623326	175	2173813	9
10060	289.3683590260524	183.45203252032573	0.1573025756681026	197	2174010	10
10061	288.8014254357919	232.67500000000092	0.37259788800002935	266	2174276	13
10062	291.43547167965454	552.2060498220603	0.3415031433105469	420	2174696	11
10063	289.9362372377721	141.51202749140947	0.16989509544180864	199	2174895	14
10064	290.82498874439796	378.811387900354	0.23081432331276502	339	2175234	3
10065	290.71310674993055	279.6367892976575	0.25148792693409294	313	2175547	2
10066	289.310392656601	150.44169741697473	0.13152234752972922	192	2175739	10
10067	287.924499086022	150.72103559870618	0.1187417034941595	207	2175946	5
10068	287.399984634084	235.47305389221685	0.6735667567099294	279	2176225	1
10069	287.0624404839457	253.64556962025387	0.2557055018708697	279	2176504	12
10070	288.1961494124395	400.4333333333305	0.41844916925197695	328	2176832	6
10071	288.1294537410999	281.52658227848053	0.29058192738315514	285	2177117	4
10072	288.7236108165921	347.545161290321	0.19769830414743134	330	2177447	8
10073	289.1146077181349	327.82330097087186	0.25844427724234975	313	2177760	13
10074	286.96612201831203	74.26603773584944	0.09586031642960913	162	2177922	10
10075	287.101871757033	300.5410958904078	1.414027214050293	384	2178306	7
10076	286.5707562652691	233.99032258064574	0.23126324485330021	272	2178578	3
10077	286.9930643765976	328.801567398118	0.2163514970224115	316	2178894	11
10078	288.78986032459187	466.6726591760273	0.25562408099486955	351	2179245	14
10079	287.27592759165316	137.39658703071734	0.1098133282783704	195	2179440	12
10080	286.487830653399	208.4662337662348	0.2615557776557075	252	2179692	5
10081	292.4289820866419	880.6029739776875	0.4379401113472733	561	2180253	9
10082	291.9933745762448	248.868231046932	0.6501591599832369	254	2180507	8
10083	292.20470701753266	313.1266187050346	0.38999767638089367	285	2180792	6
10084	294.0863276789867	480.36677316293634	0.35011492177807074	403	2181195	2
10085	293.78368077646587	263.8216374268998	0.15888331953886967	314	2181509	4
10086	292.9859072598405	214.0063291139253	0.3733378034649473	264	2181773	10
10087	295.4834236385056	542.7375451263493	0.2267540522984096	420	2182193	1
10088	297.13426682147536	460.56774193548233	0.19022942129680862	353	2182546	13
10089	297.94879827913473	378.5874125874112	0.21078482208702065	339	2182885	11
10090	296.38512137126196	141.5811074918578	0.0662800689036235	277	2183162	14
10091	296.3448491049177	292.35789473684065	0.3282367752259036	332	2183494	3
10092	296.5209327776112	313.953216374268	0.2975196050683306	339	2183833	7
10093	294.9923765110596	143.66530612244938	0.13950116084172176	195	2184028	9
10094	293.09891093992894	105.64581939799388	0.19758451249864367	180	2184208	8
10095	292.7901385487959	262.221671826625	0.2814960546194469	287	2184495	12
10096	291.0543757771693	119.21386138613921	0.16139201426135444	193	2184688	2
10097	292.1244013624633	398.05693430656805	0.3088752863957332	325	2185013	5
10098	290.0277415782293	82.45842293906854	0.08994458230693689	178	2185191	10
10099	290.81375676694864	368.6292604501582	0.3524555987622364	332	2185523	6
10100	289.7444275825127	183.88083832335423	0.27210259437561035	256	2185779	1
10101	288.33129007959593	148.43067729083717	0.24811840057373047	188	2185967	12
10102	286.892028134214	144.4050955414019	0.2154753264657694	211	2186178	11
10103	288.7162594774206	469.3151624548699	0.29518097771538626	360	2186538	4
10104	287.6965448464473	186.74479638009137	0.2947534552202538	213	2186751	10
10105	287.84294781903543	302.33684210526155	0.32274376785995174	298	2187049	3
10106	288.6580010994657	369.34827586206586	0.39503914328182443	340	2187389	13
10107	289.2215451760623	345.01240875912305	0.21073564306482093	308	2187697	8
10108	290.22461785989486	389.5288135593197	0.3899042571395024	341	2188038	9
10109	290.8914710601779	356.9099378881951	0.19407445734197443	374	2188412	14
10110	291.6361875552498	365.3631205673745	0.18816480426006138	317	2188729	5
10111	293.31622190611233	459.63962264150547	0.4904330920621839	346	2189075	2
10112	295.5340922603411	515.1032573289868	0.21255849080793024	418	2189493	7
10113	293.95071720804486	137.19658703071735	0.10172397594161445	197	2189690	3
10114	293.6252219054006	261.40118694361973	0.30656141469909876	293	2189983	1
10115	294.5110452877212	382.20756013745506	0.4366583069758629	335	2190318	12
10116	295.58879642653943	402.2861591695485	0.37187503633045016	336	2190654	4
10117	293.83276560513116	119.98571428571478	0.13695271809895834	192	2190846	2
10118	293.7043260609679	280.9888111888098	0.19708642294240553	301	2191147	13
10119	294.97955609228364	421.22732919254247	0.49728050929136747	383	2191530	11
10120	295.95207968029695	392.2319148936152	0.4600461017654603	332	2191862	10
10121	297.91791520533303	492.53563218390394	0.5309481211316223	361	2192223	8
10122	295.99003249596745	105.12964426877505	1.075344989754561	173	2192396	1
10123	297.427657718453	439.75255474452393	0.26150629561760524	346	2192742	9
10124	297.1491596879813	269.5778546712793	0.16747445273997535	279	2193021	7
10125	297.9513630063557	377.36949152542144	0.2089150338362481	327	2193348	5
10126	299.4370258468804	446.5176470588215	0.3182195390973772	350	2193698	14
10127	305.6272642840637	918.4608695652129	0.27024314790914206	597	2194295	6
10128	303.48974573958367	91.87540983606614	0.24910896496895032	195	2194490	13
10129	304.53483797290943	407.99896907216254	0.18497102910822089	352	2194842	3
10130	303.9940423088353	250.45527156549645	0.2288832838517906	274	2195116	2
10131	305.07064034728535	411.6538461538441	0.20084117179693178	344	2195460	12
10132	303.52836030040163	150.84263565891533	0.19251473095952248	196	2195656	9
10133	301.4261878085087	93.31111111111156	0.06856106903593419	177	2195833	5
10134	301.7557592637569	334.3833333333322	0.32898119042482094	301	2196134	11
10135	302.7842241430294	404.602247191009	0.2542782683870686	335	2196469	4
10136	302.4753819015991	271.89999999999935	0.19041926520211355	280	2196749	8
10137	303.2748732933111	382.42452107279433	0.39418229757890405	351	2197100	10
10138	302.59709397933824	235.49694189602582	0.35515987089950674	274	2197374	7
10139	301.0427897062115	147.16666666666723	0.10258673638412633	194	2197568	3
10140	301.6453798596909	361.3018050541492	0.22190326916465877	321	2197889	14
10141	301.68940778866875	306.04817275747405	0.14307045450015943	294	2198183	13
10142	300.2545678624066	158.20541516245544	0.31081792470571157	222	2198405	2
10143	298.572868899111	132.08467153284738	0.6094194746695424	211	2198616	9
10144	296.42496571347556	83.78255033557112	0.08139113568245096	235	2198851	8
10145	297.50108642671114	404.03703703703417	0.4703067211394614	329	2199180	5
10146	298.60188378162206	407.58082191780613	0.6279466019347966	341	2199521	12
10147	303.40462214545187	778.8757201646048	0.6536009808571344	523	2200044	6
10148	304.20420679648055	383.36308724831986	0.40228568183051217	360	2200404	11
10149	307.9562041550389	679.4039426523191	0.5723284140400503	696	2201100	1
10150	308.7087262885727	383.20841750841475	0.4124197262769554	342	2201442	14
10151	311.6396390256869	601.7999999999948	0.5607729334841152	481	2201923	4
10152	309.9217839888135	139.85413533834665	0.9353175712620607	217	2202140	5
10153	311.6808045595214	485.8238410595994	0.5988147697826424	505	2202645	10
10154	314.81690488045996	625.2908366533818	0.7572808238123193	519	2203164	7
10155	318.66628128620073	699.7545454545391	0.6783706932737116	456	2203620	2
10156	321.54150082627984	606.1882352941109	0.49609469262789574	518	2204138	3
10157	322.44945869937294	412.33728813558935	0.4420334300356048	418	2204556	8
10158	322.09409861530315	286.91345029239665	0.2781332599627859	317	2204873	11
10159	326.3901028346295	751.6945205479362	0.4588434759176002	530	2205403	9
10160	326.1302927153741	300.4090909090909	0.8139878830107132	404	2205807	6
10161	324.82146263167084	195.24728434504888	0.2928217245763042	251	2206058	4
10162	327.9816806294675	640.8432624113431	0.29859995740525264	470	2206528	12
10163	331.93908604539496	723.722222222212	0.4056489189661587	609	2207137	13
10164	331.872786688209	325.3091503267961	0.36028886770273183	308	2207445	14
10165	331.3370318852999	278.29730639730576	0.1742729459490095	280	2207725	5
10166	330.17848199988345	215.48204334365448	0.3653296371986126	290	2208015	7
10167	328.56491669207975	168.82195121951307	0.25711869101487955	262	2208277	8
10168	329.21212959412446	393.28620689654844	0.2932504575852065	342	2208619	2
10169	332.0152305204054	609.5222222222153	0.4542043232870197	501	2209120	1
10170	333.9555226596458	526.0444444444404	0.3008609621959801	433	2209553	10
10171	334.59530076638265	397.93333333333015	0.22705019769857693	353	2209906	3
10172	333.4663477587188	221.7000000000012	0.2552444241571088	282	2210188	9
10173	334.5742190796664	444.25347985347736	0.20358482683208626	355	2210543	11
10174	334.404848981893	317.6372093023242	0.5620620580348171	311	2210854	6
10175	333.3983020997911	233.7501607717048	0.2823518165072104	266	2211120	14
10176	334.3081372606114	424.38181818181465	0.4172366450731408	337	2211457	4
10177	334.32352527576035	335.8469387755088	0.4345526239674562	314	2211771	13
10178	335.981650447031	500.1360424028245	0.5294619645222579	404	2212175	12
10179	336.30439304799194	368.25591054312935	0.33892070480257447	342	2212517	5
10180	335.51424555764146	257.28964401294434	0.3828095763269132	274	2212791	8
10181	332.82102091028423	66.1917808219181	1.2475105141693692	159	2212950	13
10182	332.21922367046466	272.64129692832677	0.286532719930013	276	2213226	10
10183	332.2812476499762	338.42162162162	0.34102526892348	331	2213557	1
10184	333.4120213803729	445.35862068965105	0.42729362917329927	373	2213930	7
10185	333.1063297379977	302.8428571428561	0.6002853080017926	292	2214222	9
10186	332.0614714879364	228.62050473186218	0.31607283407182835	268	2214490	6
10187	332.03189690683627	329.1040133779252	0.24612345695495605	320	2214810	3
10188	330.00891622773077	129.73382899628348	0.27109057640394785	263	2215073	4
10189	332.57235494649433	586.3527881040847	0.2484424536308033	418	2215491	2
10190	332.95257972529686	370.5948328267457	0.891449224753458	366	2215857	11
10191	330.6936595618467	107.0605633802822	0.2635717781222596	196	2216053	9
10192	330.7822131623066	339.5490196078417	0.4418230143723879	329	2216382	12
10193	328.644436485229	117.00454545454606	0.15044349566843715	221	2216603	13
10194	328.8772824429573	351.92903225806367	0.35402509684452926	391	2216994	8
10195	334.95453795860857	936.6028340080852	0.4437520676764889	552	2217546	14
10196	333.0026688380153	139.7676258992814	0.4868227541446686	256	2217802	2
10197	333.2025051633338	352.9863013698611	0.5804910575394082	339	2218141	1
10198	334.22013660025004	434.96564885496025	0.22565903774527615	344	2218485	7
10199	331.63593523424754	75.80000000000058	0.14791684922340995	241	2218726	11
10200	332.60234559799335	428.2769716088284	0.3543805010907062	385	2219111	10
10201	332.65593141353656	337.9609271523165	0.20572876348728086	328	2219439	4
10202	336.08209817200844	675.2726072607226	0.26190293893306216	507	2219946	5
10203	337.3562771902883	463.499999999998	0.13021232269622468	364	2220310	3
10204	334.9282410641535	94.55266457680297	0.1071109142932263	182	2220492	13
10205	332.957881730435	137.89230769230812	0.1436016837957547	197	2220689	12
10206	329.6917574585852	6.345454545454574	0.06624024591328186	81	2220770	14
10207	326.427006550666	3.21666666666669	0.11177878312661614	71	2220841	1
10208	326.58101963928124	341.8283154121845	0.3153589549817537	380	2221221	6
10209	323.336802035481	2.1592592592592763	0.11083849498203822	70	2221291	7
10210	320.15789105979974	5.4457044673539805	0.12081155544374048	82	2221373	2
10211	316.97375659364616	1.744444444444453	0.022307603966956045	51	2221424	11
10212	313.8191331216694	1.5114093959731618	0.04410483322891535	51	2221475	10
10213	310.69961316854454	1.8671378091872874	0.10137463550941617	51	2221526	4
10214	307.89308061301807	30.046357615893932	0.07506791196128194	129	2221655	8
10215	304.82625237099046	1.2102564102564166	0.07578309377034505	51	2221706	5
10216	301.7992499205406	2.1260073260073358	0.22758179084927427	51	2221757	3
10217	298.80145958740013	2.020216606498204	0.1591173059800092	51	2221808	13
10218	295.8328735629547	1.9428571428571524	0.10854829526415058	51	2221859	12
10219	292.89474699339013	2.020216606498204	0.0922400904636757	51	2221910	14
10220	289.97810820512825	1.230868167202578	0.03944944867900774	51	2221961	1
10221	289.18369749344737	210.53703703703783	0.148329546957305	264	2222225	9
10222	286.3100359571094	1.8175438596491311	0.02856165287541408	51	2222276	6
10223	283.46227566487835	1.5340067340067418	0.06519909933501598	51	2222327	7
10224	280.6439122938951	1.6259385665529091	0.10032024570539885	51	2222378	2
10225	277.8544386881975	1.6965517241379384	0.07382773885539934	51	2222429	11
10226	275.08395436137556	0.8060060060060101	0.017237774297302843	51	2222480	10
10227	272.3538420904891	2.072727272727282	0.048581866657032687	51	2222531	4
10228	269.64022317422814	0.9919504643962901	0.030084689458211262	51	2222582	8
10229	266.9569675222904	1.3146579804560328	0.03854511765872731	51	2222633	5
10230	264.3078616151834	2.0463768115942127	0.03159709771474203	51	2222684	3
10231	261.67835676952336	1.3573770491803345	0.02391978104909261	51	2222735	12
10232	259.08049518764375	1.892198581560292	0.030882781627131442	51	2222786	13
10233	256.51176430984134	2.207407407407418	0.056980128381766526	51	2222837	1
10234	253.97127501923336	2.462835249042157	0.04269275478288239	51	2222888	9
10235	251.4469023363811	1.5340067340067418	0.01981991646336574	51	2222939	14
10236	248.9506087516138	1.8175438596491311	0.021798063726986155	51	2222990	7
10237	246.46640925435554	0.5306590257879692	-0.006441481557546877	51	2223041	6
10238	244.01405384348402	1.230868167202578	-0.012771957060870002	51	2223092	2
10239	241.58684836998427	1.2935064935064995	-0.007199062436234718	51	2223143	11
10240	239.18654745385197	1.5567567567567644	0.014693298760582419	51	2223194	10
10241	236.80825574980526	1.3573770491803345	0.02411335356095258	51	2223245	4
10242	234.4555132596473	1.5340067340067418	0.025693383871340285	51	2223296	8
10243	232.13800951045002	2.705138339920961	0.029442639911876005	51	2223347	3
10244	229.83815882711022	2.152941176470598	0.040922323862711586	51	2223398	5
10245	227.5516750024174	1.189776357827482	0.01804184679891549	51	2223449	12
10246	225.2945807876045	1.8422535211267697	0.015161619466893813	51	2223500	14
10247	223.0531270432205	1.1492063492063544	0.007973885419321996	51	2223551	13
10248	220.8301195823121	0.7523809523809567	0.025135108068877577	51	2223602	9
10249	218.62647561028504	0.46572237960340224	0.041524527119655236	51	2223653	1
10250	216.46396842993977	2.375757575757587	0.006965909518447577	51	2223704	7
10251	214.3155881313059	1.6259385665529091	0.0049993039346208756	51	2223755	6
10252	212.18709891665952	1.466666666666674	0.0496220588684082	51	2223806	2
10253	210.08569169560886	2.0463768115942127	0.0865631010018143	51	2223857	11
10254	208.01513930540173	3.030452674897133	0.07991237266390931	51	2223908	3
10255	205.94943309507195	1.444518272425256	0.08141955207375919	51	2223959	8
10256	203.90204132822382	1.2102564102564166	0.08231290181477864	51	2224010	4
10257	201.87491867851986	1.189776357827482	0.01957128445307414	51	2224061	10
10258	199.87935746165945	2.318796992481214	0.05893888660505706	51	2224112	5
10259	197.9060832668878	2.5519379844961354	0.007643991241268083	51	2224163	14
10260	195.9377183589838	1.0695924764890332	0.0021950473972395354	51	2224214	12
10261	193.99726316120956	1.892198581560292	-0.00440294251722448	51	2224265	13
10262	192.07425604683883	1.6965517241379384	0.012857023407431209	51	2224316	9
10263	190.1668729634946	1.335947712418307	-0.010405224912306842	51	2224367	1
10264	188.2826486783041	1.744444444444453	-0.008723984746371998	51	2224418	6
10265	186.40681924166856	0.699705014749266	0.00749432690003339	51	2224469	7
10266	184.56269349529504	1.9942446043165556	0.03464817767049752	51	2224520	2
10267	182.7328631705116	1.5796610169491596	0.04376513817731072	51	2224571	11
10268	180.9252191266201	1.9684587813620165	0.033642969879449584	51	2224622	8
10269	179.13389700528396	1.7930069930070016	0.044562124738506244	51	2224673	3
10270	177.3705580352311	2.800000000000013	0.033030374377381565	51	2224724	10
10271	175.6036759842906	0.6823529411764748	0.0222622833999933	51	2224775	4
10272	173.8641323751326	1.6493150684931583	0.01443171734903373	51	2224826	14
10273	172.13738881495956	1.189776357827482	0.00507816613889208	51	2224877	5
10274	170.43518930403417	1.9174377224199382	0.014895790932225246	51	2224928	12
10275	168.75665842266696	2.582101167315187	0.015807626294154747	51	2224979	13
10276	167.08309843910035	1.4006600660066075	0.011176014647764318	51	2225030	9
10277	165.426934121376	1.466666666666674	0.020124968360452092	51	2225081	1
10278	163.78001196117114	0.7347181008902116	0.001033526717447767	51	2225132	6
10279	162.1575519088995	1.5340067340067418	0.00849076228983262	51	2225183	7
10280	160.55064305647718	1.466666666666674	0.0047507692201464785	51	2225234	2
10281	158.96612932664232	2.0992700729927103	0.0031640120581084607	51	2225285	11
10282	157.3979974451406	2.152941176470598	0.011058678814009125	51	2225336	8
10283	155.84581820869656	2.180073800738018	0.011291377684649299	51	2225387	3
10284	154.29845150925942	1.1091482649842326	0.003466447486596949	51	2225438	10
10285	152.77540944020998	1.9942446043165556	0.01589310519835528	51	2225489	4
10286	151.26632672389977	1.8671378091872874	0.02142029650071088	51	2225540	12
10287	149.777135154774	2.3471698113207657	0.009006485635159062	51	2225591	13
10288	148.28986380322624	1.0500000000000052	0.0037060526071810256	51	2225642	14
10289	146.81520612904941	0.8240963855421735	0.0028974402184579885	51	2225693	5
10290	145.36331345342447	1.6259385665529091	0.012024410799437878	51	2225744	9
10291	143.9243469855569	1.466666666666674	0.007729662984025245	51	2225795	1
10292	142.4972060798039	1.2102564102564166	0.011520067850748697	51	2225846	6
10293	141.07975782852967	0.7523809523809567	0.007110897816863714	51	2225897	7
10294	139.6899529509743	2.0992700729927103	0.015639676767237046	51	2225948	11
10295	138.30727858702747	1.4225165562913977	0.02135929640601663	51	2225999	2
10296	136.9390954332642	1.488963210702348	0.009991664512484682	51	2226050	8
10297	135.57776453899163	0.8060060060060101	-0.0007541340355779611	51	2226101	3
10298	134.23943133804616	1.744444444444453	0.02005455774419448	51	2226152	10
10299	132.91829709792577	2.1260073260073358	0.02229662970000622	51	2226203	4
10300	131.61493513861967	2.582101167315187	0.03485997751647351	51	2226254	13
10301	130.30509482513435	0.630903790087467	0.03373921618742101	51	2226305	12
10302	129.02198632292615	1.9942446043165556	0.03904893819023581	51	2226356	14
10303	127.74873197693826	1.6965517241379384	0.025388168353660433	51	2226407	9
10304	126.48681222473645	1.5567567567567644	0.046256023294785446	51	2226458	5
10305	125.24627998035169	2.4335877862595536	0.010093166547663072	51	2226509	1
10306	124.00530924404022	1.1492063492063544	0.002095649055406159	51	2226560	6
10307	122.77735871570238	1.2102564102564166	-0.005602684675478468	51	2226611	11
10308	121.56492519588541	1.5340067340067418	0.0008156501195010017	51	2226662	7
10309	120.36200086302041	1.2724919093851197	0.012215439011068904	51	2226713	2
10310	119.18902548248937	3.0644628099173685	0.04743298829770556	51	2226764	3
10311	118.02418661106368	2.705138339920961	0.026044897004669786	51	2226815	8
10312	116.86337331638163	1.9428571428571524	0.027762363938724294	51	2226866	10
10313	115.70985367717755	1.5114093959731618	0.01909833679012224	51	2226917	13
10314	114.57192951762998	1.9174377224199382	0.013411793054318895	51	2226968	14
10315	113.43978399294548	1.3573770491803345	0.009577441449258841	51	2227019	12
10316	112.3211827631855	1.5796610169491596	0.011330447944940305	51	2227070	4
10317	111.2124161182779	1.444518272425256	0.0036047083490035113	51	2227121	9
10318	110.1226413994743	2.234944237918226	0.03025225097057866	51	2227172	1
10319	109.03191498547956	1.0500000000000052	0.004606840657252891	51	2227223	5
10320	107.9564854677318	1.488963210702348	0.02399110092836268	51	2227274	11
10321	106.90010858297929	2.318796992481214	0.02986624895357618	51	2227325	2
10322	105.84644756448955	1.5340067340067418	0.018810082884395823	51	2227376	6
10323	104.80177256252887	1.3789473684210587	0.0311509090311387	51	2227427	7
10324	103.77666120394478	2.2906367041198603	0.027774806116141526	51	2227478	3
10325	102.76411466912542	2.5220077220077335	-0.00871997312003491	51	2227529	8
10326	101.75204109000174	1.5567567567567644	0.009152524611529182	51	2227580	10
10327	100.75770864902653	2.318796992481214	0.007218142934873992	51	2227631	13
10328	99.76806163246633	1.7930069930070016	0.005013700793771183	51	2227682	12
10329	98.78395478663347	1.3573770491803345	0.006214708674187754	51	2227733	14
10330	97.80780950628306	1.1694267515923626	0.012722078491659725	51	2227784	4
10331	96.84552802138973	1.5796610169491596	0.02503039790134804	51	2227835	1
10332	95.89624711840003	1.9174377224199382	0.009872275240281048	51	2227886	5
10333	94.94663434046757	0.9349693251533792	0.002804348866144816	51	2227937	9
10334	94.01659656849147	1.9428571428571524	0.008362992137086158	51	2227988	11
10335	93.10076648066915	2.4335877862595536	0.0056380880813972625	51	2228039	2
10336	92.17873442561856	0.8975609756097607	0.0005755225817362467	51	2228090	7
10337	91.26725237731253	1.0305295950155813	0.008686039962020576	51	2228141	6
10338	90.37130837587617	1.6728522336769833	0.010491541787689808	51	2228192	3
10339	89.48182045768033	1.4225165562913977	0.008890818147098316	51	2228243	8
10340	88.60962911877516	2.26268656716419	0.03669596653358609	51	2228294	10
10341	87.73732230127162	1.3789473684210587	0.033103416947757494	51	2228345	13
10342	86.88285544530011	2.2906367041198603	0.04146871379777497	51	2228396	14
10343	86.02612945494967	1.2102564102564166	0.050520803414139094	51	2228447	12
10344	85.1830723126493	1.7204152249135034	0.04105158880645154	51	2228498	4
10345	84.34820710676418	1.6965517241379384	0.0018497804800669353	51	2228549	1
10346	83.5133310963026	0.860606060606065	0.007007011011535046	51	2228600	5
10347	82.68625784539962	0.8060060060060101	0.007361443019380756	51	2228651	9
10348	81.8801225396729	2.072727272727282	0.006099675215926825	51	2228702	11
10349	81.0762109463832	1.488963210702348	0.0010785553969588934	51	2228753	2
10350	80.28033846902639	1.488963210702348	0.05481408624088063	51	2228804	7
10351	79.49721967214974	1.9684587813620165	0.054678608389461744	51	2228855	6
10352	78.7166926581525	1.444518272425256	0.10234767315434475	51	2228906	3
10353	77.94061721422082	1.1091482649842326	0.07665653789744657	51	2228957	8
10354	77.18038541930282	1.9174377224199382	0.03375868236317354	51	2229008	13
10355	76.42507471579474	1.6493150684931583	0.022594185436473173	51	2229059	12
10356	75.6743977391286	1.3573770491803345	0.02629572737450693	51	2229110	10
10357	74.93461927897869	1.6965517241379384	0.042973836263020836	51	2229161	14
10358	74.19949825175182	1.4225165562913977	0.006831936976488899	51	2229212	4
10359	73.47693184066287	1.9428571428571524	-0.001167629279342352	51	2229263	1
10360	72.75325400490608	1.1091482649842326	-0.00832420879719304	51	2229314	5
10361	72.0403881315237	1.466666666666674	-0.012077834091934503	51	2229365	9
10362	71.33992669625162	1.9942446043165556	-0.003666072499518301	51	2229416	2
10363	70.64699119740506	2.0463768115942127	0.0016692169741088269	51	2229467	11
10364	69.95241904900928	1.189776357827482	0.05628618072060978	51	2229518	7
10365	69.26262325358091	0.9728395061728442	0.0759884609895594	51	2229569	6
10366	68.59234646342428	2.234944237918226	0.09407641840916053	51	2229620	3
10367	67.91189426315785	0.5471264367816123	0.0251924150130328	51	2229671	8
10368	67.24834288809384	1.5567567567567644	0.030164204391778682	51	2229722	13
10369	66.58943322970471	1.3573770491803345	7.374745373632394e-05	51	2229773	10
10370	65.92771867268857	0.4179775280898912	0.008934632820241591	51	2229824	12
10371	65.29134785300289	2.2906367041198603	-0.007692888671276616	51	2229875	4
10372	64.645605972106	0.7171597633136136	0.0005922557092180439	51	2229926	14
10373	64.01564306306987	1.6493150684931583	-0.006918845223445518	51	2229977	1
10374	63.39015329910584	1.466666666666674	0.005351535245483997	51	2230028	5
10375	62.77091843278144	1.466666666666674	0.006568104613061045	51	2230079	9
10376	62.1631516944968	1.9942446043165556	0.01143514642528459	51	2230130	11
10377	61.54834370696359	0.6823529411764748	0.005100642349205765	51	2230181	2
10378	60.94600684969852	1.3146579804560328	0.0007382754017325008	51	2230232	7
10379	60.36719140930071	3.0644628099173685	0.010031645204506669	51	2230283	6
10380	59.77752609586777	1.4006600660066075	0.0031220007176492727	51	2230334	3
10381	59.200478107636364	2.072727272727282	0.021285407683428598	51	2230385	8
10382	58.6328092044226	2.4335877862595536	0.03287829137315937	51	2230436	10
10383	58.065403098193975	1.892198581560292	0.026534227763905245	51	2230487	13
10384	57.49391114672274	0.9162079510703413	0.0238951888738894	51	2230538	12
10385	56.93211861506007	1.3146579804560328	0.025445091958139456	51	2230589	4
10386	56.37615690603365	1.335947712418307	0.06288682713228114	51	2230640	14
10387	55.82231484161727	0.9919504643962901	-0.002940781560598635	51	2230691	1
10388	55.27853687592535	1.444518272425256	-0.000459443120395436	51	2230742	11
10389	54.74979713454252	2.404562737642597	-0.002904423896004172	51	2230793	5
10390	54.22122114901269	1.892198581560292	-0.005644899957320269	51	2230844	9
10391	53.688358630774104	0.9349693251533792	-0.0031545185575298233	51	2230895	2
10392	53.16681511180643	1.5340067340067418	0.05125714283363492	51	2230946	6
10393	52.65003659279539	1.488963210702348	0.06414614004247329	51	2230997	7
10394	52.155569840312815	3.2033613445378304	0.0838928596646178	51	2231048	3
10395	51.645911905487964	1.189776357827482	0.04150532741172641	51	2231099	8
10396	51.139372291077045	0.9919504643962901	0.045501802481857	51	2231150	10
10397	50.6428682002733	1.488963210702348	0.06078645762275247	51	2231201	13
10398	50.15412592942039	1.7686411149825862	-0.0053253267325607005	51	2231252	12
10399	49.68288919687515	3.030452674897133	-0.003916519821858874	51	2231303	4
10400	49.20840974728558	2.234944237918226	-0.00048721479434593053	51	2231354	14
10401	48.73652781587771	2.020216606498204	0.00025046339222029143	51	2231405	1
10402	48.26167866675119	1.251612903225812	-0.007927969974630019	51	2231456	9
10403	47.79485849025316	1.5796610169491596	-0.002012493563633339	51	2231507	11
10404	47.33026938247481	1.335947712418307	-0.004522145378823374	51	2231558	5
10405	46.88072426440764	2.375757575757587	0.009787288366579543	51	2231609	2
10406	46.42381478534184	1.189776357827482	0.030008161769193763	51	2231660	6
10407	45.975373247657906	1.5796610169491596	0.04455292458627738	51	2231711	7
10408	45.539955393043925	2.4335877862595536	0.051223217272291	51	2231762	3
10409	45.09812960960529	1.3573770491803345	0.03275580967173857	51	2231813	10
10410	44.65649800676077	0.9349693251533792	0.01097404956817627	51	2231864	8
10411	44.22183079027144	1.189776357827482	0.024502613965202782	51	2231915	13
10412	43.800605183098654	2.0992700729927103	0.017313047951343013	51	2231966	4
10413	43.383326403994936	2.072727272727282	0.008464547348957435	51	2232017	12
10414	42.965752525620516	1.6259385665529091	-0.003841436961117913	51	2232068	14
10415	42.54140159062219	0.5306590257879692	0.023439870161168715	51	2232119	1
10416	42.135672162529595	1.9684587813620165	0.01191617343939987	51	2232170	9
10417	41.72810491458851	1.3789473684210587	0.004688547814593595	51	2232221	11
10418	41.32851027659245	1.7686411149825862	0.004570042970133763	51	2232272	2
10419	40.92651631306703	1.1291139240506385	0.0048682485141006175	51	2232323	5
10420	40.532140782043385	1.488963210702348	0.012196132949754303	51	2232374	6
10421	40.151155252085545	2.4335877862595536	0.018424001394533644	51	2232425	3
10422	39.76053678132569	1.0893081761006345	-0.001345768716989779	51	2232476	7
10423	39.38037585795688	1.744444444444453	0.00826894068250469	51	2232527	8
10424	39.00651454542047	1.9942446043165556	-0.0002357638349720076	51	2232578	4
10425	38.635877971394834	1.9428571428571524	0.0032133267206304215	51	2232629	10
10426	38.25669078931402	0.7171597633136136	-0.0013371857942319383	51	2232680	13
10427	37.886640010453135	1.251612903225812	0.006328538352367925	51	2232731	12
10428	37.52266324245562	1.488963210702348	0.000779991348584493	51	2232782	14
10429	37.16369599569659	1.6259385665529091	0.032409927424262554	51	2232833	1
10430	36.799230633372765	0.7171597633136136	0.029502317017199946	51	2232884	9
10431	36.44459780416322	1.335947712418307	0.032152690139471314	51	2232935	11
10432	36.09084775088648	1.0695924764890332	0.034873457515940946	51	2232986	2
10433	35.743945874037685	1.4006600660066075	0.05073091095569087	51	2233037	5
10434	35.40395085974175	1.744444444444453	0.01841921549217374	51	2233088	6
10435	35.06711550339347	1.7204152249135034	0.005600644092933804	51	2233139	3
10436	34.724145840896846	0.7701492537313478	-0.0026397506395975747	51	2233190	7
10437	34.394590793637704	1.7686411149825862	0.0027752562480814315	51	2233241	8
10438	34.07411658381453	2.3471698113207657	-0.0030835522156135707	51	2233292	12
10439	33.747820600700635	1.444518272425256	-0.0024572382954990164	51	2233343	10
10440	33.414839569834875	0.4497175141242973	0.008964889189776252	51	2233394	4
10441	33.10473680151295	2.404562737642597	-0.0012377751808540494	51	2233445	14
10442	32.782851513008524	0.9162079510703413	0.0009950684273944182	51	2233496	13
10443	32.47222715012757	1.7204152249135034	0.05507447205337824	51	2233547	1
10444	32.164709030875436	1.7204152249135034	0.03796618358761657	51	2233598	2
10445	31.855997005501745	1.2935064935064995	0.015739902561786128	51	2233649	9
10446	31.550372100381793	1.2935064935064995	0.029522255355236577	51	2233700	11
10447	31.252798449308045	1.7930069930070016	0.01704421464134665	51	2233751	5
10448	30.956529850480493	1.6259385665529091	0.017386102208904193	51	2233802	6
10449	30.67432963134077	2.7365079365079494	0.018786115973603492	51	2233853	7
10450	30.38073291483192	1.3146579804560328	0.03238790175494026	51	2233904	3
10451	30.100113555608413	2.318796992481214	0.0024351784411598652	51	2233955	12
10452	29.81422651401206	1.5114093959731618	0.009135087331136068	51	2234006	8
10453	29.537884986879316	2.180073800738018	0.017504208228167367	51	2234057	10
10454	29.266263712768097	2.375757575757587	0.03193852480720071	51	2234108	14
10455	28.976849694424946	0.3248618784530416	0.03990738532122444	51	2234159	4
10456	28.6944283784896	0.7347181008902116	0.011488117423712038	51	2234210	13
10457	28.42305166227227	1.5567567567567644	0.016582278644337374	51	2234261	1
10458	28.164946145649548	2.6125000000000123	0.01417685723772236	51	2234312	2
10459	27.896870454684855	1.3573770491803345	4.216648784338259e-05	51	2234363	9
10460	27.629192889378512	1.1291139240506385	0.008238787744559493	51	2234414	11
10461	27.362820465128692	0.9919504643962901	0.011664200062845267	51	2234465	5
10462	27.10913470652057	1.9942446043165556	0.0006105163518120261	51	2234516	6
10463	26.857727947268987	1.9684587813620165	-0.008697704357259414	51	2234567	7
10464	26.61589082527661	2.6740157480315085	-0.008581306420120538	51	2234618	12
10465	26.360624998784854	1.0893081761006345	-0.01256711810242896	51	2234669	10
10466	26.113984266038383	1.6965517241379384	-0.009194670354618746	51	2234720	3
10467	25.868184490718065	1.5340067340067418	-0.007527725369322533	51	2234771	8
10468	25.623076416302688	1.3573770491803345	-0.008033223596273684	51	2234822	14
10469	25.378539919655584	1.1694267515923626	0.00015760461489359537	51	2234873	4
10470	25.135059816409186	1.0305295950155813	0.05039403485316856	51	2234924	13
10471	24.9052386300098	2.152941176470598	0.06097564510270661	51	2234975	1
10472	24.679374213634517	2.318796992481214	0.0643300402398203	51	2235026	11
10473	24.440640531558234	0.8060060060060101	0.04613884757546818	51	2235077	2
10474	24.212030736412142	1.5796610169491596	0.07014951518937654	51	2235128	9
10475	23.990374197163963	2.0463768115942127	0.09259719474642884	51	2235179	5
10476	23.76672984085785	1.6259385665529091	0.14017741820391486	51	2235230	6
10477	23.54849111387784	1.9428571428571524	0.006782632248074401	51	2235281	7
10478	23.333469970855003	2.0463768115942127	0.01821062027239332	51	2235332	3
10479	23.11203303472473	1.189776357827482	0.032965618021347946	51	2235383	10
10480	22.899335239588748	1.8422535211267697	0.04715100924173991	51	2235434	12
10481	22.69002647500648	1.9684587813620165	0.01665834118338192	51	2235485	8
10482	22.48631418018123	2.318796992481214	0.03985665826236501	51	2235536	4
10483	22.276117705046083	1.466666666666674	0.01030294100443522	51	2235587	14
10484	22.07008505033239	1.6728522336769833	0.06134335199991862	51	2235638	13
10485	21.867806735040336	1.8422535211267697	0.13318673302145564	51	2235689	11
10486	21.67012136841986	2.0992700729927103	0.1300328385596182	51	2235740	1
10487	21.467426755395728	1.4006600660066075	0.14535214854221717	51	2235791	2
10488	21.273216255957713	2.0463768115942127	0.1673730214436849	51	2235842	9
10489	21.0758241607382	1.5340067340067418	0.199923085231407	51	2235893	5
10490	20.881325304796345	1.6259385665529091	0.07425075418808881	51	2235944	6
10491	20.68565863155294	1.3146579804560328	0.053248054840985465	51	2235995	7
10492	20.498486633051034	1.9684587813620165	0.03371073685440363	51	2236046	3
10493	20.31118817787035	1.7686411149825862	0.014453457851035922	51	2236097	8
10494	20.126251734688136	1.8175438596491311	0.021518985430399578	51	2236148	10
10495	19.940103311300987	1.5114093959731618	0.0200427396624696	51	2236199	12
10496	19.757667795429356	1.6965517241379384	0.022478328031652114	51	2236250	4
10497	19.57951968890363	1.9428571428571524	0.024949143914615408	51	2236301	14
10498	19.399521102184085	1.5796610169491596	0.025816875345566693	51	2236352	13
10499	19.22297033560669	1.744444444444453	0.021156168451496198	51	2236403	1
10500	19.056865632250624	2.6125000000000123	0.02518325927210789	51	2236454	2
10501	18.883262493169497	1.6965517241379384	0.02619026221481024	51	2236505	11
10502	18.72086124078682	2.6431372549019727	0.022606337771696204	51	2236556	5
10503	18.54616875741121	1.251612903225812	0.017758499173557058	51	2236607	9
10504	18.37219913332916	1.1492063492063544	0.01200628864998911	51	2236658	6
10505	18.211383509037066	2.2906367041198603	0.01598642620385862	51	2236709	7
10506	18.04506628411619	1.5796610169491596	0.007143884312872793	51	2236760	10
10507	17.881344143611795	1.6728522336769833	0.011871915237576353	51	2236811	8
10508	17.71546576711074	1.2935064935064995	0.02034764663845885	51	2236862	3
10509	17.54619134896059	0.7880239520958127	0.005451505090676102	51	2236913	4
10510	17.388659505401055	1.7930069930070016	0.01631593002992518	51	2236964	12
10511	17.23011297768711	1.5340067340067418	0.012798185442008224	51	2237015	14
10512	17.07853912063751	2.072727272727282	0.0068028388070125205	51	2237066	13
10513	16.930660096472334	2.2906367041198603	0.003629815052537357	51	2237117	11
10514	16.777380706391963	1.6027210884353815	0.00246262813315672	51	2237168	1
10515	16.622966376452226	1.335947712418307	0.0014060212700974708	51	2237219	2
10516	16.472304280255273	1.5567567567567644	0.00777099003978804	51	2237270	5
10517	16.339614850898098	3.2033613445378304	0.017539727921579398	51	2237321	6
10518	16.18445966624454	0.8240963855421735	0.002599948469330283	51	2237372	9
10519	16.040790508178585	1.8175438596491311	0.019879923147313735	51	2237423	7
10520	15.904428230473224	2.404562737642597	0.04446614022348441	51	2237474	8
10521	15.765068535982111	1.9684587813620165	0.021829817809310613	51	2237525	10
10522	15.626846422050862	1.9428571428571524	0.02063940786847881	51	2237576	4
10523	15.49731811531067	2.6740157480315085	0.019228149862850413	51	2237627	12
10524	15.361519311381763	1.9174377224199382	0.02961264170852362	51	2237678	3
10525	15.221050698072505	1.3146579804560328	0.003102384945925544	51	2237729	14
10526	15.087511569183652	1.8671378091872874	-0.004980300571404251	51	2237780	13
10527	14.94833072100774	1.1694267515923626	-0.004900222315507776	51	2237831	11
10528	14.807823023553759	0.8975609756097607	-0.00797517042534024	51	2237882	2
10529	14.674858887277953	1.5114093959731618	0.0075843129672256175	51	2237933	1
10530	14.547794886218792	1.9684587813620165	0.0004964359835082409	51	2237984	5
10531	14.417657004696672	1.5340067340067418	0.0036652684211730957	51	2238035	9
10532	14.283980434649704	1.0500000000000052	-0.0005259361921572217	51	2238086	6
10533	14.165768982793628	2.462835249042157	0.04083100954691569	51	2238137	7
10534	14.03967886053326	1.5567567567567644	0.049369307125315946	51	2238188	12
10535	13.916486224177062	1.7204152249135034	0.05579535633909936	51	2238239	10
10536	13.789015629451216	1.1694267515923626	0.048370772717045804	51	2238290	8
10537	13.674313443081516	2.318796992481214	0.0428008892956902	51	2238341	3
10538	13.545811272506121	0.8240963855421735	0.03874788331050499	51	2238392	4
10539	13.426846310465992	1.6493150684931583	0.07304242077995748	51	2238443	14
10540	13.312520293404496	1.9942446043165556	0.008438927285811481	51	2238494	13
10541	13.198317076286054	1.892198581560292	-0.008238483877742992	51	2238545	11
10542	13.095634718531324	2.9300813008130224	-0.005004709842158299	51	2238596	2
10543	12.977613436281075	1.2935064935064995	-0.012256733342713001	51	2238647	1
10544	12.860772366853329	1.2935064935064995	-0.012685303594551835	51	2238698	5
10545	12.740770703790856	0.860606060606065	-0.0006967032072590847	51	2238749	9
10546	12.625671678424974	1.230868167202578	0.006585447227253634	51	2238800	6
10547	12.508021022246785	0.860606060606065	-0.0044341864539127725	51	2238851	7
10548	12.400870881954388	1.7930069930070016	0.02320857842763265	51	2238902	12
10549	12.295037611731336	1.8175438596491311	0.007030842350978477	51	2238953	10
10550	12.192814508341296	2.072727272727282	0.009020304562998753	51	2239004	8
10551	12.083611282351734	1.2724919093851197	0.044591211805156634	51	2239055	3
10552	11.980219613972661	1.744444444444453	0.018271891509785372	51	2239106	4
10553	11.872111685348859	1.1694267515923626	0.009831270750831156	51	2239157	14
10554	11.771813103706638	1.8422535211267697	0.011567717673731786	51	2239208	13
10555	11.674558740785514	2.0463768115942127	0.007947401673186059	51	2239259	11
10556	11.568118449327814	1.0305295950155813	0.003173938276720982	51	2239310	1
10557	11.46601103532634	1.3573770491803345	0.009825708819370643	51	2239361	2
10558	11.368555077222211	1.7204152249135034	0.01069029406005261	51	2239412	9
10559	11.27507169251497	2.020216606498204	0.013553118004518397	51	2239463	5
10560	11.18200556340344	1.9684587813620165	0.013735737286361993	51	2239514	6
10561	11.097866782669804	2.7681274900398534	-0.0006579066462376539	51	2239565	7
10562	11.007880815573033	2.0992700729927103	-0.005417659586551143	51	2239616	8
10563	10.912916101377034	1.5114093959731618	-0.0023919308886808507	51	2239667	10
10564	10.820515462700033	1.6728522336769833	-0.0034136418618407904	51	2239718	12
10565	10.727424402032764	1.5114093959731618	0.0006550255359387866	51	2239769	14
10566	10.629125767768533	0.8975609756097607	0.007980382325602513	51	2239820	4
10567	10.534732273669123	1.189776357827482	0.010952160638921401	51	2239871	3
10568	10.4449525185	1.5567567567567644	0.018137534459431965	51	2239922	13
10569	10.36096676143094	2.0463768115942127	0.02100526819042131	51	2239973	11
10570	10.269459657919196	1.2102564102564166	0.02105254285475787	51	2240024	1
10571	10.180990226902917	1.4225165562913977	0.016290301201390286	51	2240075	2
10572	10.088155934389986	0.8975609756097607	0.013678486440695968	51	2240126	9
10573	10.006196360861688	1.892198581560292	0.021792734370512122	51	2240177	5
10574	9.917828664768995	1.1694267515923626	0.025083380586960736	51	2240228	6
10575	9.830959059793331	1.230868167202578	0.023847032995784983	51	2240279	7
10576	9.751571455011	1.892198581560292	0.013203174460167978	51	2240330	12
10577	9.671500184905335	1.744444444444453	0.025351489291471595	51	2240381	8
10578	9.596585921063662	2.180073800738018	0.012343430051616594	51	2240432	10
10579	9.518550131783096	1.7930069930070016	0.0008935194973852121	51	2240483	4
10580	9.436089549559115	1.2724919093851197	-0.0018311341603597004	51	2240534	14
10581	9.3536264176418	1.189776357827482	-0.000782094165390613	51	2240585	3
10582	9.266569685629126	0.6479532163742729	-0.00530552630331002	51	2240636	13
10583	9.191834058702904	1.7930069930070016	0.007500795757069308	51	2240687	11
10584	9.117845788045946	1.7930069930070016	0.021689679108413996	51	2240738	9
10585	9.044842768761978	1.8175438596491311	0.01367498846615062	51	2240789	1
10586	8.971359858315736	1.6965517241379384	0.021078278036678538	51	2240840	2
10587	8.898374782069348	1.6728522336769833	0.02210523100460277	51	2240891	6
10588	8.83343666162508	2.404562737642597	0.028894517935958562	51	2240942	5
10589	8.771842452489144	2.6740157480315085	0.03490703479916442	51	2240993	12
10590	8.697913501648463	1.3789473684210587	0.00535997280887529	51	2241044	7
10591	8.623243048304005	1.230868167202578	0.004361521379620421	51	2241095	8
10592	8.557212783885946	2.020216606498204	0.01714637700249167	51	2241146	10
10593	8.490815033271286	1.9174377224199382	0.01037660883922203	51	2241197	4
10594	8.423593294088398	1.7686411149825862	-0.0021522284722795674	51	2241248	14
10595	8.354924928715082	1.5567567567567644	0.009960495958141252	51	2241299	3
10596	8.293176417435312	2.180073800738018	0.00409702226227405	51	2241350	13
10597	8.221336135910802	1.1091482649842326	0.0033788797902125937	51	2241401	11
10598	8.153347940114609	1.4225165562913977	0.01501921111462163	51	2241452	9
10599	8.084749525648526	1.2935064935064995	0.0063996092945921654	51	2241503	6
10600	8.021832100322111	1.7930069930070016	0.01008220630533555	51	2241554	5
10601	7.953105842810954	1.1492063492063544	0.00014498369658694546	51	2241605	1
10602	7.885066847874908	1.1492063492063544	0.0027560413468117806	51	2241656	2
10603	7.824887557488032	1.8671378091872874	0.008905523547939226	51	2241707	12
10604	7.766067253341723	1.9428571428571524	0.006035308627521291	51	2241758	7
10605	7.699299662569312	1.0893081761006345	0.003723331526214001	51	2241809	8
10606	7.639272183184999	1.6965517241379384	0.010022948769962086	51	2241860	10
10607	7.575188143025175	1.230868167202578	0.008597851968279072	51	2241911	4
10608	7.511952390627181	1.251612903225812	-0.0005128079769658108	51	2241962	14
10609	7.450192343845092	1.335947712418307	0.006587242963267308	51	2242013	13
10610	7.387792984509206	1.2102564102564166	0.002065126071957981	51	2242064	3
10611	7.332837040479717	1.892198581560292	0.037587792265648935	51	2242115	11
10612	7.274398302181943	1.488963210702348	0.004714351074368346	51	2242166	6
10613	7.215879484723038	1.4225165562913977	0.004936399997449389	51	2242217	9
10614	7.166347555547449	2.26268656716419	0.010028460446526022	51	2242268	1
10615	7.111888232241109	1.7204152249135034	0.011500095619874843	51	2242319	5
10616	7.062570087926079	2.180073800738018	0.018223061281092027	51	2242370	12
10617	7.001672782108546	0.9728395061728442	0.006641006937213973	51	2242421	2
10618	6.955127752400668	2.3471698113207657	0.02352451343162387	51	2242472	7
10619	6.902304997213431	1.6728522336769833	0.0073554679459216545	51	2242523	10
10620	6.845590628913322	1.230868167202578	0.0002617403572680903	51	2242574	8
10621	6.798127423354115	2.0992700729927103	-0.000359366191368477	51	2242625	4
10622	6.746874671457344	1.6728522336769833	0.007129937994713877	51	2242676	14
10623	6.691922053775029	1.251612903225812	0.003209924288824493	51	2242727	13
10624	6.64079944340677	1.5796610169491596	0.00024572131680507286	51	2242778	3
10625	6.5938200204012745	1.9428571428571524	0.008352689883288215	51	2242829	11
10626	6.560988203175985	3.3106382978723556	0.010096280013813692	51	2242880	6
10627	6.513308391074296	1.7930069930070016	0.010203713295506496	51	2242931	9
10628	6.467097292979156	1.892198581560292	0.029001357508640663	51	2242982	5
10629	6.422110907862985	1.9684587813620165	0.017661384507721544	51	2243033	7
10630	6.371679272468566	1.3789473684210587	0.02029276595396154	51	2243084	12
10631	6.317500941282343	0.953846153846159	0.007334985569411633	51	2243135	1
10632	6.264054326931247	0.9728395061728442	0.01724219088460885	51	2243186	2
10633	6.222673856922008	2.1260073260073358	0.002458232874963798	51	2243237	8
10634	6.176706504018318	1.6259385665529091	0.00039684305004045075	51	2243288	10
10635	6.127042003080699	1.2102564102564166	-0.002929901959849339	51	2243339	4
10636	6.0806612151569155	1.488963210702348	0.004955016514834236	51	2243390	13
10637	6.032579522099198	1.2724919093851197	-0.002543570072043176	51	2243441	14
10638	5.985400306682767	1.3146579804560328	0.002599110205968221	51	2243492	3
10639	5.946539004345866	2.0992700729927103	0.02323583995594698	51	2243543	9
10640	5.905249052898899	1.8175438596491311	0.0655811814700856	51	2243594	12
10641	5.871416639589987	2.5220077220077335	0.09210738013772403	51	2243645	5
10642	5.829667990435467	1.6965517241379384	0.1637288822847254	51	2243696	2
10643	5.788336827772492	1.6965517241379384	0.13119292726703718	51	2243747	8
10644	5.749124837586639	1.8671378091872874	0.13983518002079984	51	2243798	10
10645	5.70697365655084	1.5340067340067418	0.030392370971978878	51	2243849	4
10646	5.66843353671007	1.8529616724738807	0.001645532776327694	85	2243934	6
10647	5.629435612492795	1.7686411149825862	0.02726587360980464	51	2243985	13
10648	5.591316694964358	1.8175438596491311	0.01926691158145082	51	2244036	3
10649	5.54570882396487	1.0305295950155813	0.025075683406755037	51	2244087	14
10650	5.503654333127819	1.3402597402597487	0.019994994243943548	83	2244170	1
10651	5.456979235579674	0.836144578313258	0.03414529046894592	81	2244251	7
10652	5.408683218440015	0.627377521613834	0.01127243373129103	108	2244359	11
10653	5.373770763479814	1.9174377224199382	0.010398493093602797	51	2244410	9
10654	5.338208494441507	1.8175438596491311	0.020302576177260456	51	2244461	12
10655	5.299940503456823	1.5114093959731618	0.014475467158298866	51	2244512	5
10656	5.265612476514128	1.8671378091872874	0.023296335164238426	51	2244563	8
10657	5.228070445708718	1.5114093959731618	0.03218382012610342	51	2244614	2
10658	5.1906793733586545	1.488963210702348	0.008188337087631226	51	2244665	4
10659	5.158715025668234	1.9942446043165556	0.011042054961709416	51	2244716	13
10660	5.123155086295905	1.6027210884353815	0.012743166848724964	51	2244767	6
10661	5.0773947998007625	0.5471264367816123	-0.0008552782967978833	51	2244818	14
10662	5.039980328926938	1.335947712418307	0.049898138233259615	51	2244869	1
10663	5.000276450402559	1.0695924764890332	0.02421911557515462	51	2244920	7
10664	4.972347759972608	2.207407407407418	0.016485899102454092	51	2244971	11
10665	4.934862377610977	1.2238095238095363	0.03905802238278273	82	2245053	10
10666	4.902958198279311	1.744444444444453	0.006355872925590067	51	2245104	9
10667	4.862534676902579	0.860606060606065	0.007124660061854942	51	2245155	12
10668	4.829936541017907	1.6027210884353815	-0.003275352365830365	51	2245206	5
10669	4.804264041279369	2.26268656716419	0.002040647992900774	51	2245257	2
10670	4.776948673593848	2.072727272727282	0.0078087314671161125	51	2245308	8
10671	4.749812989674812	2.0633802816901614	0.04365567933945429	84	2245392	3
10672	4.7343484732234415	3.2033613445378304	0.009784602067049812	51	2245443	4
10673	4.709911355532405	2.2906367041198603	0.008997139393114577	51	2245494	6
10674	4.678152309317148	1.5340067340067418	0.004939884531731699	51	2245545	13
10675	4.64286284971604	1.1492063492063544	0.00023205958160699584	51	2245596	14
10676	4.620191796976455	2.375757575757587	0.0004562700496000402	51	2245647	7
10677	4.586092443109254	1.2102564102564166	-0.0005977235588372923	51	2245698	1
10678	4.553805289169965	1.3573770491803345	0.00427602465246238	51	2245749	11
10679	4.530616678657448	2.234944237918226	0.014871402114045387	51	2245800	10
10680	4.499755694595126	1.444518272425256	0.020656221053179574	51	2245851	9
10681	4.471962289898309	1.7204152249135034	0.03161827021954106	51	2245902	5
10682	4.4425827343393935	1.5340067340067418	0.028502195489172842	51	2245953	12
10683	4.411091971931064	1.2935064935064995	0.01696167038936241	51	2246004	8
10684	4.381206217774668	1.4225165562913977	0.012786086867837346	51	2246055	2
10685	4.3538873062818535	1.6493150684931583	0.014399255023283116	51	2246106	4
10686	4.326841583903967	1.6493150684931583	0.014635908837411917	51	2246157	3
10687	4.304565868794854	2.0992700729927103	0.0016849654562333051	51	2246208	14
10688	4.276409842213929	1.488963210702348	-0.0025290905260572246	51	2246259	13
10689	4.241886707647212	0.8240963855421735	9.059204774744371e-05	51	2246310	6
10690	4.210758979811246	1.1291139240506385	-0.011830409367879232	51	2246361	1
10691	4.186581459943204	1.7930069930070016	0.00027246393409429814	51	2246412	7
10692	4.156006784584278	1.1291139240506385	-0.003350877878712673	51	2246463	11
10693	4.129786784078502	1.5340067340067418	-0.0013607755011203243	51	2246514	10
10694	4.110838358616899	2.234944237918226	0.02861918187608906	51	2246565	9
10695	4.081627738609004	1.189776357827482	0.029271593280867033	51	2246616	12
10696	4.055925555182645	1.5114093959731618	0.030911931804582186	51	2246667	5
10697	4.023972360236879	0.860606060606065	0.019906132828955557	51	2246718	8
10698	4.002907013858709	1.9174377224199382	0.02188413283404182	51	2246769	4
10699	3.9782180110601897	1.5340067340067418	0.028770918939627854	51	2246820	3
10700	3.951370895884653	1.2935064935064995	0.023512580815483543	51	2246871	2
10701	3.9317996329689717	1.9942446043165556	0.02010386130389045	51	2246922	14
10702	3.9124240826824472	1.9942446043165556	0.0035296000686346318	51	2246973	13
10703	3.8919712199474956	1.8671378091872874	0.0016244944988512526	51	2247024	6
10704	3.873515275863963	2.0463768115942127	0.007233733055638332	51	2247075	1
10705	3.857686490146522	2.2906367041198603	-0.0023238315593962578	51	2247126	7
10706	3.835602775929989	1.6493150684931583	-0.003108486825344609	51	2247177	11
10707	3.8198736138423306	2.26268656716419	-0.0038054527020921895	51	2247228	10
10708	3.802667578433834	2.0992700729927103	-0.002316353952183443	51	2247279	9
10709	3.781845054898631	1.7204152249135034	0.0006709791281644036	51	2247330	12
10710	3.7609921215910243	1.6965517241379384	0.009529328813739852	51	2247381	2
10711	3.740347717616493	1.6965517241379384	0.004040676881285275	51	2247432	4
10712	3.7080870975831854	0.5142857142857179	-0.00428887032995037	51	2247483	5
10713	3.6874993772922853	1.6493150684931583	-1.1053082405352125e-05	51	2247534	8
10714	3.6605438881633257	0.9919504643962901	-0.004248993653877109	51	2247585	3
10715	3.639052543241424	1.5114093959731618	0.015265406346788593	51	2247636	14
10716	3.618458627978501	1.5796610169491596	0.030652191124710383	51	2247687	13
10717	3.599960452848542	1.7686411149825862	0.028323891116123573	51	2247738	6
10718	3.579300915660124	1.5340067340067418	0.02975914992538153	51	2247789	1
10719	3.5664142735447215	2.2906367041198603	0.007254424048405068	51	2247840	7
10720	3.551477403536547	2.072727272727282	0.005923150801191143	51	2247891	11
10721	3.5369553302311085	2.0992700729927103	0.006687132166881187	51	2247942	10
10722	3.529267051829196	2.7681274900398534	0.0005969538115987591	51	2247993	9
10723	3.5084195640351563	1.444518272425256	0.0036276152320936614	51	2248044	12
10724	3.4846265076353107	1.1291139240506385	-0.0029460197570277194	51	2248095	2
10725	3.4665087648957273	1.6728522336769833	0.007847865422566732	51	2248146	8
10726	3.443134816487276	1.1291139240506385	0.0009864968996421964	51	2248197	4
10727	3.4276254541380067	1.892198581560292	0.008198001805473776	51	2248248	3
10728	3.40692297008843	1.3573770491803345	0.00709338807592205	51	2248299	5
10729	3.3875204070542124	1.466666666666674	0.009100211601631315	51	2248350	14
10730	3.369904588649199	1.6259385665529091	0.06695928760603362	51	2248401	13
10731	3.3538919539125334	1.7686411149825862	0.022469237738964604	51	2248452	6
10732	3.330464835615644	1.0111801242236078	0.014204672738617542	51	2248503	1
10733	3.320631885372695	2.3471698113207657	0.005489936646293192	51	2248554	10
10734	3.3032221766884597	1.5796610169491596	0.002826491407319611	51	2248605	7
10735	3.2922640289956493	2.207407407407418	0.006469013059840482	51	2248656	11
10736	3.2777639239169605	1.8422535211267697	0.0024359638200086705	51	2248707	9
10737	3.2558793664387973	1.0893081761006345	0.0026323091165692198	51	2248758	12
10738	3.2379872394410762	1.466666666666674	0.03957591804803586	51	2248809	6
10739	3.219181137538469	1.3573770491803345	0.053954358194388596	51	2248860	1
10740	3.2125087060080455	2.5519379844961354	0.1278714385687136	51	2248911	10
10741	3.203571588872777	2.318796992481214	0.10912128523284313	51	2248962	7
10742	3.1859810557083015	1.444518272425256	0.10060629190183153	51	2249013	11
10743	3.1746481268716487	2.0526881720430286	0.06503104054650595	86	2249099	2
10744	3.1579016456029323	1.5000000000000138	0.06344655581883021	84	2249183	8
10745	3.142349840031257	1.6027210884353815	0.068069761874629	51	2249234	9
10746	3.1272776929822954	1.6351351351351466	0.032730204718453546	84	2249318	5
10747	3.1165317977729026	2.0526881720430286	0.045107519903848335	86	2249404	4
10748	3.0993730804552393	1.4006600660066075	-0.0068398024521622	51	2249455	12
10749	3.086642507545424	1.8263157894736999	0.007416131884552712	86	2249541	3
10750	3.0740392403647063	1.8263157894736999	-0.00837201988974283	86	2249627	13
10751	3.061828464685798	1.8529616724738833	0.0003659587134333218	85	2249712	14
10752	3.0524702532990133	2.1260073260073358	-0.0005130312022040872	51	2249763	6
10753	3.0372856181060905	1.5340067340067418	0.008109336390214808	51	2249814	11
10754	3.02871349993241	2.180073800738018	0.014058627334295535	51	2249865	13
10755	3.018110952746706	1.9684587813620165	0.010108185749427945	51	2249916	14
10756	3.0154540067880125	2.752416356877347	0.08337173691715102	83	2249999	2
10757	2.9933895568102225	0.8090090090090174	0.09923740669533059	81	2250080	7
10758	2.9922376161293385	2.878195488721829	0.09809494018554688	83	2250163	9
10759	2.9833079406979723	2.0992700729927103	0.03681473872240852	51	2250214	6
10760	2.967194730997833	1.3719869706840542	0.0036767401609076075	83	2250297	5
10761	2.9639731148136828	2.6450331125828095	0.003377798625401088	105	2250402	1
10762	2.9526847350168977	1.835135135135153	0.012853997509653976	82	2250484	4
10763	2.93950923901808	1.6351351351351475	-0.003790324642544701	84	2250568	12
10764	2.9272342667480196	1.7120120120120323	0.0008777181307474772	102	2250670	10
10765	2.9108085694479513	1.2846645367412233	-0.01530006600589287	82	2250752	3
10766	2.8910501770050057	0.9349693251533792	-0.013492242962706322	51	2250803	11
10767	2.8919189394490026	2.9779264214047108	0.012885810102073892	103	2250906	8
10768	2.882174127278712	1.9174377224199382	-0.016066960259979845	51	2250957	13
10769	2.8634641872481605	1.0111801242236078	-0.011511210133047664	51	2251008	14
10770	2.8644621984369034	2.9632653061224627	0.01184675506516999	51	2251059	7
10771	2.850931670412266	1.5114093959731618	-0.0032586686167062496	51	2251110	2
10772	2.8357818308323264	1.335947712418307	-0.004298386620540245	51	2251161	6
10773	2.813227480732096	0.5803468208092523	-0.000439140142179003	51	2251212	9
10774	2.80503765196794	1.9942446043165556	-0.0006059083868475521	51	2251263	4
10775	2.795909261263864	1.892198581560292	0.0017022198321772557	51	2251314	1
10776	2.7892102419112987	2.1260073260073358	0.002902188721825095	51	2251365	5
10777	2.776432233451917	1.5114093959731618	0.010124550146215102	51	2251416	12
10778	2.76887007718238	2.020216606498204	0.003165984270619411	51	2251467	10
10779	2.759356815007048	1.8175438596491311	0.00681681609621235	51	2251518	3
10780	2.7446983117920425	1.2935064935064995	0.006716236764309453	51	2251569	11
10781	2.728743392166186	1.1492063492063544	0.004409677257724837	51	2251620	8
10782	2.721140546058144	1.9684587813620165	0.008832819321576287	51	2251671	13
10783	2.7165560062692045	2.26268656716419	0.021163197124705595	51	2251722	14
10784	2.7040571128731794	1.466666666666674	0.004092274051086575	51	2251773	7
10785	2.692130635704179	1.5114093959731618	0.003590057877933278	51	2251824	2
10786	2.6817024800320692	1.6493150684931583	0.004069761902678246	51	2251875	4
10787	2.6674015842640064	1.251612903225812	-0.0004952809974259021	51	2251926	9
10788	2.6486078079423248	0.7880239520958127	0.0016186938566320082	51	2251977	6
10789	2.6410437156785047	1.892198581560292	0.003869015796511781	51	2252028	1
10790	2.62842275220593	1.3789473684210587	0.0027773865297728894	51	2252079	5
10791	2.615498001808054	1.335947712418307	0.010169449974508846	51	2252130	12
10792	2.6072730917200433	1.7930069930070016	0.008543802242653043	51	2252181	11
10793	2.588901853340156	0.7701492537313478	0.008954810745575848	51	2252232	10
10794	2.587641187297176	2.462835249042157	0.01090470131705789	51	2252283	8
10795	2.5736625390024788	1.189776357827482	0.0005579083865764094	51	2252334	3
10796	2.5630400075721855	1.5114093959731618	0.01351100206375122	51	2252385	13
10797	2.552749674836531	1.5340067340067418	0.006995997008155374	51	2252436	14
10798	2.540795948579969	1.3573770491803345	0.0023749870996849208	51	2252487	7
10799	2.5335634276906607	1.8175438596491311	0.004116981929423762	51	2252538	4
10800	2.524487179079283	1.6259385665529091	0.006320727222106036	51	2252589	9
10801	2.5132489079485563	1.4006600660066075	0.003741111533314574	51	2252640	6
10802	2.49061233167561	0.24959128065395306	0.01473240758858475	51	2252691	2
10803	2.4909262855789316	2.5220077220077335	0.012624469457888136	51	2252742	12
10804	2.477711290239066	1.1694267515923626	0.005761098627950631	51	2252793	1
10805	2.471605555428548	1.8671378091872874	0.008295893669128418	51	2252844	5
10806	2.4648195698043325	1.7930069930070016	0.0074439118890201345	51	2252895	11
10807	2.454177974766355	1.4006600660066075	0.00420207866266662	51	2252946	10
10808	2.4511656067833973	2.152941176470598	0.012804552620532466	51	2252997	3
10809	2.446082522144135	1.9428571428571524	0.012044142274295582	51	2253048	8
10810	2.443695770996768	2.207407407407418	0.015825089286355412	51	2253099	13
10811	2.438687384715372	1.9428571428571524	0.0006332215579117046	51	2253150	14
10812	2.4374884807930304	2.318796992481214	0.005961204276365393	51	2253201	7
10813	2.4330560420282654	1.9942446043165556	0.0219194444955564	51	2253252	4
10814	2.4190307775581386	1.0305295950155813	-0.0020274302246523837	51	2253303	6
10815	2.407356598814815	1.251612903225812	0.007505380639842912	51	2253354	9
10816	2.3983971267863984	1.5114093959731618	0.01480722661111869	51	2253405	2
10817	2.3967625978977165	2.234944237918226	0.011559596248701507	51	2253456	1
10818	2.3948690459928135	2.207407407407418	0.021608455508363014	51	2253507	12
10819	2.3941083254576974	2.318796992481214	0.01702769947986977	51	2253558	11
10820	2.375970710411213	0.5803468208092523	0.011949268041872511	51	2253609	5
10821	2.369415155556236	1.7204152249135034	0.006347788899552589	51	2253660	10
10822	2.355640508644637	0.9919504643962901	-0.0010648761309829413	51	2253711	3
10823	2.353884841565571	2.180073800738018	0.0015131614956201292	51	2253762	8
10824	2.3521467311572954	2.180073800738018	-0.0009394223783530441	51	2253813	13
10825	2.3419847409699055	1.335947712418307	0.0006578726803555208	51	2253864	14
10826	2.345305051040522	2.6740157480315085	0.005266549540501015	51	2253915	4
10827	2.335641474214327	1.3789473684210587	0.003131338778664084	51	2253966	7
10828	2.330460498068675	1.8175438596491311	0.0022175250684513766	51	2254017	9
10829	2.320945366772199	1.3789473684210587	0.012416043702293844	51	2254068	6
10830	2.314940065353612	1.7204152249135034	0.010023660519543816	51	2254119	2
10831	2.3107126505156788	1.892198581560292	0.0064728195760764325	51	2254170	1
10832	2.309679598084596	2.207407407407418	0.025760718420440077	51	2254221	11
10833	2.303075952788682	1.6493150684931583	0.018301938094344793	51	2254272	12
10834	2.2953852606008627	1.5340067340067418	0.012913888575983983	51	2254323	10
10835	2.2862208816790646	1.3789473684210587	0.010228547395444383	51	2254374	3
10836	2.2719647334683346	0.860606060606065	0.00016814185415997226	51	2254425	5
10837	2.267175156063721	1.7930069930070016	0.021978020668029785	51	2254476	13
10838	2.266852846882266	2.234944237918226	0.024017565390642953	51	2254527	8
10839	2.2721843184134434	2.800000000000013	-0.004130796766748615	51	2254578	14
10840	2.269664641294291	2.020216606498204	0.002595795135872037	51	2254629	4
10841	2.2663965663099197	1.9428571428571524	0.002771561052284989	51	2254680	7
10842	2.26290697787102	1.9174377224199382	0.0138128306351456	51	2254731	6
10843	2.2549445747589765	1.466666666666674	0.0027364130113639086	51	2254782	9
10844	2.2481917391808786	1.5796610169491596	0.0037056342059490727	51	2254833	2
10845	2.2441323570003378	1.8422535211267697	0.009322818587808049	51	2254884	11
10846	2.2448790033551465	2.318796992481214	0.014625770204207477	51	2254935	12
10847	2.2401166244714212	1.7686411149825862	0.007305063453375124	51	2254986	1
10848	2.2403423238983486	2.26268656716419	0.0045145156921124925	51	2255037	10
10849	2.236361435870633	1.8422535211267697	0.008735027383355534	51	2255088	3
10850	2.2282229870748402	1.4225165562913977	0.008924608137093339	51	2255139	8
10851	2.223144909453227	1.7204152249135034	0.009064545234044393	51	2255190	13
10852	2.2169406712430484	1.6027210884353815	0.010028507195267022	51	2255241	5
10853	2.213442642622491	1.8671378091872874	0.01262728723825193	51	2255292	4
10854	2.210230202011869	1.892198581560292	0.027697525772393917	51	2255343	6
10855	2.203695467559318	1.5567567567567644	0.02072300630457261	51	2255394	7
10856	2.2029185861437983	2.1260073260073358	0.016662195617077397	51	2255445	2
10857	2.1882365812912625	0.7347181008902116	0.00960225451226328	51	2255496	11
10858	2.178870344510608	1.251612903225812	0.006504313618529076	51	2255547	9
10859	2.1778089137927745	2.072727272727282	0.014575612311269723	51	2255598	12
10860	2.1643165389405614	0.8285714285714298	-0.002072516828775406	80	2255678	14
10861	2.1591665242360873	1.6493150684931583	0.01951485404781267	51	2255729	1
10862	2.1461809195997867	0.860606060606065	0.017103226745829862	51	2255780	10
10863	2.142649180333859	1.7930069930070016	0.025985575189777448	51	2255831	13
10864	2.1345821656547037	1.335947712418307	0.028155163222668218	51	2255882	3
10865	2.1316588792094247	1.8422535211267697	0.023449268995546828	51	2255933	8
10866	2.1252319225243537	1.488963210702348	0.02437164502985337	51	2255984	5
10867	2.1260536773731844	2.207407407407418	-0.011011148200315587	51	2256035	4
10868	2.123967517823652	1.9174377224199382	0.004579035090465171	51	2256086	6
10869	2.1095513720571804	0.6823529411764748	0.0035417734407911113	51	2256137	7
10870	2.105421375577988	1.6965517241379384	2.5332266209172267e-05	51	2256188	2
10871	2.1061678998295883	2.180073800738018	0.0139085054397583	51	2256239	11
10872	2.096800488347216	1.1694267515923626	0.007330325888652427	51	2256290	12
10873	2.094754469279347	1.892198581560292	0.0038390372898064406	51	2256341	10
10874	2.0947996253164805	2.0992700729927103	0.0010297294048702017	51	2256392	1
10875	2.078994486206173	0.5142857142857179	0.00830511310521294	51	2256443	9
10876	2.0709294604379624	1.2724919093851197	0.003717673175475177	51	2256494	3
10877	2.067185683074962	1.6965517241379384	0.01184920820535398	51	2256545	13
10878	2.0623104364137044	1.5796610169491596	0.005844215552012126	51	2256596	8
10879	2.050662941805665	0.8975609756097607	-0.0012508139890782973	51	2256647	14
10880	2.045723879955176	1.5567567567567644	0.010394961226220224	51	2256698	5
10881	2.0386261182798076	1.335947712418307	0.013712167739868164	51	2256749	4
10882	2.03202933078122	1.3789473684210587	0.007995632933635338	51	2256800	6
10883	2.030883414697607	1.9174377224199382	0.006434721689598233	51	2256851	7
10884	2.0388958656911935	2.8321285140562384	0.017245040220372817	51	2256902	10
10885	2.0219085690841427	0.3401662049861528	0.011828225032955992	51	2256953	2
10886	2.0208638606175007	1.9174377224199382	0.012490302908654306	51	2257004	12
10887	2.01488038757424	1.4225165562913977	0.005840474484013576	51	2257055	11
10888	2.015724284428425	2.0992700729927103	0.015837531463772644	51	2257106	9
10889	2.0127711938332755	1.7204152249135034	0.01927642728768143	51	2257157	1
10890	2.0161151800081503	2.3471698113207657	0.029422837145188275	51	2257208	13
10891	2.014625406299942	1.8671378091872874	0.025226625741696825	51	2257259	3
10892	2.0185247796133683	2.404562737642597	0.03477770908206117	51	2257310	8
10893	2.0110644509110855	1.2724919093851197	0.016985075146544213	51	2257361	14
10894	1.9967572746100672	0.5803468208092523	-0.002724357387598823	51	2257412	5
10895	1.9969918679289487	2.020216606498204	-0.002427766720453898	51	2257463	4
10896	1.9967065370632795	1.9684587813620165	0.056328259262384155	51	2257514	7
10897	2.0025604833657984	2.582101167315187	0.08887281604841643	51	2257565	11
10898	2.002477324575306	1.9942446043165556	0.073913761213714	51	2257616	10
10899	1.9984797622139068	1.6027210884353815	0.08901638143202838	51	2257667	8
10900	2.003418041514845	2.492307692307704	0.031785048690496705	51	2257718	14
10901	2.0015592996961877	1.8175438596491311	0.10343043009440105	51	2257769	3
10902	2.001745872764208	2.020216606498204	0.011867191277298272	51	2257820	5
10903	2.0003622168534676	1.8633802816901541	0.0021786662035210187	86	2257906	6
10904	1.9980450058347587	1.7686411149825862	0.0077754469478831575	51	2257957	4
10905	1.991151934417188	1.3087378640776817	0.015518192785332003	83	2258040	9
10906	1.9815481073807084	1.0307692307692387	0.011821520181349765	81	2258121	2
10907	1.9799957842016382	1.8263157894736954	0.013387232325797858	86	2258207	1
10908	1.9765471777109733	1.6351351351351475	0.017994327204568044	84	2258291	12
10909	1.9769245630767207	2.0142857142857338	0.022864591243655183	86	2258377	13
10910	1.975330756042445	1.8175438596491311	-0.0018848928750730028	51	2258428	11
10911	1.9643677220382516	0.8790273556231052	-0.0012873224183624866	51	2258479	10
10912	1.9657167455477962	2.0992700729927103	-0.002043054384343764	51	2258530	8
10913	1.9662617441573003	2.020216606498204	0.006499071331585155	51	2258581	14
10914	1.9567109279579633	1.0111801242236078	0.0005038135191973518	51	2258632	3
10915	1.964825093578782	2.7681274900398534	0.012491070756725236	51	2258683	5
10916	1.9531976141563474	0.8020771513353149	0.005657925456762314	80	2258763	7
10917	1.9443615627796742	1.0695924764890332	0.012504255070405848	51	2258814	6
10918	1.9475448128235193	2.26268656716419	0.0058753858594333425	51	2258865	4
10919	1.94959877645999	2.152941176470598	0.01810302921369964	51	2258916	2
10920	1.9521768627694642	2.207407407407418	0.007703745482014674	51	2258967	12
10921	1.9536477948716966	2.0992700729927103	0.008504268585466872	51	2259018	13
10922	1.9452027995728218	1.1091482649842326	0.011111947835660448	51	2259069	1
10923	1.936446696341984	1.0695924764890332	0.010662435316572003	51	2259120	9
10924	1.9454035145191264	2.8321285140562384	0.015570341372022442	51	2259171	11
10925	1.944871465189538	1.892198581560292	0.0032489720512838926	51	2259222	10
10926	1.94076281787771	1.5340067340067418	0.0016657464644488167	51	2259273	8
10927	1.9387996341433775	1.744444444444453	0.0026244299084532494	51	2259324	14
10928	1.947732922942506	2.8321285140562384	0.0014052998785879097	51	2259375	5
10929	1.9546869662621007	2.6431372549019727	0.006630334199643603	51	2259426	6
10930	1.9441157063555772	0.8975609756097607	-0.00299609525530946	51	2259477	3
10931	1.943097084503289	1.8422535211267697	0.02352468640196557	51	2259528	13
10932	1.9368126934628165	1.3146579804560328	0.06326956842459884	51	2259579	9
10933	1.9381718392554612	2.072727272727282	0.04517267264571844	51	2259630	11
10934	1.9373197375876454	1.8529616724738789	0.04350970773135915	85	2259715	7
10935	1.9431666174318463	2.5220077220077335	0.051546699860516715	51	2259766	10
10936	1.941910389854019	1.8175438596491311	0.017361824418984206	51	2259817	8
10937	1.9462488617130547	2.375757575757587	0.011125475752587412	51	2259868	6
10938	1.9378778557457663	1.1091482649842326	0.009247135297924864	51	2259919	14
10939	1.9286667790516627	1.0167701863354095	0.0018244963593599273	82	2260001	2
10940	1.9201301112611462	1.0750000000000055	0.0010200797057733303	82	2260083	1
10941	1.9206903759848337	1.9761565836299062	0.0007958197316458059	86	2260169	4
10942	1.9204054580405883	1.892198581560292	0.011839431874892292	51	2260220	5
10943	1.914288782100959	1.3087378640776763	0.01033015279884798	83	2260303	12
10944	1.9150883403231151	1.9942446043165556	0.013568760133257099	51	2260354	3
10945	1.9185643225915259	2.26268656716419	0.00861686818739947	51	2260405	13
10946	1.9178012145768784	1.8422535211267697	-0.001154656941984214	51	2260456	7
10947	1.9193504751583825	2.072727272727282	0.008615670835270602	51	2260507	10
10948	1.9146021531310513	1.444518272425256	0.026487425261852788	51	2260558	8
10949	1.9138786668110084	1.8422535211267697	0.008364664573295443	51	2260609	6
10950	1.9100799474829657	1.5340067340067418	0.01109849822287466	51	2260660	1
10951	1.9054243307323888	1.444518272425256	0.009860836992076799	51	2260711	14
10952	1.9001595611092754	1.3789473684210587	0.022438530828438552	51	2260762	2
10953	1.8986024099426273	1.744444444444453	0.008104268242331111	51	2260813	5
10954	1.89814600256794	1.8529616724738807	0.016353531444773955	85	2260898	9
10955	1.8947321101098282	1.5567567567567644	0.00962750701343312	51	2260949	4
10956	1.887682552587005	1.189776357827482	0.02483995521769804	51	2261000	3
10957	1.8831434754055059	1.4337748344370942	0.002548360398837498	84	2261084	11
10958	1.8732876504075484	0.8975609756097607	-0.0009134703991459865	51	2261135	13
10959	1.8670177964115116	1.246302250803864	0.008404326726155108	83	2261218	12
10960	1.8672696042629993	1.892198581560292	0.002796307498333501	51	2261269	8
10961	1.8680254796489408	1.9428571428571524	0.003010626809269774	51	2261320	6
10962	1.8698089929683934	2.0463768115942127	0.024643631542430204	51	2261371	2
10963	1.8651175036987755	1.4006600660066075	0.02355356076184441	51	2261422	5
10964	1.8656407058859872	1.9174377224199382	0.009189101410847084	51	2261473	3
10965	1.8637128211638971	1.6728522336769833	0.018876143530303358	51	2261524	9
10966	1.86527785901724	2.020216606498204	0.026817971584843656	51	2261575	14
10967	1.857916219667574	1.1291139240506385	0.020373276635712267	51	2261626	4
10968	1.8575124960673897	1.8175438596491311	0.00862427552541097	51	2261677	11
10969	1.8542718192672512	1.5334448160535223	0.00959973604906173	84	2261761	7
10970	1.8442813398805489	0.8552238805970209	0.022036999464035034	80	2261841	10
10971	1.8476392644891235	2.180073800738018	0.012329271026686127	51	2261892	13
10972	1.8399128718442324	1.0750000000000055	0.003819515792334952	82	2261974	1
10973	1.838717895374925	1.7204152249135034	0.01004178150027406	51	2262025	2
10974	1.8443991574858147	2.4068441064638995	0.03318156285232372	89	2262114	12
10975	1.8438852358410265	1.7930069930070016	0.03769536579356474	51	2262165	10
10976	1.8388058606067994	1.335947712418307	0.04211951704586253	51	2262216	13
10977	1.8393397878163342	1.892198581560292	0.02729905586616666	51	2262267	1
10978	1.829766749219608	0.882035928143716	0.025723454356193543	80	2262347	6
10979	1.8264690817274118	1.500000000000011	0.040398861680712016	84	2262431	5
10980	1.8279659567464368	1.976156583629908	0.030218102211175962	86	2262517	8
10981	1.8317974082900836	2.21111111111113	0.03504494103518399	88	2262605	3
10982	1.8321132370240842	1.863380281690155	0.05263357938722123	86	2262691	9
10983	1.8319587713205103	1.8166666666666806	0.057590265835032746	85	2262776	11
10984	1.836998734169103	2.335955056179793	0.04125649820674549	88	2262864	14
10985	1.8314753921948241	1.2846645367412206	0.005721765320475508	82	2262946	4
10986	1.8314237961676127	1.8263157894736999	-0.005319535732269287	86	2263032	7
10987	1.8315320934172044	1.8422535211267697	-0.002917364531872319	51	2263083	2
10988	1.8239126972479227	1.0695924764890332	-0.00040193807845022165	51	2263134	12
10989	1.8163694950403337	1.0695924764890332	0.0005644642400975321	51	2263185	10
10990	1.8140024102594219	1.5796610169491596	0.0055082872802135995	51	2263236	13
10991	1.815546973970448	1.9684587813620165	0.0012475120670655195	51	2263287	5
10992	1.8094940683333078	1.2102564102564166	-0.0008484887726166669	51	2263338	6
10993	1.8121264003772477	2.072727272727282	0.0005702218588660745	51	2263389	1
10994	1.806313818045501	1.230868167202578	0.0027446255964391373	51	2263440	8
10995	1.8029173465317128	1.466666666666674	0.00926079937055999	51	2263491	3
10996	1.8086457488239716	2.375757575757587	0.009519524434033562	51	2263542	11
10997	1.8063559015052233	1.5796610169491596	0.01294924815495809	51	2263593	4
10998	1.7985976384403268	1.0305295950155813	0.010533820180331959	51	2263644	14
10999	1.7884919015768816	0.7880239520958127	0.01691751854092467	51	2263695	9
11000	1.7835420474961778	1.2935064935064995	-0.006964332332798079	51	2263746	7
11001	1.7735868665421741	0.7880239520958127	-0.008808412972618552	51	2263797	2
11002	1.783216077241832	2.7365079365079494	0.03301056927325679	51	2263848	10
11003	1.7756892124195693	1.0305295950155813	0.038851389697953764	51	2263899	12
11004	1.773272387635441	1.5340067340067418	0.04045785642137714	51	2263950	13
11005	1.7734697336891565	1.7930069930070016	0.020490630000245338	51	2264001	6
11006	1.774657022167868	1.892198581560292	0.01703951405543907	51	2264052	5
11007	1.777637724673462	2.072727272727282	-0.004995445994769826	51	2264103	1
11008	1.7798037934698931	1.9942446043165556	-0.0033641586116715974	51	2264154	3
11009	1.7860513829116202	2.404562737642597	-8.172848645378562e-05	51	2264205	8
11010	1.794931026562819	2.6740157480315085	0.005596647659937541	51	2264256	4
11011	1.7899167812322558	1.2935064935064995	-0.002859954740486893	51	2264307	11
11012	1.7763556415889474	0.4338028169014112	0.01754415970222623	51	2264358	14
11013	1.7746192960574116	1.6027210884353815	-0.0015297415209751502	51	2264409	9
11014	1.7724406706644051	1.5567567567567644	0.002863137161030489	51	2264460	7
11015	1.7670249456297868	1.230868167202578	-0.0012524051993500953	51	2264511	2
11016	1.7796592229224604	3.030452674897133	0.002583644553726795	51	2264562	10
11017	1.7864909831836573	2.462835249042157	0.0052431126435597735	51	2264613	12
11018	1.7844226835213122	1.5796610169491596	0.010690900624967088	51	2264664	13
11019	1.7936298400853088	2.705138339920961	-0.0007458069160872815	51	2264715	5
11020	1.7997391690608817	2.404562737642597	0.004360046749021493	51	2264766	3
11021	1.7964084440369397	1.466666666666674	0.004218141237894694	51	2264817	6
11022	1.7942409697660617	1.5796610169491596	0.008535908133375878	51	2264868	8
11023	1.790965226735068	1.466666666666674	0.007938167628119974	51	2264919	1
11024	1.7973914523303127	2.4335877862595536	0.007982441023284314	51	2264970	4
11025	1.7949851053745773	1.5567567567567644	0.009322992726868274	51	2265021	11
11026	1.7942394065699667	1.7204152249135034	0.012520191716212853	51	2265072	14
11027	1.7932625297456464	1.6965517241379384	0.008737505650987812	51	2265123	9
11028	1.784120178004421	0.8790273556231052	0.0015221232292698878	51	2265174	7
11029	1.7909073287147983	2.462835249042157	0.0046186476361517815	51	2265225	2
11030	1.7874434381519029	1.444518272425256	0.008543895740135043	51	2265276	10
11031	1.789253591584004	1.9684587813620165	0.007470411412856158	51	2265327	12
11032	1.7876204413336931	1.6259385665529091	0.007750079912297866	51	2265378	13
11033	1.7907369376502833	2.0992700729927103	0.003617363233192294	51	2265429	5
11034	1.7986505799469323	2.582101167315187	0.006001103158090629	51	2265480	4
11035	1.7971572248323946	1.6493150684931583	0.010828118698269712	51	2265531	3
11036	1.794982262753562	1.5796610169491596	0.010928039457283769	51	2265582	6
11037	1.7937609624627964	1.6728522336769833	0.009813932811512667	51	2265633	1
11038	1.7879259169407327	1.2102564102564166	0.007375771508497351	51	2265684	8
11039	1.779585119309787	0.953846153846159	0.004158872015335981	51	2265735	11
11040	1.7757958687767552	1.4006600660066075	0.014808200153650022	51	2265786	9
11041	1.7701404741915518	1.2102564102564166	0.009366852395674762	51	2265837	14
11042	1.7767749473122318	2.4335877862595536	0.005436013726627126	51	2265888	2
11043	1.7700986804889518	1.1091482649842326	0.0016466456593251695	51	2265939	7
11044	1.7686570793495913	1.6259385665529091	0.015398969837263519	51	2265990	10
11045	1.7730445826301695	2.207407407407418	0.010013984698875277	51	2266041	13
11046	1.7730005479536937	1.7686411149825862	0.009729495819877176	51	2266092	5
11047	1.7699372091408236	1.466666666666674	0.013938602279214299	51	2266143	4
11048	1.7743119111234895	2.207407407407418	0.008357414427925558	51	2266194	6
11049	1.7721363595798223	1.5567567567567644	0.019631208158006855	51	2266245	1
11050	1.7628379567090997	0.8422960725075577	0.01310216094933304	51	2266296	8
11051	1.756102658903015	1.0893081761006345	0.012278975224962421	51	2266347	3
11052	1.751266551407836	1.2724919093851197	0.012263143763822667	51	2266398	11
11053	1.7484205525604244	1.466666666666674	0.012068060098909865	51	2266449	9
11054	1.748140499283955	1.7204152249135034	0.004349972979695189	51	2266500	14
11055	1.7437464729318923	1.3087378640776781	0.0015019637992583126	83	2266583	12
11056	1.7467727763185155	2.0463768115942127	0.001980295806538825	51	2266634	7
11057	1.7398050485553302	1.0500000000000052	0.00804313900423985	51	2266685	2
11058	1.7382036082392684	1.5796610169491596	0.010700466586094276	51	2266736	10
11059	1.7420816454169492	2.1260073260073358	0.006185386110754574	51	2266787	13
11060	1.740000896302847	1.5340067340067418	0.012316418629066617	51	2266838	4
11061	1.7444016253471988	2.180073800738018	0.0019956499922509285	51	2266889	5
11062	1.744161761342862	1.7204152249135034	0.009519717272590189	51	2266940	6
11063	1.7398667235339935	1.3146579804560328	0.009338438510894775	51	2266991	1
11064	1.7364746569587197	1.4006600660066075	0.0047726368202882655	51	2267042	3
11065	1.7377812884810053	1.8671378091872874	0.0052637878586264215	51	2267093	11
11066	1.743875173709403	2.3471698113207657	0.008187148500891292	51	2267144	9
11067	1.7476964952323824	2.1260073260073358	0.009196682303559547	51	2267195	14
11068	1.7491415160956614	1.892198581560292	0.00912307056726194	51	2267246	12
11069	1.7542769666063467	2.26268656716419	0.008686709053376141	51	2267297	13
11070	1.755263813665022	1.8529616724738842	0.02234971944023581	85	2267382	8
11071	1.7561337107396395	1.8422535211267697	0.011097800497915231	51	2267433	10
11072	1.7587745396972252	2.020216606498204	0.024541179339090984	51	2267484	5
11073	1.7606153657288246	1.9428571428571524	0.026824095669914696	51	2267535	6
11074	1.7573698678092415	1.4360655737705068	0.013224403542208385	83	2267618	2
11075	1.7599390262740064	2.014285714285732	0.008052984642428021	86	2267704	7
11076	1.770020910911665	2.7681274900398534	0.02397298812866211	51	2267755	1
11077	1.7735807750626216	2.1260073260073358	0.029892566157322303	51	2267806	11
11078	1.7698515679720614	1.4006600660066075	0.007383838588116216	51	2267857	9
11079	1.7665982350165934	1.444518272425256	0.007067138073491115	51	2267908	14
11080	1.7517267732143726	0.27945205479452273	0.013420981519362506	51	2267959	3
11081	1.7495495728222963	1.5340067340067418	0.004855700567656872	51	2268010	12
11082	1.7521969342369306	2.0142857142857284	-0.001318200383075448	86	2268096	4
11083	1.7607999648945614	2.6125000000000123	0.01927235196618473	51	2268147	6
11084	1.7585320325856832	1.5340067340067418	0.011486557184481154	51	2268198	2
11085	1.7581508645089614	1.7204152249135034	0.014100472132364908	51	2268249	7
11086	1.754143126355675	1.3573770491803345	0.013356905357510435	51	2268300	11
11087	1.7495367600271834	1.2935064935064995	0.018161913927863624	51	2268351	9
11088	1.7517259802405318	1.9684587813620165	0.012115008690777947	51	2268402	14
11089	1.7565028380851855	2.2294117647058993	0.0072638659641660495	87	2268489	13
11090	1.7549479107144346	1.6010101010101128	0.010214587052663168	84	2268573	8
11091	1.7456393954627119	0.8240963855421735	0.017293245184655283	51	2268624	12
11092	1.748709883228515	2.052688172043025	0.014358648034029229	86	2268710	10
11093	1.743738913428488	1.251612903225812	0.024733707016589595	51	2268761	4
11094	1.740662180031908	1.4360655737704997	0.0002716427826019655	83	2268844	1
11095	1.7414222248982558	1.8166666666666806	-0.0003976295976077809	85	2268929	5
11096	1.7349010844102797	1.0893081761006345	0.001213511999915628	51	2268980	6
11097	1.7399015159453592	2.234944237918226	0.00786438409019919	51	2269031	7
11098	1.7344392096466652	1.1936708860759562	0.003423312451781296	82	2269113	3
11099	1.7304542946743817	1.335947712418307	0.006828561717388677	51	2269164	2
11100	1.7325783231562095	1.9428571428571524	0.008435621565463496	51	2269215	11
11101	1.723675500649723	0.8422960725075577	0.006128402317271513	51	2269266	9
11102	1.7217788129832932	1.5340067340067418	0.018000338591781316	51	2269317	14
11103	1.7181347953452635	1.3573770491803345	0.016671932211109235	51	2269368	13
11104	1.7165210149593786	1.5567567567567644	0.01661092627282236	51	2269419	8
11105	1.7175312434062762	1.8175438596491311	0.005110134096706615	51	2269470	12
11106	1.723827629085421	2.3471698113207657	0.008646080306932038	51	2269521	10
11107	1.7289387951737492	2.234944237918226	0.0030184341411964564	51	2269572	5
11108	1.7274460173915032	1.5796610169491596	0.008868580939722997	51	2269623	1
11109	1.7237453277093915	1.3573770491803345	0.006110633120817297	51	2269674	7
11110	1.7225350853166512	1.6027210884353815	0.008004955216950061	51	2269725	6
11111	1.7218028851484162	1.6493150684931583	0.01656496524810791	51	2269776	11
11112	1.7188100218598459	1.4225165562913977	0.012501337948967428	51	2269827	2
11113	1.7050395040588298	0.3417582417582413	0.005511535283846733	78	2269905	4
11114	1.7081912750832235	2.020216606498204	0.011425802520677155	51	2269956	14
11115	1.6972488972161124	0.6139534883720965	0.007986279094920438	51	2270007	9
11116	1.7004785743089332	2.020216606498204	0.005865230279810289	51	2270058	8
11117	1.6968332656900271	1.335947712418307	0.009183930415733187	51	2270109	13
11118	1.6917626966114017	1.189776357827482	0.010670049517762428	51	2270160	12
11119	1.6867428332235626	1.189776357827482	0.003078143970639098	51	2270211	10
11120	1.684875404891327	1.5000000000000102	0.012254416942596436	84	2270295	3
11121	1.6725238259836568	0.4497175141242973	0.023276403838512944	51	2270346	5
11122	1.6752271591523917	1.9428571428571524	0.0016248445300494924	51	2270397	7
11123	1.6784173336040333	1.9942446043165556	0.0077710864590663535	51	2270448	6
11124	1.6808075374921925	1.9174377224199382	0.015864185258453966	51	2270499	2
11125	1.6866263277889124	2.26268656716419	0.005974925616208245	51	2270550	14
11126	1.7095031837770787	3.9743119266055227	0.019083025408726112	51	2270601	13
11127	1.7072977840463315	1.488963210702348	0.02834341105292825	51	2270652	9
11128	1.7107516879262985	2.0526881720430286	0.0014987643374953159	86	2270738	1
11129	1.7065792359821006	1.2935064935064995	0.017784908706066655	51	2270789	12
11130	1.7060065943072111	1.6493150684931583	0.007250986262863758	51	2270840	10
11131	1.7049873446906696	1.6040816326530738	0.015648614659028896	85	2270925	11
11132	1.7030515652034945	1.5114093959731618	0.014908746177074956	51	2270976	5
11133	1.7006877162181264	1.466666666666674	0.01786411860409905	51	2271027	7
11134	1.6964550326043324	1.2774193548387194	0.01987436593297016	83	2271110	4
11135	1.6972967106519916	1.7806228373702564	0.003000159824595732	85	2271195	8
11136	1.697289260786851	1.6965517241379384	0.019512793597053078	51	2271246	6
11137	1.702665810558165	2.234944237918226	0.01656726178000955	51	2271297	2
11138	1.708545519493782	2.2906367041198603	0.002736377657628527	51	2271348	14
11139	1.7071312052384418	1.5671140939597428	-0.004492243840580895	84	2271432	3
11140	1.7063192788515864	1.6259385665529091	0.0049718969008501835	51	2271483	13
11141	1.704145718170094	1.488963210702348	0.00969522139605354	51	2271534	9
11142	1.7004637381125762	1.335947712418307	0.0026862738179225546	51	2271585	1
11143	1.6997184863969796	1.6259385665529091	0.013486289510539934	51	2271636	10
11144	1.6999254537821449	1.7204152249135034	0.005036189859988643	51	2271687	11
11145	1.7093575717933431	2.6431372549019727	0.01150524616241455	51	2271738	5
11146	1.7092295133167892	1.6965517241379384	0.016315476567137475	51	2271789	7
11147	1.7123393842486032	2.020216606498204	0.012001584557925953	51	2271840	4
11148	1.7262035422733373	3.0987551867220064	0.02032171744926303	51	2271891	8
11149	1.7220880866551642	1.3146579804560328	0.012811271583332735	51	2271942	6
11150	1.7272166481677949	2.234944237918226	0.0214461368672988	51	2271993	2
11151	1.7246122557724957	1.4667774086378822	0.008713184368042718	84	2272077	12
11152	1.7267947046433423	1.9428571428571524	0.0037870488914788936	51	2272128	1
11153	1.7332843333544847	2.375757575757587	0.0026959674615485998	51	2272179	3
11154	1.7326800123577097	1.6728522336769833	0.0004601776599884033	51	2272230	9
11155	1.7327976566785772	1.744444444444453	0.007276614507039388	51	2272281	13
11156	1.7375437541858656	2.207407407407418	0.00360586333508585	51	2272332	10
11157	1.7318055406187705	1.1637223974763518	0.02751624584197998	82	2272414	14
11158	1.7312160075493526	1.6728522336769833	0.019167381174424115	51	2272465	2
11159	1.7470102304525825	3.3106382978723556	0.02826850087034936	51	2272516	1
11160	1.7428996052722399	1.335947712418307	0.032225821532455144	51	2272567	3
11161	1.7365620918693596	1.1091482649842326	0.024938405728807636	51	2272618	9
11162	1.7458435297741957	2.664705882352962	0.010982053809695774	90	2272708	11
11163	1.73967623371696	1.1291139240506385	0.027940850631863464	51	2272759	13
11164	1.7366401271174954	1.4360655737705033	0.013748790844377265	83	2272842	7
11165	1.7463839620667931	2.7110236220472674	0.009437693489922417	90	2272932	6
11166	1.7408568313068848	1.193670886075958	0.004230806013432945	82	2273014	4
11167	1.7401879890212133	1.6739726027397381	0.0022309632862315457	85	2273099	5
11168	1.7334820338958914	1.0695924764890332	0.020662997283187566	51	2273150	10
11169	1.7318183544965298	1.56711409395974	0.004145434214955284	84	2273234	8
11170	1.7291843814778802	1.4684210526315882	0.004012813051062894	83	2273317	12
11171	1.720498598269162	0.860606060606065	0.0004326210302465102	51	2273368	14
11172	1.7164401920910306	1.3146579804560328	0.0016691620443381515	51	2273419	2
11173	1.7205358634301937	2.1260073260073358	0.019549077632380465	51	2273470	9
11174	1.7279588572863134	2.462835249042157	0.009470831529766905	51	2273521	13
11175	1.7298536459376497	1.9174377224199382	0.015576781011095234	51	2273572	4
11176	1.7250712385105313	1.251612903225812	0.01943851335375917	51	2273623	11
11177	1.7348719095246357	2.705138339920961	0.013052557028976142	51	2273674	6
11178	1.7302481095232405	1.2724919093851197	0.01585982827579274	51	2273725	7
11179	1.7326302162416283	1.9684587813620165	0.00809284109695285	51	2273776	8
11180	1.7405239912992891	2.5220077220077335	0.009404814126444798	51	2273827	12
11181	1.737786525472675	1.4667774086378857	0.001713380217552185	84	2273911	1
11182	1.730433200095249	1.0024539877300702	0.004264431971090811	81	2273992	3
11183	1.7248231356102202	1.1694267515923626	0.011219043357699526	51	2274043	2
11184	1.7192121282288815	1.1637223974763464	0.001973336789666153	82	2274125	5
11185	1.7136572309213562	1.16372239747635	0.011877916935013562	82	2274207	10
11186	1.7047616224675644	0.8240963855421735	0.0071192161709654565	51	2274258	13
11187	1.6977385461201893	1.0024539877300702	0.017358335447900088	81	2274339	14
11188	1.6916542424199938	1.0893081761006345	0.010471797456928328	51	2274390	12
11189	1.6944222878094142	1.9684587813620165	0.012884703336977492	51	2274441	2
11190	1.6869414795654665	0.9463414634146418	0.016744029374770177	81	2274522	4
11191	1.6864234161211633	1.635135135135152	0.019558446747916087	84	2274606	9
11192	1.6855999982864824	1.6040816326530773	0.014364977443919463	85	2274691	11
11193	1.69368652703925	2.4942528735632408	0.0354646672023816	89	2274780	6
11194	1.6842452369900964	0.7495575221238954	0.005955290421843529	80	2274860	7
11195	1.6892928945103056	2.1890109890110048	0.011077771926748341	87	2274947	8
11196	1.6957595161270005	2.3359550561797913	0.004544745792042126	88	2275035	1
11197	1.6939160149254622	1.5114093959731618	0.014077015951568005	51	2275086	14
11198	1.6976725069501208	2.0695652173913235	0.014357801141410038	87	2275173	3
11199	1.7028068929917308	2.2111111111111272	0.009150892496109009	88	2275261	5
11200	1.6986254694292258	1.2846645367412268	0.004431329485846729	82	2275343	10
11201	1.6959998704726384	1.436065573770505	0.01018392680639244	83	2275426	13
11202	1.696969941697982	1.7930069930070016	0.009683388705347098	51	2275477	6
11203	1.6955678098485698	1.5567567567567644	0.02076562713174259	51	2275528	8
11204	1.6958162839992192	1.7204152249135034	0.021545054865818397	51	2275579	1
11205	1.6922607185618246	1.340259740259754	0.00637939464615052	83	2275662	12
11206	1.6881847567436186	1.2846645367412268	0.014634535080049096	82	2275744	4
11207	1.68799782443042	1.6694915254237408	0.016925000009082612	84	2275828	9
11208	1.6893810040808526	1.8263157894736972	0.013787758904834127	86	2275914	2
11209	1.6854222589751091	1.2935064935064995	0.023360221993689444	51	2275965	14
11210	1.6798591756258645	1.1291139240506385	0.011498460582658356	51	2276016	3
11211	1.6680464195636568	0.4985835694051033	0.007756712315957757	79	2276095	11
11212	1.6671625655375117	1.5796610169491596	0.02512501034082151	51	2276146	5
11213	1.6626447860359828	1.2153846153846288	0.0074597460677824825	83	2276229	7
11214	1.659377815299806	1.335947712418307	0.00491984860569823	51	2276280	10
11215	1.663776737876735	2.0992700729927103	0.0034934860818526324	51	2276331	8
11216	1.6708965462555434	2.375757575757587	0.014606440768522374	51	2276382	12
11217	1.67438974685797	2.020216606498204	0.003108243147532145	51	2276433	1
11218	1.66958255825015	1.1936708860759562	0.0015111085845202934	82	2276515	13
11219	1.677222610530244	2.4335877862595536	0.01603999792360792	51	2276566	7
11220	1.6666596867505228	0.6209302325581443	0.005685859546065331	80	2276646	6
11221	1.6646608639693963	1.4667774086378866	0.011128471720786322	84	2276730	11
11222	1.6588935122956467	1.0879256965944384	0.019564588864644367	81	2276811	4
11223	1.658693655670984	1.6389078498293683	0.017528329176061293	85	2276896	9
11224	1.6588464451416713	1.6739726027397417	0.021689626749824074	85	2276981	14
11225	1.6556605780928522	1.340259740259754	0.018812176692916686	83	2277064	2
11226	1.6572706389785905	1.8166666666666842	0.032370892693014706	85	2277149	3
11227	1.6493323736764178	0.8634441087613391	0.00456154015329149	81	2277230	5
11228	1.6475068240260324	1.4667774086378866	0.006644178004491897	84	2277314	10
11229	1.6553676336483676	2.4335877862595536	0.02460057127709482	51	2277365	13
11230	1.6794065499044766	4.059259259259278	0.045292087629729624	51	2277416	7
11231	1.678622585415533	1.6010101010101163	0.017174747728166125	84	2277500	8
11232	1.6895176344617762	2.7681274900398534	0.020406386431525734	51	2277551	6
11233	1.6914286864908612	1.8806228373702618	0.010499260255268641	84	2277635	12
11234	1.6849723435511863	1.0457943925233693	0.0005084187155816613	82	2277717	1
11235	1.6901966941897486	2.207407407407418	0.01810165012584013	51	2277768	11
11236	1.6962010942890497	2.2906367041198603	0.01879179360819798	51	2277819	4
11237	1.6954984690116883	1.6259385665529091	0.017639329620436125	51	2277870	9
11238	1.6967189229180628	1.8175438596491311	0.0038974577305363675	51	2277921	14
11239	1.7000549827863551	2.030324909747306	0.019337459542285437	87	2278008	2
11240	1.6990645339685928	1.601010101010118	0.018694390853246052	84	2278092	10
11241	1.7142790168340354	3.220512820512848	0.044014970879805715	95	2278187	5
11242	1.7194394757631681	2.2303249097473135	0.018405559483696432	85	2278272	7
11243	1.7211401859006417	1.8895104895105073	0.035996007919311526	85	2278357	8
11244	1.7217350124153379	1.78062283737026	0.03760347085840562	85	2278442	6
11245	1.7557713936344683	5.1253731343283935	0.05667296144151196	97	2278539	13
11246	1.767141215930008	2.892753623188442	0.012253914708676546	115	2278654	3
11247	1.7790468788695224	2.9577075098814487	0.009864438663829456	88	2278742	1
11248	1.8019159845489126	4.065957446808541	0.010220671808996867	86	2278828	4
11249	1.7988968247034236	1.5000000000000155	0.007494414136523292	84	2278912	11
11250	1.7959078564563895	1.5000000000000155	0.004926072344893501	84	2278996	9
11251	1.7963713131030934	1.8422535211267697	0.001919616817259321	51	2279047	2
11252	1.789286856938007	1.0879256965944384	0.009263677361570759	81	2279128	14
11253	1.800485243121479	2.9091254752852067	0.011892685147582507	122	2279250	12
11254	1.7992089130270341	1.6728522336769833	0.0077288553995244645	51	2279301	10
11255	1.7977099745816953	1.6493150684931583	0.0013845165570576985	51	2279352	5
11256	1.7989072520600777	1.9174377224199382	0.009857293437508977	51	2279403	7
11257	1.794064759344037	1.3146579804560328	0.004408481074314492	51	2279454	8
11258	1.787017193511603	1.0893081761006345	-0.004079059350724314	51	2279505	13
11259	1.7798429463413774	1.0695924764890332	-0.000307236816368851	51	2279556	6
11260	1.7719640215219266	0.9919504643962901	-0.002998170899409874	51	2279607	3
11261	1.7768712469783492	2.26268656716419	0.015434980392456055	51	2279658	4
11262	1.7744426018486332	1.5340067340067418	0.004616044899996589	51	2279709	1
11263	1.776900341895129	2.020216606498204	0.02276789207084506	51	2279760	11
11264	1.7746989060437455	1.5567567567567644	0.02495436808642219	51	2279811	9
11265	1.7815802694737297	2.462835249042157	0.0160827963959937	51	2279862	2
11266	1.779561076948484	1.5796610169491596	0.012833879274480483	51	2279913	10
11267	1.773663229757274	1.189776357827482	0.019802161291533827	51	2279964	7
11268	1.7699331981197675	1.4006600660066075	0.015423204384598077	51	2280015	8
11269	1.7711558519541726	1.892198581560292	0.03805606271706376	51	2280066	13
11270	1.7800913522581605	2.664705882352963	0.03675289154052734	90	2280156	14
11271	1.7824332958784361	2.014285714285733	0.021967216979625614	86	2280242	12
11272	1.7895514916552842	2.494252873563239	0.008935545267683736	89	2280331	5
11273	1.7883957027661286	1.6739726027397381	0.008068276854122387	85	2280416	6
11274	1.7802548650045225	0.9743119266055148	0.003675694818849917	81	2280497	3
11275	1.7735437990043195	1.1091482649842326	0.021245168704612582	51	2280548	10
11276	1.7751913397376806	1.9382978723404434	0.004731609377750131	86	2280634	4
11277	1.7702136198886909	1.277419354838722	0.01016132371971406	83	2280717	1
11278	1.772774641584541	2.0263157894737036	0.012590912126359485	84	2280801	11
11279	1.7749893412118611	1.9942446043165556	0.022199770983527687	51	2280852	7
11280	1.767935372564633	1.0695924764890332	0.00969690902560365	51	2280903	8
11281	1.7627190413470253	1.246302250803872	0.00933112796530666	83	2280986	9
11282	1.7628315769609526	1.7739726027397436	0.009797456718626477	84	2281070	2
11283	1.7564944004318495	1.1291139240506385	0.008257258756487978	51	2281121	14
11284	1.7535961230941979	1.466666666666674	0.015461616656359504	51	2281172	12
11285	1.7520873727476096	1.6027210884353815	0.008317213432461607	51	2281223	6
11286	1.7489271547578387	1.4360655737705068	0.006508743906595621	83	2281306	13
11287	1.7470054507778279	1.5567567567567644	0.008712502086863798	51	2281357	10
11288	1.7472218074198753	1.7686411149825862	0.007041892000273162	51	2281408	1
11289	1.7520990317248588	2.234944237918226	0.005996081174588671	51	2281459	4
11290	1.7477246212121704	1.3146579804560328	0.0066080064165825935	51	2281510	3
11291	1.74842281359654	1.8175438596491311	0.007676512002944946	51	2281561	11
11292	1.7508810315037402	1.9942446043165556	0.015321262911254284	51	2281612	7
11293	1.753056809002323	1.9684587813620165	0.005500745539571725	51	2281663	8
11294	1.7567863141723732	2.1260073260073358	0.014386069540883981	51	2281714	9
11295	1.7545585183707169	1.5340067340067418	0.01831673173343434	51	2281765	2
11296	1.752347381347545	1.533444816053526	0.0037945789240655444	84	2281849	5
11297	1.7469264716366337	1.2102564102564166	0.009993005032632864	51	2281900	12
11298	1.7466613591694025	1.7204152249135034	0.01130367961584353	51	2281951	13
11299	1.7461602628190878	1.6965517241379384	0.01913950256272858	51	2282002	11
11300	1.752744287567323	2.404562737642597	0.014054700440051509	51	2282053	3
11301	1.7502168446916497	1.5000000000000164	0.007210332722890945	84	2282137	14
11302	1.7537073769746603	2.0992700729927103	0.025345185223747704	51	2282188	2
11303	1.7419737714130061	0.5803468208092523	0.02094734182544783	51	2282239	7
11304	1.7405948500254067	1.604081632653072	0.009115535371443804	85	2282324	6
11305	1.7478252651615165	2.463636363636386	0.004385917701504447	88	2282412	10
11306	1.7526411301569602	2.229411764705903	0.02103584388206745	87	2282499	1
11307	1.7494753745930955	1.4360655737705015	0.009645177657345691	83	2282582	4
11308	1.748720346874562	1.6739726027397435	0.0060538348029641545	85	2282667	8
11309	1.7425727660473258	1.1339622641509552	0.0067345768940158006	82	2282749	9
11310	1.7331678099002057	0.8020771513353202	0.00295055340975523	80	2282829	5
11311	1.7225554300468178	0.6719298245614111	0.0036563843488693236	80	2282909	12
11312	1.729665753608945	2.4335877862595536	0.01225915142134124	51	2282960	6
11313	1.7270533065991713	1.4684210526315935	0.016450051801750458	83	2283043	11
11314	1.718603132814617	0.8820359281437222	0.0066559046506881716	80	2283123	14
11315	1.7273596302221033	2.5942528735632426	0.038870816881006416	88	2283211	3
11316	1.7333892830173554	2.3303249097473144	0.016718793483007522	84	2283295	2
11317	1.728902035554594	1.2846645367412268	0.00645281846930341	82	2283377	7
